"country","region","region_code","start_date","end_date","days","year","week","population","total_deaths","covid_deaths","expected_deaths","excess_deaths","non_covid_deaths","covid_deaths_per_100k","excess_deaths_per_100k","excess_deaths_pct_change"
"Brazil","Brazil","0","2019-12-29","2020-01-04",7,2020,"1",210147125,23681,0,22066,1615,23681,0,0.768509205158053,0.0731895223420647
"Brazil","Brazil","0","2020-01-05","2020-01-11",7,2020,"2",210147125,23260,0,20970,2290,23260,0,1.08971274291761,0.109203624225084
"Brazil","Brazil","0","2020-01-12","2020-01-18",7,2020,"3",210147125,22824,0,21986,838,22824,0,0.398768243914829,0.0381151641953972
"Brazil","Brazil","0","2020-01-19","2020-01-25",7,2020,"4",210147125,22595,0,22056,539,22595,0,0.256486973114669,0.0244377947043888
"Brazil","Brazil","0","2020-01-26","2020-02-01",7,2020,"5",210147125,22924,0,21896,1028,22924,0,0.489181091580482,0.0469492144683961
"Brazil","Brazil","0","2020-02-02","2020-02-08",7,2020,"6",210147125,22893,0,21558,1335,22893,0,0.635269219124459,0.0619259671583634
"Brazil","Brazil","0","2020-02-09","2020-02-15",7,2020,"7",210147125,22664,0,21140,1524,22664,0,0.725206209697135,0.0720908230842006
"Brazil","Brazil","0","2020-02-16","2020-02-22",7,2020,"8",210147125,23041,0,21118,1923,23041,0,0.915073189795007,0.0910597594469174
"Brazil","Brazil","0","2020-02-23","2020-02-29",7,2020,"9",210147125,23309,0,21932,1377,23309,0,0.655255217029498,0.0627849717308042
"Brazil","Brazil","0","2020-03-01","2020-03-07",7,2020,"10",210147125,23633,0,22063,1570,23633,0,0.747095635974082,0.0711598603997643
"Brazil","Brazil","0","2020-03-08","2020-03-14",7,2020,"11",210147125,24507,0,22642,1865,24507,0,0.887473478402334,0.0823690486706121
"Brazil","Brazil","0","2020-03-15","2020-03-21",7,2020,"12",210147125,25268,15,22340,2928,25253,0.00713785639465684,1.39330956823701,0.131065353625783
"Brazil","Brazil","0","2020-03-22","2020-03-28",7,2020,"13",210147125,24374,96,21412,2962,24278,0.0456822809258038,1.40948870939824,0.138333644685223
"Brazil","Brazil","0","2020-03-29","2020-04-04",7,2020,"14",210147125,24719,334,21818,2901,24385,0.158936269054359,1.38046142672663,0.132963608030067
"Brazil","Brazil","0","2020-04-05","2020-04-11",7,2020,"15",210147125,25200,679,22414,2786,24521,0.323106966131466,1.32573786103426,0.124297314178638
"Brazil","Brazil","0","2020-04-12","2020-04-18",7,2020,"16",210147125,26027,1230,22683,3344,24797,0.585304224361861,1.5912661189155,0.147423180355332
"Brazil","Brazil","0","2020-04-19","2020-04-25",7,2020,"17",210147125,28946,1703,23326,5620,27243,0.81038462934004,2.67431686253143,0.240932864614593
"Brazil","Brazil","0","2020-04-26","2020-05-02",7,2020,"18",210147125,31969,2704,23154,8815,29265,1.28671757941014,4.19468027459334,0.380711756068066
"Brazil","Brazil","0","2020-05-03","2020-05-09",7,2020,"19",210147125,33471,3895,23578,9893,29576,1.85346337714589,4.70765422082267,0.419586054796844
"Brazil","Brazil","0","2020-05-10","2020-05-16",7,2020,"20",210147125,33885,5006,23679,10206,28879,2.38214060744348,4.85659749092451,0.431014823261118
"Brazil","Brazil","0","2020-05-17","2020-05-23",7,2020,"21",210147125,32909,6351,24407,8502,26558,3.02216839749771,4.0457370044915,0.34834268857295
"Brazil","Brazil","0","2020-05-24","2020-05-30",7,2020,"22",210147125,32514,6821,24955,7559,25693,3.24582123119695,3.59700376581407,0.302905229412943
"Brazil","Brazil","0","2020-05-31","2020-06-06",7,2020,"23",210147125,32270,7096,25195,7075,25174,3.37668193176566,3.36668893281314,0.280809684461203
"Brazil","Brazil","0","2020-06-07","2020-06-13",7,2020,"24",210147125,31376,6790,25466,5910,24586,3.23106966131466,2.81231541949479,0.232074138066442
"Brazil","Brazil","0","2020-06-14","2020-06-20",7,2020,"25",210147125,30296,7256,24958,5338,23040,3.452819066642,2.54012516231188,0.213879317252985
"Brazil","Brazil","0","2020-06-21","2020-06-27",7,2020,"26",210147125,30031,7094,24983,5048,22937,3.37573021757971,2.40212660534851,0.202057399031341
"Brazil","Brazil","0","2020-06-28","2020-07-04",7,2020,"27",210147125,30527,7195,24801,5726,23332,3.4237917839704,2.724757714387,0.230877787186001
"Brazil","Brazil","0","2020-07-05","2020-07-11",7,2020,"28",210147125,31153,7204,25906,5247,23949,3.42807449780719,2.49682216685096,0.202539952134641
"Brazil","Brazil","0","2020-07-12","2020-07-18",7,2020,"29",210147125,31543,7303,25976,5567,24240,3.47518435001193,2.64909643660364,0.214313212195873
"Brazil","Brazil","0","2020-07-19","2020-07-25",7,2020,"30",210147125,31071,7677,24905,6166,23394,3.65315490278537,2.93413483529694,0.247580807066854
"Brazil","Brazil","0","2020-07-26","2020-08-01",7,2020,"31",210147125,30298,7114,24518,5780,23184,3.38524735943925,2.75045399740777,0.235745166816217
"Brazil","Brazil","0","2020-08-02","2020-08-08",7,2020,"32",210147125,30573,6914,24702,5871,23659,3.29007594084383,2.79375699286869,0.237673062909886
"Brazil","Brazil","0","2020-08-09","2020-08-15",7,2020,"33",210147125,30413,6755,24483,5930,23658,3.21441466306046,2.82183256135434,0.242208879630764
"Brazil","Brazil","0","2020-08-16","2020-08-22",7,2020,"34",210147125,29253,7018,24268,4985,22235,3.33956507851345,2.37214760849096,0.205414537662766
"Brazil","Brazil","0","2020-08-23","2020-08-29",7,2020,"35",210147125,29894,6012,24504,5390,23882,2.86085284297846,2.56486973114669,0.219964087495919
"Brazil","Brazil","0","2020-08-30","2020-09-05",7,2020,"36",210147125,29169,5941,24183,4986,23228,2.82706698937709,2.37262346558393,0.206177893561593
"Brazil","Brazil","0","2020-09-06","2020-09-12",7,2020,"37",210147125,28522,5007,24118,4404,23515,2.38261646453645,2.09567463747125,0.182602205821378
"Brazil","Brazil","0","2020-09-13","2020-09-19",7,2020,"38",210147125,27483,5322,23132,4351,22161,2.53251144882425,2.07045421154346,0.188094414663669
"Brazil","Brazil","0","2020-09-20","2020-09-26",7,2020,"39",210147125,26854,4874,23118,3736,21980,2.3193274711705,1.77780209936253,0.161605675231421
"Brazil","Brazil","0","2020-09-27","2020-10-03",7,2020,"40",210147125,28335,4581,22516,5819,23754,2.1799013429282,2.76901242403388,0.258438443773317
"Brazil","Brazil","0","2020-10-04","2020-10-10",7,2020,"41",210147125,29488,4211,22134,7354,25277,2.00383421852666,3.49945306175376,0.332249028643716
"Brazil","Brazil","0","2020-10-11","2020-10-17",7,2020,"42",210147125,26538,3477,21805,4733,23061,1.65455511228146,2.25223162106072,0.217060307268975
"Brazil","Brazil","0","2020-10-18","2020-10-24",7,2020,"43",210147125,25245,3228,22404,2841,22017,1.53606669613015,1.35191000114801,0.126807712908409
"Brazil","Brazil","0","2020-10-25","2020-10-31",7,2020,"44",210147125,25163,2981,22364,2799,22182,1.4185299941648,1.33192400324297,0.1251565015203
"Brazil","Brazil","0","2020-11-01","2020-11-07",7,2020,"45",210147125,25468,2385,21930,3538,23083,1.13491916675044,1.68358239495306,0.161331509347925
"Brazil","Brazil","0","2020-11-08","2020-11-14",7,2020,"46",210147125,26037,3389,22260,3777,22648,1.61267968809947,1.79731224017459,0.169676549865229
"Brazil","Brazil","0","2020-11-15","2020-11-21",7,2020,"47",210147125,25719,3331,21493,4226,22388,1.5850799767068,2.01097207492132,0.196622156050807
"Brazil","Brazil","0","2020-11-22","2020-11-28",7,2020,"48",210147125,26460,3572,21556,4904,22888,1.69976153611428,2.33360318395981,0.227500463907961
"Brazil","Brazil","0","2020-11-29","2020-12-05",7,2020,"49",210147125,27964,4067,21628,6336,23897,1.93531079713796,3.01503054110305,0.292953578694285
"Brazil","Brazil","0","2020-12-06","2020-12-12",7,2020,"50",210147125,27930,4495,22627,5303,23435,2.13897763293217,2.52347016405768,0.234366022893004
"Brazil","Brazil","0","2020-12-13","2020-12-19",7,2020,"51",210147125,29203,5233,23340,5863,23970,2.49016016754928,2.78995013612487,0.251199657240788
"Brazil","Brazil","0","2020-12-20","2020-12-26",7,2020,"52",210147125,28427,4439,22347,6080,23988,2.11232963572545,2.89321112530091,0.272072313957131
