"country","region","region_code","start_date","end_date","days","year","week","population","total_deaths","covid_deaths","expected_deaths","excess_deaths","non_covid_deaths","covid_deaths_per_100k","excess_deaths_per_100k","excess_deaths_pct_change"
"South Africa","South Africa","0",2019-12-29,2020-01-04,7,2020,"1",59622350,9921,0,9002,919,9921,0,1.54136829561398,0.10208842479449
"South Africa","South Africa","0",2020-01-05,2020-01-11,7,2020,"2",59622350,9112,0,8740,372,9112,0,0.623927101162567,0.0425629290617848
"South Africa","South Africa","0",2020-01-12,2020-01-18,7,2020,"3",59622350,8678,0,8598,80,8678,0,0.134177871217756,0.00930448941614337
"South Africa","South Africa","0",2020-01-19,2020-01-25,7,2020,"4",59622350,8179,0,8370,-191,8179,0,-0.320349667532393,-0.0228195937873357
"South Africa","South Africa","0",2020-01-26,2020-02-01,7,2020,"5",59622350,8810,0,8575,235,8810,0,0.394147496702159,0.027405247813411
"South Africa","South Africa","0",2020-02-02,2020-02-08,7,2020,"6",59622350,9313,0,8758,555,9313,0,0.930858981573185,0.0633706325645125
"South Africa","South Africa","0",2020-02-09,2020-02-15,7,2020,"7",59622350,8615,0,8515,100,8615,0,0.167722339022196,0.01174398120963
"South Africa","South Africa","0",2020-02-16,2020-02-22,7,2020,"8",59622350,8659,0,8345,314,8659,0,0.526648144529694,0.0376273217495506
"South Africa","South Africa","0",2020-02-23,2020-02-29,7,2020,"9",59622350,8368,0,8718,-350,8368,0,-0.587028186577684,-0.040146822665749
"South Africa","South Africa","0",2020-03-01,2020-03-07,7,2020,"10",59622350,9289,0,8740,549,9289,0,0.920795641231854,0.0628146453089244
"South Africa","South Africa","0",2020-03-08,2020-03-14,7,2020,"11",59622350,8800,0,8512,288,8800,0,0.483040336383923,0.0338345864661653
"South Africa","South Africa","0",2020-03-15,2020-03-21,7,2020,"12",59622350,8597,0,8413,184,8597,0,0.30860910380084,0.0218709140615714
"South Africa","South Africa","0",2020-03-22,2020-03-28,7,2020,"13",59622350,8447,1,8717,-270,8446,0.00167722339022196,-0.452850315359928,-0.0309739589308248
"South Africa","South Africa","0",2020-03-29,2020-04-04,7,2020,"14",59622350,8240,8,8957,-717,8232,0.0134177871217756,-1.20256917078914,-0.0800491235904879
"South Africa","South Africa","0",2020-04-05,2020-04-11,7,2020,"15",59622350,8257,16,8753,-496,8241,0.0268355742435513,-0.83190280155009,-0.0566662858448532
"South Africa","South Africa","0",2020-04-12,2020-04-18,7,2020,"16",59622350,8126,27,8782,-656,8099,0.0452850315359928,-1.1002585439856,-0.0746982464131177
"South Africa","South Africa","0",2020-04-19,2020-04-25,7,2020,"17",59622350,7959,34,8965,-1006,7925,0.0570255952675465,-1.68728673056329,-0.112214166201896
"South Africa","South Africa","0",2020-04-26,2020-05-02,7,2020,"18",59622350,8032,37,9444,-1412,7995,0.0620572654382123,-2.3682394269934,-0.149512918254977
"South Africa","South Africa","0",2020-05-03,2020-05-09,7,2020,"19",59622350,8510,63,9380,-870,8447,0.105665073583983,-1.4591843494931,-0.0927505330490405
"South Africa","South Africa","0",2020-05-10,2020-05-16,7,2020,"20",59622350,8657,75,9440,-783,8582,0.125791754266647,-1.31326591454379,-0.0829449152542373
"South Africa","South Africa","0",2020-05-17,2020-05-23,7,2020,"21",59622350,8883,146,9250,-367,8737,0.244874614972405,-0.615540984211458,-0.0396756756756756
"South Africa","South Africa","0",2020-05-24,2020-05-30,7,2020,"22",59622350,9450,236,9909,-459,9214,0.395824720092381,-0.769845536111877,-0.0463215258855586
"South Africa","South Africa","0",2020-05-31,2020-06-06,7,2020,"23",59622350,10158,309,10493,-335,9849,0.518262027578584,-0.561869835724355,-0.0319260459353855
"South Africa","South Africa","0",2020-06-07,2020-06-13,7,2020,"24",59622350,10636,471,10629,7,10165,0.789972216794541,0.0117405637315537,0.000658575595070099
"South Africa","South Africa","0",2020-06-14,2020-06-20,7,2020,"25",59622350,11980,454,10529,1451,11526,0.761459419160768,2.43365113921206,0.137809858486086
"South Africa","South Africa","0",2020-06-21,2020-06-27,7,2020,"26",59622350,12541,536,10595,1946,12005,0.898991737158968,3.26387671737193,0.183671543180746
"South Africa","South Africa","0",2020-06-28,2020-07-04,7,2020,"27",59622350,13525,613,10806,2719,12912,1.02813793820606,4.5603703980135,0.251619470664446
"South Africa","South Africa","0",2020-07-05,2020-07-11,7,2020,"28",59622350,14775,945,10507,4268,13830,1.58497610375975,7.15838942946731,0.406205386884934
"South Africa","South Africa","0",2020-07-12,2020-07-18,7,2020,"29",59622350,16256,977,10239,6017,15279,1.63864725224685,10.0918531389655,0.587655044437933
"South Africa","South Africa","0",2020-07-19,2020-07-25,7,2020,"30",59622350,16206,1707,9888,6318,14499,2.86302032710888,10.5966973794223,0.638956310679612
"South Africa","South Africa","0",2020-07-26,2020-08-01,7,2020,"31",59622350,15264,1498,10251,5013,13766,2.51248063855249,8.40792085518266,0.489025460930641
"South Africa","South Africa","0",2020-08-02,2020-08-08,7,2020,"32",59622350,13721,2057,10121,3600,11664,3.45004851368656,6.03800420479904,0.355696077462701
"South Africa","South Africa","0",2020-08-09,2020-08-15,7,2020,"33",59622350,12389,1467,9851,2538,10922,2.46048671345561,4.25679296438332,0.257638818394072
"South Africa","South Africa","0",2020-08-16,2020-08-22,7,2020,"34",59622350,11958,1310,9722,2236,10648,2.19716264119076,3.75027150053629,0.229993828430364
"South Africa","South Africa","0",2020-08-23,2020-08-29,7,2020,"35",59622350,11158,994,9700,1458,10164,1.66716004988062,2.44539170294361,0.150309278350516
"South Africa","South Africa","0",2020-08-30,2020-09-05,7,2020,"36",59622350,10927,798,10011,916,10129,1.33842426539712,1.53633662544331,0.0914993507142143
"South Africa","South Africa","0",2020-09-06,2020-09-12,7,2020,"37",59622350,10065,648,9521,544,9417,1.08684075686383,0.912409524280744,0.0571368553723348
"South Africa","South Africa","0",2020-09-13,2020-09-19,7,2020,"38",59622350,9570,513,9394,176,9057,0.860415599183863,0.295191316679064,0.0187353629976581
"South Africa","South Africa","0",2020-09-20,2020-09-26,7,2020,"39",59622350,9863,436,9267,596,9427,0.731269398136772,0.999625140572285,0.0643142333009603
"South Africa","South Africa","0",2020-09-27,2020-10-03,7,2020,"40",59622350,9504,562,9672,-168,8942,0.942599545304739,-0.281773529557289,-0.0173697270471465
"South Africa","South Africa","0",2020-10-04,2020-10-10,7,2020,"41",59622350,10069,735,9266,803,9334,1.23275919181314,1.34681038234823,0.0866609108568961
"South Africa","South Africa","0",2020-10-11,2020-10-17,7,2020,"42",59622350,10127,735,8962,1165,9392,1.23275919181314,1.95396524960858,0.129993305065834
"South Africa","South Africa","0",2020-10-18,2020-10-24,7,2020,"43",59622350,9945,536,8961,984,9409,0.898991737158968,1.6503878159784,0.109809173083361
"South Africa","South Africa","0",2020-10-25,2020-10-31,7,2020,"44",59622350,9819,332,9191,628,9487,0.556838165553689,1.05329628905939,0.0683277118920684
"South Africa","South Africa","0",2020-11-01,2020-11-07,7,2020,"45",59622350,9967,513,9063,904,9454,0.860415599183863,1.51620994476065,0.0997462208981574
"South Africa","South Africa","0",2020-11-08,2020-11-14,7,2020,"46",59622350,10297,417,8825,1472,9880,0.699402153722555,2.46887283040672,0.166798866855524
"South Africa","South Africa","0",2020-11-15,2020-11-21,7,2020,"47",59622350,10293,639,8715,1578,9654,1.07174574635183,2.64665850977025,0.181067125645439
"South Africa","South Africa","0",2020-11-22,2020-11-28,7,2020,"48",59622350,10115,594,9239,876,9521,0.996270693791842,1.46924768983443,0.0948154562182055
"South Africa","South Africa","0",2020-11-29,2020-12-05,7,2020,"49",59622350,11352,628,9379,1973,10724,1.05329628905939,3.30916174890792,0.210363578206632
"South Africa","South Africa","0",2020-12-06,2020-12-12,7,2020,"50",59622350,12310,1039,9015,3295,11271,1.74263510244061,5.52645107078134,0.365501941209096
"South Africa","South Africa","0",2020-12-13,2020-12-19,7,2020,"51",59622350,13684,1433,9528,4156,12251,2.40346111818806,6.97054040976245,0.436188077246012
"South Africa","South Africa","0",2020-12-20,2020-12-26,7,2020,"52",59622350,17011,1982,9632,7379,15029,3.32425675941992,12.3762313964478,0.76609219269103
"South Africa","South Africa","0",2020-12-27,2021-01-02,7,2020,"53",59622350,19690,2654,9416,10274,17036,4.45135087764907,17.2317931111404,1.0911214953271
"South Africa","South Africa","0",2021-01-03,2021-01-09,7,2021,"1",59622350,22930,3649,9002,13928,19281,6.12018815091992,23.3603673790114,1.54721173072651
"South Africa","South Africa","0",2021-01-10,2021-01-16,7,2021,"2",59622350,24376,4027,8740,15636,20349,6.75417859242381,26.2250649295105,1.78901601830664
"South Africa","South Africa","0",2021-01-17,2021-01-23,7,2021,"3",59622350,21177,3723,8598,12579,17454,6.24430268179634,21.097793025602,1.46301465457083
"South Africa","South Africa","0",2021-01-24,2021-01-30,7,2021,"4",59622350,15319,3377,8370,6949,11942,5.66398338877954,11.6550253386524,0.830227001194743
"South Africa","South Africa","0",2021-01-31,2021-02-06,7,2021,"5",59622350,13303,2229,8575,4728,11074,3.73853093680474,7.9299121889694,0.551370262390671
"South Africa","South Africa","0",2021-02-07,2021-02-13,7,2021,"6",59622350,11650,1641,8758,2892,10009,2.75232358335423,4.85053004452189,0.330212377255081
"South Africa","South Africa","0",2021-02-14,2021-02-20,7,2021,"7",59622350,10916,1119,8515,2401,9797,1.87681297365837,4.02701335992291,0.281972988843218
"South Africa","South Africa","0",2021-02-21,2021-02-27,7,2021,"8",59622350,10055,1001,8345,1710,9054,1.67890061361218,2.86805199727954,0.204913121629718
"South Africa","South Africa","0",2021-02-28,2021-03-06,7,2021,"9",59622350,10382,706,8718,1664,9676,1.1841197134967,2.79089972132933,0.190869465473732
"South Africa","South Africa","0",2021-03-07,2021-03-13,7,2021,"10",59622350,10309,614,8740,1569,9695,1.02981516159628,2.63156349925825,0.179519450800915
"South Africa","South Africa","0",2021-03-14,2021-03-20,7,2021,"11",59622350,9577,821,8512,1065,8756,1.37700040337223,1.78624291058638,0.125117481203008
"South Africa","South Africa","0",2021-03-21,2021-03-27,7,2021,"12",59622350,9482,566,8413,1069,8916,0.949308438865627,1.79295180414727,0.127065256151195
"South Africa","South Africa","0",2021-03-28,2021-04-03,7,2021,"13",59622350,10017,306,8717,1300,9711,0.513230357407918,2.18039040728854,0.149133876333601
"South Africa","South Africa","0",2021-04-04,2021-04-10,7,2021,"14",59622350,10230,302,8957,1273,9928,0.50652146384703,2.13510537575255,0.142123478843363
"South Africa","South Africa","0",2021-04-11,2021-04-17,7,2021,"15",59622350,10108,455,8753,1355,9653,0.76313664255099,2.27263769375075,0.154804067176968
"South Africa","South Africa","0",2021-04-18,2021-04-24,7,2021,"16",59622350,9989,414,8782,1207,9575,0.694370483551889,2.0244086319979,0.137440218629014
"South Africa","South Africa","0",2021-04-25,2021-05-01,7,2021,"17",59622350,10280,281,8965,1315,9999,0.471299772652369,2.20554875814187,0.146681539319576
"South Africa","South Africa","0",2021-05-02,2021-05-08,7,2021,"18",59622350,10849,281,9444,1405,10568,0.471299772652369,2.35649886326185,0.148771706903854
"South Africa","South Africa","0",2021-05-09,2021-05-15,7,2021,"19",59622350,11073,496,9380,1693,10577,0.83190280155009,2.83953919964577,0.180490405117271
"South Africa","South Africa","0",2021-05-16,2021-05-22,7,2021,"20",59622350,11010,589,9440,1570,10421,0.987884576840732,2.63324072264847,0.166313559322034
"South Africa","South Africa","0",2021-05-23,2021-05-29,7,2021,"21",59622350,11532,591,9250,2282,10941,0.991239023621176,3.8274237764865,0.246702702702703
"South Africa","South Africa","0",2021-05-30,2021-06-05,7,2021,"22",59622350,12619,566,9909,2710,12053,0.949308438865627,4.5452753875015,0.273488747603189
"South Africa","South Africa","0",2021-06-06,2021-06-12,7,2021,"23",59622350,13364,777,10493,2871,12587,1.30320257420246,4.81530835332723,0.273610978747737
"South Africa","South Africa","0",2021-06-13,2021-06-19,7,2021,"24",59622350,12863,884,10629,2234,11979,1.48266547695621,3.74691705375585,0.210179697055226
"South Africa","South Africa","0",2021-06-20,2021-06-26,7,2021,"25",59622350,14227,1188,10529,3698,13039,1.99254138758368,6.20237209704079,0.351220438788109
