"country","region","region_code","start_date","end_date","days","year","week","population","total_deaths","covid_deaths","expected_deaths","excess_deaths","non_covid_deaths","covid_deaths_per_100k","excess_deaths_per_100k","excess_deaths_pct_change"
"South Africa","South Africa","0","2019-12-29","2020-01-04",7,2020,"1",58775022,9920,0,9002,918,9920,0,1.56188797343198,0.101977338369251
"South Africa","South Africa","0","2020-01-05","2020-01-11",7,2020,"2",58775022,9111,0,8740,371,9111,0,0.631220520853229,0.0424485125858123
"South Africa","South Africa","0","2020-01-12","2020-01-18",7,2020,"3",58775022,8678,0,8598,80,8678,0,0.136112241693419,0.00930448941614337
"South Africa","South Africa","0","2020-01-19","2020-01-25",7,2020,"4",58775022,8179,0,8370,-191,8179,0,-0.324967977043037,-0.0228195937873357
"South Africa","South Africa","0","2020-01-26","2020-02-01",7,2020,"5",58775022,8808,0,8575,233,8808,0,0.396426903932082,0.0271720116618075
"South Africa","South Africa","0","2020-02-02","2020-02-08",7,2020,"6",58775022,9313,0,8758,555,9313,0,0.944278676748092,0.0633706325645125
"South Africa","South Africa","0","2020-02-09","2020-02-15",7,2020,"7",58775022,8614,0,8515,99,8614,0,0.168438899095606,0.0116265413975338
"South Africa","South Africa","0","2020-02-16","2020-02-22",7,2020,"8",58775022,8658,0,8345,313,8658,0,0.532539145625501,0.0375074895146794
"South Africa","South Africa","0","2020-02-23","2020-02-29",7,2020,"9",58775022,8367,0,8718,-351,8367,0,-0.597192460429875,-0.0402615278733655
"South Africa","South Africa","0","2020-03-01","2020-03-07",7,2020,"10",58775022,9287,0,8740,547,9287,0,0.93066745257875,0.0625858123569794
"South Africa","South Africa","0","2020-03-08","2020-03-14",7,2020,"11",58775022,8796,0,8512,284,8796,0,0.483198458011636,0.0333646616541354
"South Africa","South Africa","0","2020-03-15","2020-03-21",7,2020,"12",58775022,8593,0,8413,180,8593,0,0.306252543810192,0.021395459408059
"South Africa","South Africa","0","2020-03-22","2020-03-28",7,2020,"13",58775022,8447,1,8717,-270,8446,0.00170140302116773,-0.459378815715288,-0.0309739589308248
"South Africa","South Africa","0","2020-03-29","2020-04-04",7,2020,"14",58775022,8239,8,8957,-718,8231,0.0136112241693419,-1.22160736919843,-0.080160768114324
"South Africa","South Africa","0","2020-04-05","2020-04-11",7,2020,"15",58775022,8257,16,8753,-496,8241,0.0272224483386837,-0.843895898499196,-0.0566662858448532
"South Africa","South Africa","0","2020-04-12","2020-04-18",7,2020,"16",58775022,8121,27,8782,-661,8094,0.0459378815715288,-1.12462739699187,-0.0752675928034616
"South Africa","South Africa","0","2020-04-19","2020-04-25",7,2020,"17",58775022,7956,34,8965,-1009,7922,0.0578477027197029,-1.71671564835824,-0.112548800892359
"South Africa","South Africa","0","2020-04-26","2020-05-02",7,2020,"18",58775022,8030,37,9444,-1414,7993,0.0629519117832061,-2.40578387193118,-0.149724692926726
"South Africa","South Africa","0","2020-05-03","2020-05-09",7,2020,"19",58775022,8505,63,9380,-875,8442,0.107188390333567,-1.48872764352177,-0.0932835820895522
"South Africa","South Africa","0","2020-05-10","2020-05-16",7,2020,"20",58775022,8654,75,9440,-786,8579,0.12760522658758,-1.33730277463784,-0.0832627118644068
"South Africa","South Africa","0","2020-05-17","2020-05-23",7,2020,"21",58775022,8878,146,9250,-372,8732,0.248404841090489,-0.632921923874397,-0.0402162162162162
"South Africa","South Africa","0","2020-05-24","2020-05-30",7,2020,"22",58775022,9447,236,9909,-462,9211,0.401531112995585,-0.786048195779493,-0.046624280956706
"South Africa","South Africa","0","2020-05-31","2020-06-06",7,2020,"23",58775022,10155,309,10493,-338,9846,0.52573353354083,-0.575074221154694,-0.0322119508243591
"South Africa","South Africa","0","2020-06-07","2020-06-13",7,2020,"24",58775022,10631,471,10629,2,10160,0.801360822970003,0.00340280604233547,0.000188164455734219
"South Africa","South Africa","0","2020-06-14","2020-06-20",7,2020,"25",58775022,11978,454,10529,1449,11524,0.772436971610151,2.46533297767205,0.137619906923734
"South Africa","South Africa","0","2020-06-21","2020-06-27",7,2020,"26",58775022,12535,536,10595,1940,11999,0.911952019345905,3.3007218610654,0.183105238319962
"South Africa","South Africa","0","2020-06-28","2020-07-04",7,2020,"27",58775022,13515,613,10806,2709,12902,1.04296005197582,4.60910078434339,0.250694058856191
"South Africa","South Africa","0","2020-07-05","2020-07-11",7,2020,"28",58775022,14764,945,10507,4257,13819,1.60782585500351,7.24287266111104,0.405158465784715
"South Africa","South Africa","0","2020-07-12","2020-07-18",7,2020,"29",58775022,16243,977,10239,6004,15266,1.66227075168088,10.2152237390911,0.586385389198164
"South Africa","South Africa","0","2020-07-19","2020-07-25",7,2020,"30",58775022,16195,1707,9888,6307,14488,2.90429495713332,10.7307488545049,0.637843851132686
"South Africa","South Africa","0","2020-07-26","2020-08-01",7,2020,"31",58775022,15255,1498,10251,5004,13757,2.54870172570927,8.51382071792334,0.488147497805092
"South Africa","South Africa","0","2020-08-02","2020-08-08",7,2020,"32",58775022,13704,2057,10121,3583,11647,3.49978601454203,6.09612702484399,0.35401640154135
"South Africa","South Africa","0","2020-08-09","2020-08-15",7,2020,"33",58775022,12381,1467,9851,2530,10914,2.49595823205306,4.30454964355437,0.256826718099685
"South Africa","South Africa","0","2020-08-16","2020-08-22",7,2020,"34",58775022,11953,1310,9722,2231,10643,2.22883795772973,3.79583014022521,0.229479530960708
"South Africa","South Africa","0","2020-08-23","2020-08-29",7,2020,"35",58775022,11144,994,9700,1444,10150,1.69119460304073,2.45682596256621,0.148865979381443
"South Africa","South Africa","0","2020-08-30","2020-09-05",7,2020,"36",58775022,10920,798,10011,909,10122,1.35771961089185,1.54657534624147,0.090800119868145
"South Africa","South Africa","0","2020-09-06","2020-09-12",7,2020,"37",58775022,10058,648,9521,537,9410,1.10250915771669,0.913653422367073,0.0564016384833526
"South Africa","South Africa","0","2020-09-13","2020-09-19",7,2020,"38",58775022,9563,513,9394,169,9050,0.872819749859047,0.287537110577347,0.0179902065147968
"South Africa","South Africa","0","2020-09-20","2020-09-26",7,2020,"39",58775022,9860,436,9267,593,9424,0.741811717229132,1.00893199155247,0.0639905039387072
"South Africa","South Africa","0","2020-09-27","2020-10-03",7,2020,"40",58775022,9493,562,9672,-179,8931,0.956188497896266,-0.304551140789024,-0.0185070306038048
"South Africa","South Africa","0","2020-10-04","2020-10-10",7,2020,"41",58775022,10059,735,9266,793,9324,1.25053122055828,1.34921259578601,0.0855816965249299
"South Africa","South Africa","0","2020-10-11","2020-10-17",7,2020,"42",58775022,10108,735,8962,1146,9373,1.25053122055828,1.94980786225822,0.127873242579781
"South Africa","South Africa","0","2020-10-18","2020-10-24",7,2020,"43",58775022,9924,536,8961,963,9388,0.911952019345905,1.63845110938453,0.107465684633411
"South Africa","South Africa","0","2020-10-25","2020-10-31",7,2020,"44",58775022,9809,332,9191,618,9477,0.564865803027688,1.05146706708166,0.0672396910020672
"South Africa","South Africa","0","2020-11-01","2020-11-07",7,2020,"45",58775022,9950,513,9063,887,9437,0.872819749859047,1.50914447977578,0.0978704623193203
"South Africa","South Africa","0","2020-11-08","2020-11-14",7,2020,"46",58775022,10280,417,8825,1455,9863,0.709485059826945,2.47554139579905,0.164872521246459
"South Africa","South Africa","0","2020-11-15","2020-11-21",7,2020,"47",58775022,10260,639,8715,1545,9621,1.08719653052618,2.62866766770415,0.177280550774527
"South Africa","South Africa","0","2020-11-22","2020-11-28",7,2020,"48",58775022,10075,594,9239,836,9481,1.01063339457363,1.42237292569623,0.0904859833315295
"South Africa","South Africa","0","2020-11-29","2020-12-05",7,2020,"49",58775022,11324,628,9379,1945,10696,1.06848109729334,3.30922887617124,0.207378185307602
"South Africa","South Africa","0","2020-12-06","2020-12-12",7,2020,"50",58775022,12277,1039,9015,3262,11238,1.76775773899328,5.54997665504915,0.361841375485302
"South Africa","South Africa","0","2020-12-13","2020-12-19",7,2020,"51",58775022,13631,1433,9528,4103,12198,2.43811052933336,6.98085659585121,0.430625524769102
"South Africa","South Africa","0","2020-12-20","2020-12-26",7,2020,"52",58775022,16951,1982,9632,7319,14969,3.37218078795445,12.4525687119266,0.759862956810631
"South Africa","South Africa","0","2020-12-27","2021-01-02",7,2020,"53",58775022,20136,2654,9416,10720,17482,4.51552361817916,18.2390403869181,1.13848768054376
"South Africa","South Africa","0","2021-01-03","2021-01-09",7,2021,"1",58775022,22863,3649,8912,13951,19214,6.20841962424106,23.7362735483111,1.56541741472172
"South Africa","South Africa","0","2021-01-10","2021-01-16",7,2021,"2",58775022,24300,4027,8645,15655,20273,6.85154996624246,26.6354642963809,1.81087333718913
"South Africa","South Africa","0","2021-01-17","2021-01-23",7,2021,"3",58775022,21091,3723,8504,12587,17368,6.33432344780747,21.4155598274383,1.48012699905927
"South Africa","South Africa","0","2021-01-24","2021-01-30",7,2021,"4",58775022,15224,3377,8282,6942,11847,5.74563800248344,11.8111397729464,0.838203332528375
"South Africa","South Africa","0","2021-01-31","2021-02-06",7,2021,"5",58775022,13179,2229,8488,4691,10950,3.79242733418288,7.98128157229784,0.552662582469369
"South Africa","South Africa","0","2021-02-07","2021-02-13",7,2021,"6",58775022,11412,1641,8668,2744,9771,2.79200235773625,4.66864989008426,0.316566682048915
"South Africa","South Africa","0","2021-02-14","2021-02-20",7,2021,"7",58775022,11255,1119,8427,2828,10136,1.90386998068669,4.81156774386235,0.335587990981369
