"country","region","region_code","start_date","end_date","days","year","week","population","total_deaths","covid_deaths","expected_deaths","excess_deaths","non_covid_deaths","covid_deaths_per_100k","excess_deaths_per_100k","excess_deaths_pct_change"
"South Africa","South Africa","0",2019-12-29,2020-01-04,7,2020,"1",59622350,10451,0,10099,352,10451,0,0.590382633358128,0.0348549361322903
"South Africa","South Africa","0",2020-01-05,2020-01-11,7,2020,"2",59622350,9676,0,9144,532,9676,0,0.89228284359808,0.0581802274715661
"South Africa","South Africa","0",2020-01-12,2020-01-18,7,2020,"3",59622350,9253,0,8957,296,9253,0,0.496458123505699,0.0330467790554874
"South Africa","South Africa","0",2020-01-19,2020-01-25,7,2020,"4",59622350,8621,0,8775,-154,8621,0,-0.258292402094181,-0.0175498575498575
"South Africa","South Africa","0",2020-01-26,2020-02-01,7,2020,"5",59622350,9409,0,9059,350,9409,0,0.587028186577684,0.0386356109945911
"South Africa","South Africa","0",2020-02-02,2020-02-08,7,2020,"6",59622350,10092,0,9225,867,10092,0,1.45415267932244,0.0939837398373984
"South Africa","South Africa","0",2020-02-09,2020-02-15,7,2020,"7",59622350,9277,0,8959,318,9277,0,0.533357038090582,0.0354950329277821
"South Africa","South Africa","0",2020-02-16,2020-02-22,7,2020,"8",59622350,9305,0,8838,467,9305,0,0.783263323233653,0.0528400090518217
"South Africa","South Africa","0",2020-02-23,2020-02-29,7,2020,"9",59622350,9013,0,9203,-190,9013,0,-0.318672444142171,-0.0206454417037922
"South Africa","South Africa","0",2020-03-01,2020-03-07,7,2020,"10",59622350,9830,0,9249,581,9830,0,0.974466789718956,0.0628176019029085
"South Africa","South Africa","0",2020-03-08,2020-03-14,7,2020,"11",59622350,9395,0,8996,399,9395,0,0.66921213269856,0.0443530457981325
"South Africa","South Africa","0",2020-03-15,2020-03-21,7,2020,"12",59622350,9111,0,8885,226,9111,0,0.379052486190162,0.025436128306134
"South Africa","South Africa","0",2020-03-22,2020-03-28,7,2020,"13",59622350,9041,1,9242,-201,9040,0.00167722339022196,-0.337121901434613,-0.0217485392772128
"South Africa","South Africa","0",2020-03-29,2020-04-04,7,2020,"14",59622350,8764,8,9481,-717,8756,0.0134177871217756,-1.20256917078914,-0.0756249340786836
"South Africa","South Africa","0",2020-04-05,2020-04-11,7,2020,"15",59622350,8761,16,9208,-447,8745,0.0268355742435513,-0.749718855429214,-0.0485447437011295
"South Africa","South Africa","0",2020-04-12,2020-04-18,7,2020,"16",59622350,8610,27,9212,-602,8583,0.0452850315359928,-1.00968848091362,-0.0653495440729484
"South Africa","South Africa","0",2020-04-19,2020-04-25,7,2020,"17",59622350,8425,34,9431,-1006,8391,0.0570255952675465,-1.68728673056329,-0.106669494221185
"South Africa","South Africa","0",2020-04-26,2020-05-02,7,2020,"18",59622350,8477,37,9981,-1504,8440,0.0620572654382123,-2.52254397889382,-0.150686303977557
"South Africa","South Africa","0",2020-05-03,2020-05-09,7,2020,"19",59622350,8935,63,9875,-940,8872,0.105665073583983,-1.57658998680864,-0.0951898734177216
"South Africa","South Africa","0",2020-05-10,2020-05-16,7,2020,"20",59622350,9063,75,9903,-840,8988,0.125791754266647,-1.40886764778644,-0.084822780975462
"South Africa","South Africa","0",2020-05-17,2020-05-23,7,2020,"21",59622350,9270,146,9696,-426,9124,0.244874614972405,-0.714497164234553,-0.0439356435643564
"South Africa","South Africa","0",2020-05-24,2020-05-30,7,2020,"22",59622350,9817,236,10408,-591,9581,0.395824720092381,-0.991239023621176,-0.056783243658724
"South Africa","South Africa","0",2020-05-31,2020-06-06,7,2020,"23",59622350,10505,309,11021,-516,10196,0.518262027578584,-0.865447269354529,-0.0468197078305054
"South Africa","South Africa","0",2020-06-07,2020-06-13,7,2020,"24",59622350,11005,471,11118,-113,10534,0.789972216794541,-0.189526243095081,-0.0101636985069257
"South Africa","South Africa","0",2020-06-14,2020-06-20,7,2020,"25",59622350,12396,454,10971,1425,11942,0.761459419160768,2.39004333106629,0.129887886245556
"South Africa","South Africa","0",2020-06-21,2020-06-27,7,2020,"26",59622350,12984,536,11023,1961,12448,0.898991737158968,3.28903506822525,0.177900752971061
"South Africa","South Africa","0",2020-06-28,2020-07-04,7,2020,"27",59622350,13956,613,11212,2744,13343,1.02813793820606,4.60230098276905,0.244737780948983
"South Africa","South Africa","0",2020-07-05,2020-07-11,7,2020,"28",59622350,15236,945,10913,4323,14291,1.58497610375975,7.25063671592951,0.396133052322918
"South Africa","South Africa","0",2020-07-12,2020-07-18,7,2020,"29",59622350,16707,977,10623,6084,15730,1.63864725224685,10.2042271061104,0.572719570742728
"South Africa","South Africa","0",2020-07-19,2020-07-25,7,2020,"30",59622350,16556,1707,10224,6332,14849,2.86302032710888,10.6201785068854,0.619327073552426
"South Africa","South Africa","0",2020-07-26,2020-08-01,7,2020,"31",59622350,15636,1498,10660,4976,14138,2.51248063855249,8.34586358974445,0.466791744840525
"South Africa","South Africa","0",2020-08-02,2020-08-08,7,2020,"32",59622350,14191,2057,10589,3602,12134,3.45004851368656,6.04135865157948,0.340164321465672
"South Africa","South Africa","0",2020-08-09,2020-08-15,7,2020,"33",59622350,12735,1467,10267,2468,11268,2.46048671345561,4.13938732706779,0.240381805785526
"South Africa","South Africa","0",2020-08-16,2020-08-22,7,2020,"34",59622350,12389,1310,10102,2287,11079,2.19716264119076,3.83580989343761,0.226390813700257
"South Africa","South Africa","0",2020-08-23,2020-08-29,7,2020,"35",59622350,11552,994,10086,1466,10558,1.66716004988062,2.45880949006539,0.145349990085267
"South Africa","South Africa","0",2020-08-30,2020-09-05,7,2020,"36",59622350,11373,798,10396,977,10575,1.33842426539712,1.63864725224685,0.0939784532512504
"South Africa","South Africa","0",2020-09-06,2020-09-12,7,2020,"37",59622350,10482,648,9900,582,9834,1.08684075686383,0.976144013109178,0.0587878787878788
"South Africa","South Africa","0",2020-09-13,2020-09-19,7,2020,"38",59622350,10004,513,9741,263,9491,0.860415599183863,0.441109751628374,0.0269992813879478
"South Africa","South Africa","0",2020-09-20,2020-09-26,7,2020,"39",59622350,10253,436,9641,612,9817,0.731269398136772,1.02646071481584,0.0634788922310963
"South Africa","South Africa","0",2020-09-27,2020-10-03,7,2020,"40",59622350,9936,562,10105,-169,9374,0.942599545304739,-0.28345075294751,-0.0167243938644236
"South Africa","South Africa","0",2020-10-04,2020-10-10,7,2020,"41",59622350,10516,735,9618,898,9781,1.23275919181314,1.50614660441932,0.0933666042836347
"South Africa","South Africa","0",2020-10-11,2020-10-17,7,2020,"42",59622350,10559,735,9295,1264,9824,1.23275919181314,2.12001036524055,0.135987089833244
"South Africa","South Africa","0",2020-10-18,2020-10-24,7,2020,"43",59622350,10444,536,9278,1166,9908,0.898991737158968,1.9556424729988,0.125673636559603
"South Africa","South Africa","0",2020-10-25,2020-10-31,7,2020,"44",59622350,10298,332,9568,730,9966,0.556838165553689,1.22437307486203,0.0762959866220736
"South Africa","South Africa","0",2020-11-01,2020-11-07,7,2020,"45",59622350,10472,513,9424,1048,9959,0.860415599183863,1.75773011295261,0.111205432937182
"South Africa","South Africa","0",2020-11-08,2020-11-14,7,2020,"46",59622350,10843,417,9141,1702,10426,0.699402153722555,2.85463421015777,0.186194070670605
"South Africa","South Africa","0",2020-11-15,2020-11-21,7,2020,"47",59622350,10730,639,9035,1695,10091,1.07174574635183,2.84289364642621,0.187603763143331
"South Africa","South Africa","0",2020-11-22,2020-11-28,7,2020,"48",59622350,10598,594,9591,1007,10004,0.996270693791842,1.68896395395351,0.104994265457199
"South Africa","South Africa","0",2020-11-29,2020-12-05,7,2020,"49",59622350,11867,628,9739,2128,11239,1.05329628905939,3.56913137439232,0.218502926378478
"South Africa","South Africa","0",2020-12-06,2020-12-12,7,2020,"50",59622350,12790,1039,9280,3510,11751,1.74263510244061,5.88705409967906,0.37823275862069
"South Africa","South Africa","0",2020-12-13,2020-12-19,7,2020,"51",59622350,14301,1433,9855,4446,12868,2.40346111818806,7.45693519292681,0.451141552511416
"South Africa","South Africa","0",2020-12-20,2020-12-26,7,2020,"52",59622350,17512,1982,9952,7560,15530,3.32425675941992,12.679808830078,0.759646302250804
"South Africa","South Africa","0",2020-12-27,2021-01-02,7,2020,"53",59622350,20217,2654,9825,10392,17563,4.45135087764907,17.4297054711866,1.05770992366412
"South Africa","South Africa","0",2021-01-03,2021-01-09,7,2021,"1",59622350,23477,3649,10099,13378,19828,6.12018815091992,22.4378945143893,1.32468561243688
"South Africa","South Africa","0",2021-01-10,2021-01-16,7,2021,"2",59622350,24929,4027,9144,15785,20902,6.75417859242381,26.4749712146536,1.72626859142607
"South Africa","South Africa","0",2021-01-17,2021-01-23,7,2021,"3",59622350,21778,3723,8957,12821,18055,6.24430268179634,21.5036810860357,1.43139444010271
"South Africa","South Africa","0",2021-01-24,2021-01-30,7,2021,"4",59622350,15802,3377,8775,7027,12425,5.66398338877954,11.7858487630897,0.800797720797721
"South Africa","South Africa","0",2021-01-31,2021-02-06,7,2021,"5",59622350,13808,2229,9059,4749,11579,3.73853093680474,7.96513388016407,0.524230047466608
"South Africa","South Africa","0",2021-02-07,2021-02-13,7,2021,"6",59622350,12168,1641,9225,2943,10527,2.75232358335423,4.93606843742321,0.319024390243903
"South Africa","South Africa","0",2021-02-14,2021-02-20,7,2021,"7",59622350,11428,1119,8959,2469,10309,1.87681297365837,4.14106455045801,0.27558879339212
"South Africa","South Africa","0",2021-02-21,2021-02-27,7,2021,"8",59622350,10701,1001,8838,1863,9700,1.67890061361218,3.1246671759835,0.210794297352342
"South Africa","South Africa","0",2021-02-28,2021-03-06,7,2021,"9",59622350,10960,706,9203,1757,10254,1.1841197134967,2.94688149661998,0.190916005650331
"South Africa","South Africa","0",2021-03-07,2021-03-13,7,2021,"10",59622350,10904,614,9249,1655,10290,1.02981516159628,2.77580471081734,0.178938263596064
"South Africa","South Africa","0",2021-03-14,2021-03-20,7,2021,"11",59622350,10147,821,8996,1151,9326,1.37700040337223,1.93048412214547,0.127945753668297
"South Africa","South Africa","0",2021-03-21,2021-03-27,7,2021,"12",59622350,10153,566,8885,1268,9587,0.949308438865627,2.12671925880144,0.142712436691052
"South Africa","South Africa","0",2021-03-28,2021-04-03,7,2021,"13",59622350,10600,306,9242,1358,10294,0.513230357407918,2.27766936392142,0.146937892231119
"South Africa","South Africa","0",2021-04-04,2021-04-10,7,2021,"14",59622350,10831,302,9481,1350,10529,0.50652146384703,2.26425157679964,0.142390043244383
"South Africa","South Africa","0",2021-04-11,2021-04-17,7,2021,"15",59622350,10786,455,9208,1578,10331,0.76313664255099,2.64665850977025,0.171372719374457
"South Africa","South Africa","0",2021-04-18,2021-04-24,7,2021,"16",59622350,10617,414,9212,1405,10203,0.694370483551889,2.35649886326185,0.152518454190187
"South Africa","South Africa","0",2021-04-25,2021-05-01,7,2021,"17",59622350,10911,281,9431,1480,10630,0.471299772652369,2.48229061752849,0.156929275792599
"South Africa","South Africa","0",2021-05-02,2021-05-08,7,2021,"18",59622350,11441,281,9981,1460,11160,0.471299772652369,2.44874614972405,0.14627792806332
"South Africa","South Africa","0",2021-05-09,2021-05-15,7,2021,"19",59622350,11683,496,9875,1808,11187,0.83190280155009,3.0324198895213,0.183088607594937
"South Africa","South Africa","0",2021-05-16,2021-05-22,7,2021,"20",59622350,11743,589,9903,1840,11154,0.987884576840732,3.0860910380084,0.185802282136726
"South Africa","South Africa","0",2021-05-23,2021-05-29,7,2021,"21",59622350,12245,591,9696,2549,11654,0.991239023621176,4.27524242167576,0.262891914191419
"South Africa","South Africa","0",2021-05-30,2021-06-05,7,2021,"22",59622350,13521,566,10408,3113,12955,0.949308438865627,5.22119641376095,0.299096848578017
"South Africa","South Africa","0",2021-06-06,2021-06-12,7,2021,"23",59622350,14295,777,11021,3274,13518,1.30320257420246,5.49122937958668,0.297069231467199
"South Africa","South Africa","0",2021-06-13,2021-06-19,7,2021,"24",59622350,13885,884,11118,2767,13001,1.48266547695621,4.64087712074415,0.248875697067818
"South Africa","South Africa","0",2021-06-20,2021-06-26,7,2021,"25",59622350,15666,1188,10971,4695,14478,1.99254138758368,7.87456381709208,0.427946404156412
"South Africa","South Africa","0",2021-06-27,2021-07-03,7,2021,"26",59622350,17269,1729,11023,6246,15540,2.89991924169376,10.4759372953263,0.566633402884877
"South Africa","South Africa","0",2021-07-04,2021-07-10,7,2021,"27",59622350,18756,2631,11212,7544,16125,4.41277473967396,12.6529732558344,0.67285051730289
"South Africa","South Africa","0",2021-07-11,2021-07-17,7,2021,"28",59622350,21203,2538,10913,10290,18665,4.25679296438332,17.2586286853839,0.942912123155869
"South Africa","South Africa","0",2021-07-18,2021-07-24,7,2021,"29",59622350,20231,2812,10623,9608,17419,4.71635217330414,16.1147623332525,0.904452602842888
"South Africa","South Africa","0",2021-07-25,2021-07-31,7,2021,"30",59622350,18831,2525,10224,8607,16306,4.23498906031044,14.4358617196404,0.841842723004695
"South Africa","South Africa","0",2021-08-01,2021-08-07,7,2021,"31",59622350,16800,2610,10660,6140,14190,4.3775530484793,10.2981516159628,0.575984990619137
"South Africa","South Africa","0",2021-08-08,2021-08-14,7,2021,"32",59622350,15989,2246,10589,5400,13743,3.76704373443851,9.05700630719856,0.50996316932666
