"country","region","region_code","start_date","end_date","days","year","week","population","total_deaths","covid_deaths","expected_deaths","excess_deaths","non_covid_deaths","covid_deaths_per_100k","excess_deaths_per_100k","excess_deaths_pct_change"
"South Africa","South Africa","0",2019-12-29,2020-01-04,7,2020,"1",59622350,9922,0,9002,920,9922,0,1.5430455190042,0.102199511219729
"South Africa","South Africa","0",2020-01-05,2020-01-11,7,2020,"2",59622350,9112,0,8740,372,9112,0,0.623927101162567,0.0425629290617848
"South Africa","South Africa","0",2020-01-12,2020-01-18,7,2020,"3",59622350,8678,0,8598,80,8678,0,0.134177871217756,0.00930448941614337
"South Africa","South Africa","0",2020-01-19,2020-01-25,7,2020,"4",59622350,8179,0,8370,-191,8179,0,-0.320349667532393,-0.0228195937873357
"South Africa","South Africa","0",2020-01-26,2020-02-01,7,2020,"5",59622350,8810,0,8575,235,8810,0,0.394147496702159,0.027405247813411
"South Africa","South Africa","0",2020-02-02,2020-02-08,7,2020,"6",59622350,9313,0,8758,555,9313,0,0.930858981573185,0.0633706325645125
"South Africa","South Africa","0",2020-02-09,2020-02-15,7,2020,"7",59622350,8617,0,8515,102,8617,0,0.171076785802639,0.0119788608338227
"South Africa","South Africa","0",2020-02-16,2020-02-22,7,2020,"8",59622350,8660,0,8345,315,8660,0,0.528325367919916,0.0377471539844219
"South Africa","South Africa","0",2020-02-23,2020-02-29,7,2020,"9",59622350,8368,0,8718,-350,8368,0,-0.587028186577684,-0.040146822665749
"South Africa","South Africa","0",2020-03-01,2020-03-07,7,2020,"10",59622350,9289,0,8740,549,9289,0,0.920795641231854,0.0628146453089244
"South Africa","South Africa","0",2020-03-08,2020-03-14,7,2020,"11",59622350,8800,0,8512,288,8800,0,0.483040336383923,0.0338345864661653
"South Africa","South Africa","0",2020-03-15,2020-03-21,7,2020,"12",59622350,8597,0,8413,184,8597,0,0.30860910380084,0.0218709140615714
"South Africa","South Africa","0",2020-03-22,2020-03-28,7,2020,"13",59622350,8447,1,8717,-270,8446,0.00167722339022196,-0.452850315359928,-0.0309739589308248
"South Africa","South Africa","0",2020-03-29,2020-04-04,7,2020,"14",59622350,8241,8,8957,-716,8233,0.0134177871217756,-1.20089194739892,-0.0799374790666518
"South Africa","South Africa","0",2020-04-05,2020-04-11,7,2020,"15",59622350,8257,16,8753,-496,8241,0.0268355742435513,-0.83190280155009,-0.0566662858448532
"South Africa","South Africa","0",2020-04-12,2020-04-18,7,2020,"16",59622350,8126,27,8782,-656,8099,0.0452850315359928,-1.1002585439856,-0.0746982464131177
"South Africa","South Africa","0",2020-04-19,2020-04-25,7,2020,"17",59622350,7959,34,8965,-1006,7925,0.0570255952675465,-1.68728673056329,-0.112214166201896
"South Africa","South Africa","0",2020-04-26,2020-05-02,7,2020,"18",59622350,8032,37,9444,-1412,7995,0.0620572654382123,-2.3682394269934,-0.149512918254977
"South Africa","South Africa","0",2020-05-03,2020-05-09,7,2020,"19",59622350,8510,63,9380,-870,8447,0.105665073583983,-1.4591843494931,-0.0927505330490405
"South Africa","South Africa","0",2020-05-10,2020-05-16,7,2020,"20",59622350,8657,75,9440,-783,8582,0.125791754266647,-1.31326591454379,-0.0829449152542373
"South Africa","South Africa","0",2020-05-17,2020-05-23,7,2020,"21",59622350,8883,146,9250,-367,8737,0.244874614972405,-0.615540984211458,-0.0396756756756756
"South Africa","South Africa","0",2020-05-24,2020-05-30,7,2020,"22",59622350,9450,236,9909,-459,9214,0.395824720092381,-0.769845536111877,-0.0463215258855586
"South Africa","South Africa","0",2020-05-31,2020-06-06,7,2020,"23",59622350,10158,309,10493,-335,9849,0.518262027578584,-0.561869835724355,-0.0319260459353855
"South Africa","South Africa","0",2020-06-07,2020-06-13,7,2020,"24",59622350,10636,471,10629,7,10165,0.789972216794541,0.0117405637315537,0.000658575595070099
"South Africa","South Africa","0",2020-06-14,2020-06-20,7,2020,"25",59622350,11980,454,10529,1451,11526,0.761459419160768,2.43365113921206,0.137809858486086
"South Africa","South Africa","0",2020-06-21,2020-06-27,7,2020,"26",59622350,12541,536,10595,1946,12005,0.898991737158968,3.26387671737193,0.183671543180746
"South Africa","South Africa","0",2020-06-28,2020-07-04,7,2020,"27",59622350,13525,613,10806,2719,12912,1.02813793820606,4.5603703980135,0.251619470664446
"South Africa","South Africa","0",2020-07-05,2020-07-11,7,2020,"28",59622350,14775,945,10507,4268,13830,1.58497610375975,7.15838942946731,0.406205386884934
"South Africa","South Africa","0",2020-07-12,2020-07-18,7,2020,"29",59622350,16256,977,10239,6017,15279,1.63864725224685,10.0918531389655,0.587655044437933
"South Africa","South Africa","0",2020-07-19,2020-07-25,7,2020,"30",59622350,16206,1707,9888,6318,14499,2.86302032710888,10.5966973794223,0.638956310679612
"South Africa","South Africa","0",2020-07-26,2020-08-01,7,2020,"31",59622350,15266,1498,10251,5015,13768,2.51248063855249,8.41127530196311,0.48922056384743
"South Africa","South Africa","0",2020-08-02,2020-08-08,7,2020,"32",59622350,13724,2057,10121,3603,11667,3.45004851368656,6.04303587496971,0.355992490860587
"South Africa","South Africa","0",2020-08-09,2020-08-15,7,2020,"33",59622350,12389,1467,9851,2538,10922,2.46048671345561,4.25679296438332,0.257638818394072
"South Africa","South Africa","0",2020-08-16,2020-08-22,7,2020,"34",59622350,11958,1310,9722,2236,10648,2.19716264119076,3.75027150053629,0.229993828430364
"South Africa","South Africa","0",2020-08-23,2020-08-29,7,2020,"35",59622350,11158,994,9700,1458,10164,1.66716004988062,2.44539170294361,0.150309278350516
"South Africa","South Africa","0",2020-08-30,2020-09-05,7,2020,"36",59622350,10927,798,10011,916,10129,1.33842426539712,1.53633662544331,0.0914993507142143
"South Africa","South Africa","0",2020-09-06,2020-09-12,7,2020,"37",59622350,10066,648,9521,545,9418,1.08684075686383,0.914086747670966,0.0572418863564752
"South Africa","South Africa","0",2020-09-13,2020-09-19,7,2020,"38",59622350,9570,513,9394,176,9057,0.860415599183863,0.295191316679064,0.0187353629976581
"South Africa","South Africa","0",2020-09-20,2020-09-26,7,2020,"39",59622350,9863,436,9267,596,9427,0.731269398136772,0.999625140572285,0.0643142333009603
"South Africa","South Africa","0",2020-09-27,2020-10-03,7,2020,"40",59622350,9505,562,9672,-167,8943,0.942599545304739,-0.280096306167067,-0.0172663358147229
"South Africa","South Africa","0",2020-10-04,2020-10-10,7,2020,"41",59622350,10068,735,9266,802,9333,1.23275919181314,1.34513315895801,0.0865529894236996
"South Africa","South Africa","0",2020-10-11,2020-10-17,7,2020,"42",59622350,10127,735,8962,1165,9392,1.23275919181314,1.95396524960858,0.129993305065834
"South Africa","South Africa","0",2020-10-18,2020-10-24,7,2020,"43",59622350,9948,536,8961,987,9412,0.898991737158968,1.65541948614907,0.11014395714764
"South Africa","South Africa","0",2020-10-25,2020-10-31,7,2020,"44",59622350,9823,332,9191,632,9491,0.556838165553689,1.06000518262028,0.0687629202480688
"South Africa","South Africa","0",2020-11-01,2020-11-07,7,2020,"45",59622350,9968,513,9063,905,9455,0.860415599183863,1.51788716815087,0.0998565596380889
"South Africa","South Africa","0",2020-11-08,2020-11-14,7,2020,"46",59622350,10298,417,8825,1473,9881,0.699402153722555,2.47055005379694,0.166912181303116
"South Africa","South Africa","0",2020-11-15,2020-11-21,7,2020,"47",59622350,10296,639,8715,1581,9657,1.07174574635183,2.65169017994091,0.181411359724613
"South Africa","South Africa","0",2020-11-22,2020-11-28,7,2020,"48",59622350,10117,594,9239,878,9523,0.996270693791842,1.47260213661488,0.0950319298625393
"South Africa","South Africa","0",2020-11-29,2020-12-05,7,2020,"49",59622350,11356,628,9379,1977,10728,1.05329628905939,3.31587064246881,0.210790062906493
"South Africa","South Africa","0",2020-12-06,2020-12-12,7,2020,"50",59622350,12314,1039,9015,3299,11275,1.74263510244061,5.53315996434223,0.365945646145313
"South Africa","South Africa","0",2020-12-13,2020-12-19,7,2020,"51",59622350,13686,1433,9528,4158,12253,2.40346111818806,6.97389485654289,0.43639798488665
"South Africa","South Africa","0",2020-12-20,2020-12-26,7,2020,"52",59622350,17013,1982,9632,7381,15031,3.32425675941992,12.3795858432283,0.766299833887043
"South Africa","South Africa","0",2020-12-27,2021-01-02,7,2020,"53",59622350,19695,2654,9416,10279,17041,4.45135087764907,17.2401792280915,1.09165250637213
"South Africa","South Africa","0",2021-01-03,2021-01-09,7,2021,"1",59622350,22935,3649,9002,13933,19286,6.12018815091992,23.3687534959625,1.5477671628527
"South Africa","South Africa","0",2021-01-10,2021-01-16,7,2021,"2",59622350,24378,4027,8740,15638,20351,6.75417859242381,26.2284193762909,1.78924485125858
"South Africa","South Africa","0",2021-01-17,2021-01-23,7,2021,"3",59622350,21180,3723,8598,12582,17457,6.24430268179634,21.1028246957726,1.46336357292394
"South Africa","South Africa","0",2021-01-24,2021-01-30,7,2021,"4",59622350,15322,3377,8370,6952,11945,5.66398338877954,11.660057008823,0.830585424133811
"South Africa","South Africa","0",2021-01-31,2021-02-06,7,2021,"5",59622350,13304,2229,8575,4729,11075,3.73853093680474,7.93158941235963,0.551486880466472
"South Africa","South Africa","0",2021-02-07,2021-02-13,7,2021,"6",59622350,11651,1641,8758,2893,10010,2.75232358335423,4.85220726791212,0.330326558575017
"South Africa","South Africa","0",2021-02-14,2021-02-20,7,2021,"7",59622350,10921,1119,8515,2406,9802,1.87681297365837,4.03539947687402,0.282560187903699
"South Africa","South Africa","0",2021-02-21,2021-02-27,7,2021,"8",59622350,10056,1001,8345,1711,9055,1.67890061361218,2.86972922066977,0.20503295386459
"South Africa","South Africa","0",2021-02-28,2021-03-06,7,2021,"9",59622350,10385,706,8718,1667,9679,1.1841197134967,2.7959313915,0.191213581096582
"South Africa","South Africa","0",2021-03-07,2021-03-13,7,2021,"10",59622350,10312,614,8740,1572,9698,1.02981516159628,2.63659516942891,0.179862700228833
"South Africa","South Africa","0",2021-03-14,2021-03-20,7,2021,"11",59622350,9581,821,8512,1069,8760,1.37700040337223,1.79295180414727,0.125587406015037
"South Africa","South Africa","0",2021-03-21,2021-03-27,7,2021,"12",59622350,9483,566,8413,1070,8917,0.949308438865627,1.79462902753749,0.127184119814573
"South Africa","South Africa","0",2021-03-28,2021-04-03,7,2021,"13",59622350,10018,306,8717,1301,9712,0.513230357407918,2.18206763067876,0.149248594700012
"South Africa","South Africa","0",2021-04-04,2021-04-10,7,2021,"14",59622350,10236,302,8957,1279,9934,0.50652146384703,2.14516871609388,0.142793345986379
"South Africa","South Africa","0",2021-04-11,2021-04-17,7,2021,"15",59622350,10112,455,8753,1359,9657,0.76313664255099,2.27934658731164,0.155261053353136
"South Africa","South Africa","0",2021-04-18,2021-04-24,7,2021,"16",59622350,9996,414,8782,1214,9582,0.694370483551889,2.03614919572945,0.138237303575495
"South Africa","South Africa","0",2021-04-25,2021-05-01,7,2021,"17",59622350,10283,281,8965,1318,10002,0.471299772652369,2.21058042831254,0.147016174010039
"South Africa","South Africa","0",2021-05-02,2021-05-08,7,2021,"18",59622350,10863,281,9444,1419,10582,0.471299772652369,2.37997999072495,0.150254129606099
"South Africa","South Africa","0",2021-05-09,2021-05-15,7,2021,"19",59622350,11079,496,9380,1699,10583,0.83190280155009,2.8496025399871,0.181130063965885
"South Africa","South Africa","0",2021-05-16,2021-05-22,7,2021,"20",59622350,11025,589,9440,1585,10436,0.987884576840732,2.6583990735018,0.167902542372881
"South Africa","South Africa","0",2021-05-23,2021-05-29,7,2021,"21",59622350,11553,591,9250,2303,10962,0.991239023621176,3.86264546768116,0.248972972972973
"South Africa","South Africa","0",2021-05-30,2021-06-05,7,2021,"22",59622350,12669,566,9909,2760,12103,0.949308438865627,4.6291365570126,0.278534665455646
"South Africa","South Africa","0",2021-06-06,2021-06-12,7,2021,"23",59622350,13437,777,10493,2944,12660,1.30320257420246,4.93774566081344,0.280567997712761
"South Africa","South Africa","0",2021-06-13,2021-06-19,7,2021,"24",59622350,13143,884,10629,2514,12259,1.48266547695621,4.216539603018,0.23652272085803
"South Africa","South Africa","0",2021-06-20,2021-06-26,7,2021,"25",59622350,14816,1188,10529,4287,13628,1.99254138758368,7.19025667388152,0.407161173900655
"South Africa","South Africa","0",2021-06-27,2021-07-03,7,2021,"26",59622350,16349,1729,10595,5754,14620,2.89991924169376,9.65074338733713,0.54308636149127
"South Africa","South Africa","0",2021-07-04,2021-07-10,7,2021,"27",59622350,17242,2631,10806,6436,14611,4.41277473967396,10.7946097394685,0.595595039792708
"South Africa","South Africa","0",2021-07-11,2021-07-17,7,2021,"28",59622350,20131,2538,10507,9624,17593,4.25679296438332,16.1415979074961,0.915960788046065
