"country","region","region_code","start_date","end_date","days","year","week","population","total_deaths","covid_deaths","expected_deaths","excess_deaths","non_covid_deaths","covid_deaths_per_100k","excess_deaths_per_100k","excess_deaths_pct_change"
"South Africa","South Africa","0",2019-12-29,2020-01-04,7,2020,"1",59622350,10452,0,10099,353,10452,0,0.59205985674835,0.0349539558372116
"South Africa","South Africa","0",2020-01-05,2020-01-11,7,2020,"2",59622350,9676,0,9144,532,9676,0,0.89228284359808,0.0581802274715661
"South Africa","South Africa","0",2020-01-12,2020-01-18,7,2020,"3",59622350,9253,0,8957,296,9253,0,0.496458123505699,0.0330467790554874
"South Africa","South Africa","0",2020-01-19,2020-01-25,7,2020,"4",59622350,8622,0,8775,-153,8622,0,-0.256615178703959,-0.0174358974358975
"South Africa","South Africa","0",2020-01-26,2020-02-01,7,2020,"5",59622350,9409,0,9059,350,9409,0,0.587028186577684,0.0386356109945911
"South Africa","South Africa","0",2020-02-02,2020-02-08,7,2020,"6",59622350,10092,0,9225,867,10092,0,1.45415267932244,0.0939837398373984
"South Africa","South Africa","0",2020-02-09,2020-02-15,7,2020,"7",59622350,9277,0,8959,318,9277,0,0.533357038090582,0.0354950329277821
"South Africa","South Africa","0",2020-02-16,2020-02-22,7,2020,"8",59622350,9305,0,8838,467,9305,0,0.783263323233653,0.0528400090518217
"South Africa","South Africa","0",2020-02-23,2020-02-29,7,2020,"9",59622350,9015,0,9203,-188,9015,0,-0.315317997361728,-0.020428121264805
"South Africa","South Africa","0",2020-03-01,2020-03-07,7,2020,"10",59622350,9830,0,9249,581,9830,0,0.974466789718956,0.0628176019029085
"South Africa","South Africa","0",2020-03-08,2020-03-14,7,2020,"11",59622350,9395,0,8996,399,9395,0,0.66921213269856,0.0443530457981325
"South Africa","South Africa","0",2020-03-15,2020-03-21,7,2020,"12",59622350,9111,0,8885,226,9111,0,0.379052486190162,0.025436128306134
"South Africa","South Africa","0",2020-03-22,2020-03-28,7,2020,"13",59622350,9041,1,9242,-201,9040,0.00167722339022196,-0.337121901434613,-0.0217485392772128
"South Africa","South Africa","0",2020-03-29,2020-04-04,7,2020,"14",59622350,8764,8,9481,-717,8756,0.0134177871217756,-1.20256917078914,-0.0756249340786836
"South Africa","South Africa","0",2020-04-05,2020-04-11,7,2020,"15",59622350,8761,16,9208,-447,8745,0.0268355742435513,-0.749718855429214,-0.0485447437011295
"South Africa","South Africa","0",2020-04-12,2020-04-18,7,2020,"16",59622350,8610,27,9212,-602,8583,0.0452850315359928,-1.00968848091362,-0.0653495440729484
"South Africa","South Africa","0",2020-04-19,2020-04-25,7,2020,"17",59622350,8425,34,9431,-1006,8391,0.0570255952675465,-1.68728673056329,-0.106669494221185
"South Africa","South Africa","0",2020-04-26,2020-05-02,7,2020,"18",59622350,8476,37,9981,-1505,8439,0.0620572654382123,-2.52422120228404,-0.150786494339245
"South Africa","South Africa","0",2020-05-03,2020-05-09,7,2020,"19",59622350,8935,63,9875,-940,8872,0.105665073583983,-1.57658998680864,-0.0951898734177216
"South Africa","South Africa","0",2020-05-10,2020-05-16,7,2020,"20",59622350,9063,75,9903,-840,8988,0.125791754266647,-1.40886764778644,-0.084822780975462
"South Africa","South Africa","0",2020-05-17,2020-05-23,7,2020,"21",59622350,9270,146,9696,-426,9124,0.244874614972405,-0.714497164234553,-0.0439356435643564
"South Africa","South Africa","0",2020-05-24,2020-05-30,7,2020,"22",59622350,9817,236,10408,-591,9581,0.395824720092381,-0.991239023621176,-0.056783243658724
"South Africa","South Africa","0",2020-05-31,2020-06-06,7,2020,"23",59622350,10505,309,11021,-516,10196,0.518262027578584,-0.865447269354529,-0.0468197078305054
"South Africa","South Africa","0",2020-06-07,2020-06-13,7,2020,"24",59622350,11005,471,11118,-113,10534,0.789972216794541,-0.189526243095081,-0.0101636985069257
"South Africa","South Africa","0",2020-06-14,2020-06-20,7,2020,"25",59622350,12396,454,10971,1425,11942,0.761459419160768,2.39004333106629,0.129887886245556
"South Africa","South Africa","0",2020-06-21,2020-06-27,7,2020,"26",59622350,12984,536,11023,1961,12448,0.898991737158968,3.28903506822525,0.177900752971061
"South Africa","South Africa","0",2020-06-28,2020-07-04,7,2020,"27",59622350,13956,613,11212,2744,13343,1.02813793820606,4.60230098276905,0.244737780948983
"South Africa","South Africa","0",2020-07-05,2020-07-11,7,2020,"28",59622350,15236,945,10913,4323,14291,1.58497610375975,7.25063671592951,0.396133052322918
"South Africa","South Africa","0",2020-07-12,2020-07-18,7,2020,"29",59622350,16709,977,10623,6086,15732,1.63864725224685,10.2075815528908,0.572907841476042
"South Africa","South Africa","0",2020-07-19,2020-07-25,7,2020,"30",59622350,16556,1707,10224,6332,14849,2.86302032710888,10.6201785068854,0.619327073552426
"South Africa","South Africa","0",2020-07-26,2020-08-01,7,2020,"31",59622350,15635,1498,10660,4975,14137,2.51248063855249,8.34418636635423,0.466697936210131
"South Africa","South Africa","0",2020-08-02,2020-08-08,7,2020,"32",59622350,14191,2057,10589,3602,12134,3.45004851368656,6.04135865157948,0.340164321465672
"South Africa","South Africa","0",2020-08-09,2020-08-15,7,2020,"33",59622350,12735,1467,10267,2468,11268,2.46048671345561,4.13938732706779,0.240381805785526
"South Africa","South Africa","0",2020-08-16,2020-08-22,7,2020,"34",59622350,12389,1310,10102,2287,11079,2.19716264119076,3.83580989343761,0.226390813700257
"South Africa","South Africa","0",2020-08-23,2020-08-29,7,2020,"35",59622350,11554,994,10086,1468,10560,1.66716004988062,2.46216393684583,0.14554828475114
"South Africa","South Africa","0",2020-08-30,2020-09-05,7,2020,"36",59622350,11373,798,10396,977,10575,1.33842426539712,1.63864725224685,0.0939784532512504
"South Africa","South Africa","0",2020-09-06,2020-09-12,7,2020,"37",59622350,10482,648,9900,582,9834,1.08684075686383,0.976144013109178,0.0587878787878788
"South Africa","South Africa","0",2020-09-13,2020-09-19,7,2020,"38",59622350,10004,513,9741,263,9491,0.860415599183863,0.441109751628374,0.0269992813879478
"South Africa","South Africa","0",2020-09-20,2020-09-26,7,2020,"39",59622350,10254,436,9641,613,9818,0.731269398136772,1.02813793820606,0.0635826159112125
"South Africa","South Africa","0",2020-09-27,2020-10-03,7,2020,"40",59622350,9936,562,10105,-169,9374,0.942599545304739,-0.28345075294751,-0.0167243938644236
"South Africa","South Africa","0",2020-10-04,2020-10-10,7,2020,"41",59622350,10518,735,9618,900,9783,1.23275919181314,1.50950105119976,0.0935745477230194
"South Africa","South Africa","0",2020-10-11,2020-10-17,7,2020,"42",59622350,10561,735,9295,1266,9826,1.23275919181314,2.123364812021,0.136202259279182
"South Africa","South Africa","0",2020-10-18,2020-10-24,7,2020,"43",59622350,10447,536,9278,1169,9911,0.898991737158968,1.96067414316947,0.125996982108213
"South Africa","South Africa","0",2020-10-25,2020-10-31,7,2020,"44",59622350,10299,332,9568,731,9967,0.556838165553689,1.22605029825225,0.0764005016722409
"South Africa","South Africa","0",2020-11-01,2020-11-07,7,2020,"45",59622350,10473,513,9424,1049,9960,0.860415599183863,1.75940733634283,0.111311544991511
"South Africa","South Africa","0",2020-11-08,2020-11-14,7,2020,"46",59622350,10844,417,9141,1703,10427,0.699402153722555,2.85631143354799,0.186303467891916
"South Africa","South Africa","0",2020-11-15,2020-11-21,7,2020,"47",59622350,10731,639,9035,1696,10092,1.07174574635183,2.84457086981644,0.187714443829552
"South Africa","South Africa","0",2020-11-22,2020-11-28,7,2020,"48",59622350,10598,594,9591,1007,10004,0.996270693791842,1.68896395395351,0.104994265457199
"South Africa","South Africa","0",2020-11-29,2020-12-05,7,2020,"49",59622350,11871,628,9739,2132,11243,1.05329628905939,3.57584026795321,0.218913646164904
"South Africa","South Africa","0",2020-12-06,2020-12-12,7,2020,"50",59622350,12791,1039,9280,3511,11752,1.74263510244061,5.88873132306929,0.378340517241379
"South Africa","South Africa","0",2020-12-13,2020-12-19,7,2020,"51",59622350,14301,1433,9855,4446,12868,2.40346111818806,7.45693519292681,0.451141552511416
"South Africa","South Africa","0",2020-12-20,2020-12-26,7,2020,"52",59622350,17513,1982,9952,7561,15531,3.32425675941992,12.6814860534682,0.759746784565916
"South Africa","South Africa","0",2020-12-27,2021-01-02,7,2020,"53",59622350,20219,2654,9825,10394,17565,4.45135087764907,17.433059917967,1.05791348600509
"South Africa","South Africa","0",2021-01-03,2021-01-09,7,2021,"1",59622350,23486,3649,10099,13387,19837,6.12018815091992,22.4529895249013,1.32557678978117
"South Africa","South Africa","0",2021-01-10,2021-01-16,7,2021,"2",59622350,24932,4027,9144,15788,20905,6.75417859242381,26.4800028848242,1.72659667541557
"South Africa","South Africa","0",2021-01-17,2021-01-23,7,2021,"3",59622350,21782,3723,8957,12825,18059,6.24430268179634,21.5103899795966,1.43184101819806
"South Africa","South Africa","0",2021-01-24,2021-01-30,7,2021,"4",59622350,15802,3377,8775,7027,12425,5.66398338877954,11.7858487630897,0.800797720797721
"South Africa","South Africa","0",2021-01-31,2021-02-06,7,2021,"5",59622350,13809,2229,9059,4750,11580,3.73853093680474,7.96681110355429,0.524340434926592
"South Africa","South Africa","0",2021-02-07,2021-02-13,7,2021,"6",59622350,12170,1641,9225,2945,10529,2.75232358335423,4.93942288420366,0.319241192411924
"South Africa","South Africa","0",2021-02-14,2021-02-20,7,2021,"7",59622350,11428,1119,8959,2469,10309,1.87681297365837,4.14106455045801,0.27558879339212
"South Africa","South Africa","0",2021-02-21,2021-02-27,7,2021,"8",59622350,10702,1001,8838,1864,9701,1.67890061361218,3.12634439937372,0.210907445123331
"South Africa","South Africa","0",2021-02-28,2021-03-06,7,2021,"9",59622350,10962,706,9203,1759,10256,1.1841197134967,2.95023594340042,0.191133326089319
"South Africa","South Africa","0",2021-03-07,2021-03-13,7,2021,"10",59622350,10904,614,9249,1655,10290,1.02981516159628,2.77580471081734,0.178938263596064
"South Africa","South Africa","0",2021-03-14,2021-03-20,7,2021,"11",59622350,10151,821,8996,1155,9330,1.37700040337223,1.93719301570636,0.128390395731436
"South Africa","South Africa","0",2021-03-21,2021-03-27,7,2021,"12",59622350,10162,566,8885,1277,9596,0.949308438865627,2.14181426931344,0.143725379853686
"South Africa","South Africa","0",2021-03-28,2021-04-03,7,2021,"13",59622350,10604,306,9242,1362,10298,0.513230357407918,2.2843782574823,0.147370698982904
"South Africa","South Africa","0",2021-04-04,2021-04-10,7,2021,"14",59622350,10836,302,9481,1355,10534,0.50652146384703,2.27263769375075,0.142917413774918
"South Africa","South Africa","0",2021-04-11,2021-04-17,7,2021,"15",59622350,10794,455,9208,1586,10339,0.76313664255099,2.66007629689202,0.172241529105126
"South Africa","South Africa","0",2021-04-18,2021-04-24,7,2021,"16",59622350,10619,414,9212,1407,10205,0.694370483551889,2.35985331004229,0.15273556231003
"South Africa","South Africa","0",2021-04-25,2021-05-01,7,2021,"17",59622350,10913,281,9431,1482,10632,0.471299772652369,2.48564506430894,0.157141342381508
"South Africa","South Africa","0",2021-05-02,2021-05-08,7,2021,"18",59622350,11449,281,9981,1468,11168,0.471299772652369,2.46216393684583,0.147079450956818
"South Africa","South Africa","0",2021-05-09,2021-05-15,7,2021,"19",59622350,11690,496,9875,1815,11194,0.83190280155009,3.04416045325285,0.18379746835443
"South Africa","South Africa","0",2021-05-16,2021-05-22,7,2021,"20",59622350,11754,589,9903,1851,11165,0.987884576840732,3.10454049530084,0.1869130566495
"South Africa","South Africa","0",2021-05-23,2021-05-29,7,2021,"21",59622350,12254,591,9696,2558,11663,0.991239023621176,4.29033743218776,0.263820132013201
"South Africa","South Africa","0",2021-05-30,2021-06-05,7,2021,"22",59622350,13527,566,10408,3119,12961,0.949308438865627,5.23125975410228,0.29967332820907
"South Africa","South Africa","0",2021-06-06,2021-06-12,7,2021,"23",59622350,14305,777,11021,3284,13528,1.30320257420246,5.5080016134889,0.297976590146085
"South Africa","South Africa","0",2021-06-13,2021-06-19,7,2021,"24",59622350,13901,884,11118,2783,13017,1.48266547695621,4.6677126949877,0.250314804821011
"South Africa","South Africa","0",2021-06-20,2021-06-26,7,2021,"25",59622350,15683,1188,10971,4712,14495,1.99254138758368,7.90307661472585,0.429495943851973
"South Africa","South Africa","0",2021-06-27,2021-07-03,7,2021,"26",59622350,17296,1729,11023,6273,15567,2.89991924169376,10.5212223268623,0.569082826816656
"South Africa","South Africa","0",2021-07-04,2021-07-10,7,2021,"27",59622350,18802,2631,11212,7590,16171,4.41277473967396,12.7301255317846,0.676953264359615
"South Africa","South Africa","0",2021-07-11,2021-07-17,7,2021,"28",59622350,21262,2538,10913,10349,18724,4.25679296438332,17.357584865407,0.948318519197288
"South Africa","South Africa","0",2021-07-18,2021-07-24,7,2021,"29",59622350,20318,2812,10623,9695,17506,4.71635217330414,16.2606807682019,0.912642379742069
"South Africa","South Africa","0",2021-07-25,2021-07-31,7,2021,"30",59622350,18988,2525,10224,8764,16463,4.23498906031044,14.6991857919052,0.857198748043819
"South Africa","South Africa","0",2021-08-01,2021-08-07,7,2021,"31",59622350,17312,2610,10660,6652,14702,4.3775530484793,11.1568899917564,0.624015009380863
"South Africa","South Africa","0",2021-08-08,2021-08-14,7,2021,"32",59622350,15511,2246,10589,4922,13265,3.76704373443851,8.25529352667246,0.464821985078856
"South Africa","South Africa","0",2021-08-15,2021-08-21,7,2021,"33",59622350,15579,2382,10267,5312,13197,3.9951461155087,8.90941064885903,0.517385799162365
"South Africa","South Africa","0",2021-08-22,2021-08-28,7,2021,"34",59622350,14482,2210,10102,4380,12272,3.70666369239052,7.34623844917216,0.433577509404078
"South Africa","South Africa","0",2021-08-29,2021-09-04,7,2021,"35",59622350,14482,1882,10086,4396,12600,3.15653442039772,7.37307402341572,0.435851675589927
