"country","region","region_code","start_date","end_date","days","year","week","population","total_deaths","covid_deaths","expected_deaths","excess_deaths","non_covid_deaths","covid_deaths_per_100k","excess_deaths_per_100k","excess_deaths_pct_change"
"United States","Alabama","AL",2019-12-29,2020-01-04,7,2020,"1",4903185,1082,0,1190,-108,1082,0,-2.20264991021142,-0.0907563025210084
"United States","Alabama","AL",2020-01-05,2020-01-11,7,2020,"2",4903185,1127,0,1176,-49,1127,0,-0.999350422225553,-0.0416666666666666
"United States","Alabama","AL",2020-01-12,2020-01-18,7,2020,"3",4903185,1039,0,1154,-115,1039,0,-2.34541425624365,-0.0996533795493935
"United States","Alabama","AL",2020-01-19,2020-01-25,7,2020,"4",4903185,1056,0,1139,-83,1056,0,-1.69277724581063,-0.0728709394205443
"United States","Alabama","AL",2020-01-26,2020-02-01,7,2020,"5",4903185,1026,0,1141,-115,1026,0,-2.34541425624365,-0.100788781770377
"United States","Alabama","AL",2020-02-02,2020-02-08,7,2020,"6",4903185,1120,0,1151,-31,1120,0,-0.632242103856983,-0.0269331016507385
"United States","Alabama","AL",2020-02-09,2020-02-15,7,2020,"7",4903185,1095,0,1145,-50,1095,0,-1.01974532880158,-0.0436681222707423
"United States","Alabama","AL",2020-02-16,2020-02-22,7,2020,"8",4903185,1098,0,1129,-31,1098,0,-0.632242103856983,-0.0274579273693534
"United States","Alabama","AL",2020-02-23,2020-02-29,7,2020,"9",4903185,1164,0,1112,52,1164,0,1.06053514195365,0.0467625899280575
"United States","Alabama","AL",2020-03-01,2020-03-07,7,2020,"10",4903185,1057,0,1106,-49,1057,0,-0.999350422225553,-0.0443037974683544
"United States","Alabama","AL",2020-03-08,2020-03-14,7,2020,"11",4903185,1091,0,1100,-9,1091,0,-0.183554159184285,-0.00818181818181818
"United States","Alabama","AL",2020-03-15,2020-03-21,7,2020,"12",4903185,1059,0,1094,-35,1059,0,-0.71382173016111,-0.0319926873857403
"United States","Alabama","AL",2020-03-22,2020-03-28,7,2020,"13",4903185,1073,3,1086,-13,1070,0.0611847197280951,-0.265133785488412,-0.0119705340699816
"United States","Alabama","AL",2020-03-29,2020-04-04,7,2020,"14",4903185,1156,23,1070,86,1133,0.469082851248729,1.75396196553873,0.080373831775701
"United States","Alabama","AL",2020-04-05,2020-04-11,7,2020,"15",4903185,1135,34,1059,76,1101,0.693426823585078,1.55001289977841,0.0717658168083097
"United States","Alabama","AL",2020-04-12,2020-04-18,7,2020,"16",4903185,1149,50,1058,91,1099,1.01974532880158,1.85593649841888,0.0860113421550095
"United States","Alabama","AL",2020-04-19,2020-04-25,7,2020,"17",4903185,1139,102,1049,90,1037,2.08028047075523,1.83554159184285,0.0857959961868446
"United States","Alabama","AL",2020-04-26,2020-05-02,7,2020,"18",4903185,1147,75,1044,103,1072,1.52961799320238,2.10067537733127,0.0986590038314177
"United States","Alabama","AL",2020-05-03,2020-05-09,7,2020,"19",4903185,1171,101,1022,149,1070,2.0598855641792,3.03884107982872,0.145792563600783
"United States","Alabama","AL",2020-05-10,2020-05-16,7,2020,"20",4903185,1148,94,1021,127,1054,1.91712121814698,2.59015313515603,0.124387855044074
"United States","Alabama","AL",2020-05-17,2020-05-23,7,2020,"21",4903185,1153,69,1017,136,1084,1.40724855374619,2.77370729434031,0.133726647000983
"United States","Alabama","AL",2020-05-24,2020-05-30,7,2020,"22",4903185,1109,67,1027,82,1042,1.36645874059412,1.6723823392346,0.0798442064264848
"United States","Alabama","AL",2020-05-31,2020-06-06,7,2020,"23",4903185,1173,66,1003,170,1107,1.34606383401809,3.46713411792539,0.169491525423729
"United States","Alabama","AL",2020-06-07,2020-06-13,7,2020,"24",4903185,1138,84,992,146,1054,1.71317215238666,2.97765636010063,0.147177419354839
"United States","Alabama","AL",2020-06-14,2020-06-20,7,2020,"25",4903185,1090,70,983,107,1020,1.42764346032222,2.18225500363539,0.108850457782299
"United States","Alabama","AL",2020-06-21,2020-06-27,7,2020,"26",4903185,1151,81,982,169,1070,1.65198743265857,3.44673921134936,0.172097759674134
"United States","Alabama","AL",2020-06-28,2020-07-04,7,2020,"27",4903185,1201,88,985,216,1113,1.79475177869079,4.40529982042285,0.219289340101523
"United States","Alabama","AL",2020-07-05,2020-07-11,7,2020,"28",4903185,1265,107,988,277,1158,2.18225500363539,5.64938912156078,0.280364372469636
"United States","Alabama","AL",2020-07-12,2020-07-18,7,2020,"29",4903185,1289,172,974,315,1117,3.50792393107745,6.42439557144999,0.323408624229979
"United States","Alabama","AL",2020-07-19,2020-07-25,7,2020,"30",4903185,1333,170,973,360,1163,3.46713411792539,7.34216636737141,0.369989722507708
"United States","Alabama","AL",2020-07-26,2020-08-01,7,2020,"31",4903185,1364,147,967,397,1217,2.99805126667666,8.09677791068458,0.410548086866598
"United States","Alabama","AL",2020-08-02,2020-08-08,7,2020,"32",4903185,1379,165,972,407,1214,3.36515958504523,8.3007269764449,0.418724279835391
"United States","Alabama","AL",2020-08-09,2020-08-15,7,2020,"33",4903185,1305,128,970,335,1177,2.61054804173206,6.83229370297062,0.345360824742268
"United States","Alabama","AL",2020-08-16,2020-08-22,7,2020,"34",4903185,1303,115,964,339,1188,2.34541425624365,6.91387332927475,0.351659751037344
"United States","Alabama","AL",2020-08-23,2020-08-29,7,2020,"35",4903185,1216,141,951,265,1075,2.87568182722047,5.4046502426484,0.278654048370137
"United States","Alabama","AL",2020-08-30,2020-09-05,7,2020,"36",4903185,1216,123,958,258,1093,2.5085735088519,5.26188589661618,0.269311064718163
"United States","Alabama","AL",2020-09-06,2020-09-12,7,2020,"37",4903185,1232,75,968,264,1157,1.52961799320238,5.38425533607237,0.272727272727273
"United States","Alabama","AL",2020-09-13,2020-09-19,7,2020,"38",4903185,1200,87,975,225,1113,1.77435687211476,4.58885397960713,0.230769230769231
"United States","Alabama","AL",2020-09-20,2020-09-26,7,2020,"39",4903185,1183,64,975,208,1119,1.30527402086603,4.24214056781459,0.213333333333333
"United States","Alabama","AL",2020-09-27,2020-10-03,7,2020,"40",4903185,1103,57,984,119,1046,1.16250967483381,2.42699388254777,0.120934959349593
"United States","Alabama","AL",2020-10-04,2020-10-10,7,2020,"41",4903185,1204,106,980,224,1098,2.16186009705936,4.5684590730311,0.228571428571429
"United States","Alabama","AL",2020-10-11,2020-10-17,7,2020,"42",4903185,1190,124,971,219,1066,2.52896841542793,4.46648454015094,0.225540679711637
"United States","Alabama","AL",2020-10-18,2020-10-24,7,2020,"43",4903185,1142,78,969,173,1064,1.59080271293047,3.52831883765348,0.178534571723426
"United States","Alabama","AL",2020-10-25,2020-10-31,7,2020,"44",4903185,1169,98,985,184,1071,1.99870084445111,3.75266280998983,0.186802030456853
"United States","Alabama","AL",2020-11-01,2020-11-07,7,2020,"45",4903185,1277,115,991,286,1162,2.34541425624365,5.83294328074507,0.288597376387487
"United States","Alabama","AL",2020-11-08,2020-11-14,7,2020,"46",4903185,1269,165,1002,267,1104,3.36515958504523,5.44544005580046,0.266467065868264
"United States","Alabama","AL",2020-11-15,2020-11-21,7,2020,"47",4903185,1275,211,1027,248,1064,4.30332528754269,5.05793683085586,0.241480038948393
"United States","Alabama","AL",2020-11-22,2020-11-28,7,2020,"48",4903185,1326,115,1044,282,1211,2.34541425624365,5.75136365444094,0.270114942528736
"United States","Alabama","AL",2020-11-29,2020-12-05,7,2020,"49",4903185,1355,304,1058,297,1051,6.20005159911364,6.05728725308142,0.280718336483932
"United States","Alabama","AL",2020-12-06,2020-12-12,7,2020,"50",4903185,1598,205,1078,520,1393,4.1809558480865,10.6053514195365,0.482374768089054
"United States","Alabama","AL",2020-12-13,2020-12-19,7,2020,"51",4903185,1584,310,1092,492,1274,6.32242103856983,10.0342940354076,0.450549450549451
"United States","Alabama","AL",2020-12-20,2020-12-26,7,2020,"52",4903185,1626,294,1107,519,1332,5.99610253335332,10.5849565129605,0.468834688346883
"United States","Alabama","AL",2020-12-27,2021-01-02,7,2020,"53",4903185,1801,188,1119,682,1613,3.83424243629396,13.9093262848536,0.609472743521001
"United States","Alabama","AL",2021-01-03,2021-01-09,7,2021,"1",4903185,1807,428,1121,686,1379,8.72902001454157,13.9909059111577,0.611953612845674
"United States","Alabama","AL",2021-01-10,2021-01-16,7,2021,"2",4903185,1821,819,1117,704,1002,16.70342848577,14.3580142295263,0.630259623992838
"United States","Alabama","AL",2021-01-17,2021-01-23,7,2021,"3",4903185,1782,539,1123,659,1243,10.9928546444811,13.4402434336049,0.586821015138023
"United States","Alabama","AL",2021-01-24,2021-01-30,7,2021,"4",4903185,1634,909,1119,515,725,18.5389700776128,10.5033768866563,0.460232350312779
"United States","Alabama","AL",2021-01-31,2021-02-06,7,2021,"5",4903185,1503,956,1110,393,547,19.4975306866863,8.01519828438046,0.354054054054054
"United States","Alabama","AL",2021-02-07,2021-02-13,7,2021,"6",4903185,1425,722,1108,317,703,14.7251225478949,6.46518538460205,0.286101083032491
"United States","Alabama","AL",2021-02-14,2021-02-20,7,2021,"7",4903185,1329,347,1090,239,982,7.077032581883,4.87438267167158,0.219266055045872
"United States","Alabama","AL",2021-02-21,2021-02-27,7,2021,"8",4903185,1317,343,1080,237,974,6.99545295557887,4.83359285851951,0.219444444444445
"United States","Alabama","AL",2021-02-28,2021-03-06,7,2021,"9",4903185,1163,218,1072,91,945,4.44608963357491,1.85593649841888,0.0848880597014925
"United States","Alabama","AL",2021-03-07,2021-03-13,7,2021,"10",4903185,1193,181,1072,121,1012,3.69147809026174,2.46778369569984,0.112873134328358
"United States","Alabama","AL",2021-03-14,2021-03-20,7,2021,"11",4903185,1062,108,1057,5,954,2.20264991021142,0.101974532880159,0.00473036896877965
"United States","Alabama","AL",2021-03-21,2021-03-27,7,2021,"12",4903185,1192,89,1053,139,1103,1.81514668526682,2.83489201406841,0.132003798670465
"United States","Alabama","AL",2021-03-28,2021-04-03,7,2021,"13",4903185,1107,110,1041,66,997,2.24343972336349,1.34606383401809,0.0634005763688761
"United States","Alabama","AL",2021-04-04,2021-04-10,7,2021,"14",4903185,1208,72,1045,163,1136,1.46843327347428,3.32436977189317,0.155980861244019
"United States","Alabama","AL",2021-04-11,2021-04-17,7,2021,"15",4903185,1168,78,1039,129,1090,1.59080271293047,2.63094294830809,0.124157844080847
"United States","Alabama","AL",2021-04-18,2021-04-24,7,2021,"16",4903185,1109,61,1029,80,1048,1.24408930113793,1.63159252608254,0.0777453838678328
"United States","Alabama","AL",2021-04-25,2021-05-01,7,2021,"17",4903185,1196,62,1027,169,1134,1.26448420771397,3.44673921134936,0.164556962025316
"United States","Alabama","AL",2021-05-02,2021-05-08,7,2021,"18",4903185,1151,65,1024,127,1086,1.32566892744206,2.59015313515603,0.1240234375
"United States","Alabama","AL",2021-05-09,2021-05-15,7,2021,"19",4903185,1098,60,1017,81,1038,1.2236943945619,1.65198743265857,0.0796460176991149
"United States","Alabama","AL",2021-05-16,2021-05-22,7,2021,"20",4903185,1098,74,1018,80,1024,1.50922308662635,1.63159252608254,0.0785854616895874
"United States","Alabama","AL",2021-05-23,2021-05-29,7,2021,"21",4903185,1077,34,1011,66,1043,0.693426823585078,1.34606383401809,0.0652818991097923
"United States","Alabama","AL",2021-05-30,2021-06-05,7,2021,"22",4903185,1085,52,994,91,1033,1.06053514195365,1.85593649841888,0.091549295774648
"United States","Alabama","AL",2021-06-06,2021-06-12,7,2021,"23",4903185,1104,68,989,115,1036,1.38685364717016,2.34541425624365,0.116279069767442
"United States","Alabama","AL",2021-06-13,2021-06-19,7,2021,"24",4903185,1136,40,992,144,1096,0.815796263041268,2.93686654694856,0.145161290322581
"United States","Alabama","AL",2021-06-20,2021-06-26,7,2021,"25",4903185,1080,30,988,92,1050,0.611847197280951,1.87633140499492,0.0931174089068827
"United States","Alabama","AL",2021-06-27,2021-07-03,7,2021,"26",4903185,1062,22,982,80,1040,0.448687944672697,1.63159252608254,0.0814663951120163
"United States","Alabama","AL",2021-07-04,2021-07-10,7,2021,"27",4903185,1106,44,982,124,1062,0.897375889345395,2.52896841542793,0.126272912423625
"United States","Alabama","AL",2021-07-11,2021-07-17,7,2021,"28",4903185,1018,41,977,41,977,0.8361911696173,0.8361911696173,0.0419651995905834
"United States","Alabama","AL",2021-07-18,2021-07-24,7,2021,"29",4903185,1052,40,981,71,1012,0.815796263041268,1.44803836689825,0.0723751274209989
"United States","Alabama","AL",2021-07-25,2021-07-31,7,2021,"30",4903185,974,59,982,-8,915,1.20329948798587,-0.163159252608254,-0.00814663951120165
"United States","Alabama","AL",2021-08-01,2021-08-07,7,2021,"31",4903185,805,58,971,-166,747,1.18290458140984,-3.38555449162126,-0.170957775489186
"United States","Alaska","AK",2019-12-29,2020-01-04,7,2020,"1",731545,89,0,89,0,89,0,0,0
"United States","Alaska","AK",2020-01-05,2020-01-11,7,2020,"2",731545,105,0,86,19,105,0,2.59724282169928,0.220930232558139
"United States","Alaska","AK",2020-01-12,2020-01-18,7,2020,"3",731545,99,0,87,12,99,0,1.64036388738902,0.137931034482759
"United States","Alaska","AK",2020-01-19,2020-01-25,7,2020,"4",731545,97,0,83,14,97,0,1.91375786862052,0.168674698795181
"United States","Alaska","AK",2020-01-26,2020-02-01,7,2020,"5",731545,85,0,80,5,85,0,0.683484953078758,0.0625
"United States","Alaska","AK",2020-02-02,2020-02-08,7,2020,"6",731545,92,0,78,14,92,0,1.91375786862052,0.17948717948718
"United States","Alaska","AK",2020-02-09,2020-02-15,7,2020,"7",731545,89,0,76,13,89,0,1.77706087800477,0.171052631578947
"United States","Alaska","AK",2020-02-16,2020-02-22,7,2020,"8",731545,83,0,75,8,83,0,1.09357592492601,0.106666666666667
"United States","Alaska","AK",2020-02-23,2020-02-29,7,2020,"9",731545,84,0,78,6,84,0,0.82018194369451,0.0769230769230769
"United States","Alaska","AK",2020-03-01,2020-03-07,7,2020,"10",731545,79,0,79,0,79,0,0,0
"United States","Alaska","AK",2020-03-08,2020-03-14,7,2020,"11",731545,92,0,77,15,92,0,2.05045485923627,0.194805194805195
"United States","Alaska","AK",2020-03-15,2020-03-21,7,2020,"12",731545,69,0,79,-10,69,0,-1.36696990615752,-0.126582278481013
"United States","Alaska","AK",2020-03-22,2020-03-28,7,2020,"13",731545,86,2,80,6,84,0.273393981231503,0.82018194369451,0.075
"United States","Alaska","AK",2020-03-29,2020-04-04,7,2020,"14",731545,98,3,85,13,95,0.410090971847255,1.77706087800477,0.152941176470588
"United States","Alaska","AK",2020-04-05,2020-04-11,7,2020,"15",731545,84,3,82,2,81,0.410090971847255,0.273393981231503,0.024390243902439
"United States","Alaska","AK",2020-04-12,2020-04-18,7,2020,"16",731545,80,1,84,-4,79,0.136696990615752,-0.546787962463006,-0.0476190476190477
"United States","Alaska","AK",2020-04-19,2020-04-25,7,2020,"17",731545,61,0,81,-20,61,0,-2.73393981231503,-0.246913580246914
"United States","Alaska","AK",2020-04-26,2020-05-02,7,2020,"18",731545,87,0,79,8,87,0,1.09357592492601,0.10126582278481
"United States","Alaska","AK",2020-05-03,2020-05-09,7,2020,"19",731545,89,1,76,13,88,0.136696990615752,1.77706087800477,0.171052631578947
"United States","Alaska","AK",2020-05-10,2020-05-16,7,2020,"20",731545,84,0,76,8,84,0,1.09357592492601,0.105263157894737
"United States","Alaska","AK",2020-05-17,2020-05-23,7,2020,"21",731545,82,0,75,7,82,0,0.956878934310261,0.0933333333333333
"United States","Alaska","AK",2020-05-24,2020-05-30,7,2020,"22",731545,97,0,79,18,97,0,2.46054583108353,0.227848101265823
"United States","Alaska","AK",2020-05-31,2020-06-06,7,2020,"23",731545,79,0,81,-2,79,0,-0.273393981231503,-0.0246913580246914
"United States","Alaska","AK",2020-06-07,2020-06-13,7,2020,"24",731545,88,2,79,9,86,0.273393981231503,1.23027291554176,0.113924050632911
"United States","Alaska","AK",2020-06-14,2020-06-20,7,2020,"25",731545,92,0,83,9,92,0,1.23027291554176,0.108433734939759
"United States","Alaska","AK",2020-06-21,2020-06-27,7,2020,"26",731545,90,0,86,4,90,0,0.546787962463006,0.0465116279069768
"United States","Alaska","AK",2020-06-28,2020-07-04,7,2020,"27",731545,84,2,85,-1,82,0.273393981231503,-0.136696990615752,-0.0117647058823529
"United States","Alaska","AK",2020-07-05,2020-07-11,7,2020,"28",731545,101,0,85,16,101,0,2.18715184985203,0.188235294117647
"United States","Alaska","AK",2020-07-12,2020-07-18,7,2020,"29",731545,89,4,88,1,85,0.546787962463006,0.136696990615752,0.0113636363636365
"United States","Alaska","AK",2020-07-19,2020-07-25,7,2020,"30",731545,93,2,87,6,91,0.273393981231503,0.82018194369451,0.0689655172413792
"United States","Alaska","AK",2020-07-26,2020-08-01,7,2020,"31",731545,114,4,83,31,110,0.546787962463006,4.2376067090883,0.373493975903614
"United States","Alaska","AK",2020-08-02,2020-08-08,7,2020,"32",731545,101,2,86,15,99,0.273393981231503,2.05045485923627,0.174418604651163
"United States","Alaska","AK",2020-08-09,2020-08-15,7,2020,"33",731545,74,2,87,-13,72,0.273393981231503,-1.77706087800477,-0.149425287356322
"United States","Alaska","AK",2020-08-16,2020-08-22,7,2020,"34",731545,116,3,85,31,113,0.410090971847255,4.2376067090883,0.364705882352941
"United States","Alaska","AK",2020-08-23,2020-08-29,7,2020,"35",731545,93,6,85,8,87,0.82018194369451,1.09357592492601,0.0941176470588236
"United States","Alaska","AK",2020-08-30,2020-09-05,7,2020,"36",731545,105,5,87,18,100,0.683484953078758,2.46054583108353,0.206896551724138
"United States","Alaska","AK",2020-09-06,2020-09-12,7,2020,"37",731545,87,2,85,2,85,0.273393981231503,0.273393981231503,0.0235294117647058
"United States","Alaska","AK",2020-09-13,2020-09-19,7,2020,"38",731545,104,1,86,18,103,0.136696990615752,2.46054583108353,0.209302325581395
"United States","Alaska","AK",2020-09-20,2020-09-26,7,2020,"39",731545,114,7,87,27,107,0.956878934310261,3.69081874662529,0.310344827586207
"United States","Alaska","AK",2020-09-27,2020-10-03,7,2020,"40",731545,78,6,89,-11,72,0.82018194369451,-1.50366689677327,-0.123595505617977
"United States","Alaska","AK",2020-10-04,2020-10-10,7,2020,"41",731545,117,2,92,25,115,0.273393981231503,3.41742476539379,0.271739130434783
"United States","Alaska","AK",2020-10-11,2020-10-17,7,2020,"42",731545,101,7,91,10,94,0.956878934310261,1.36696990615752,0.10989010989011
"United States","Alaska","AK",2020-10-18,2020-10-24,7,2020,"43",731545,102,1,89,13,101,0.136696990615752,1.77706087800477,0.146067415730337
"United States","Alaska","AK",2020-10-25,2020-10-31,7,2020,"44",731545,107,14,90,17,93,1.91375786862052,2.32384884046778,0.188888888888889
"United States","Alaska","AK",2020-11-01,2020-11-07,7,2020,"45",731545,114,1,91,23,113,0.136696990615752,3.14403078416229,0.252747252747253
"United States","Alaska","AK",2020-11-08,2020-11-14,7,2020,"46",731545,114,13,89,25,101,1.77706087800477,3.41742476539379,0.280898876404494
"United States","Alaska","AK",2020-11-15,2020-11-21,7,2020,"47",731545,122,0,90,32,122,0,4.37430369970405,0.355555555555556
"United States","Alaska","AK",2020-11-22,2020-11-28,7,2020,"48",731545,114,0,94,20,114,0,2.73393981231503,0.212765957446809
"United States","Alaska","AK",2020-11-29,2020-12-05,7,2020,"49",731545,118,0,97,21,118,0,2.87063680293078,0.216494845360825
"United States","Alaska","AK",2020-12-06,2020-12-12,7,2020,"50",731545,135,72,96,39,63,9.84218332433411,5.33118263401431,0.40625
"United States","Alaska","AK",2020-12-13,2020-12-19,7,2020,"51",731545,99,7,97,2,92,0.956878934310261,0.273393981231503,0.0206185567010309
"United States","Alaska","AK",2020-12-20,2020-12-26,7,2020,"52",731545,115,16,99,16,99,2.18715184985203,2.18715184985203,0.161616161616162
"United States","Alaska","AK",2020-12-27,2021-01-02,7,2020,"53",731545,105,15,100,5,90,2.05045485923627,0.683484953078758,0.05
"United States","Alaska","AK",2021-01-03,2021-01-09,7,2021,"1",731545,111,8,101,10,103,1.09357592492601,1.36696990615752,0.0990099009900991
"United States","Alaska","AK",2021-01-10,2021-01-16,7,2021,"2",731545,128,5,103,25,123,0.683484953078758,3.41742476539379,0.242718446601942
"United States","Alaska","AK",2021-01-17,2021-01-23,7,2021,"3",731545,95,29,103,-8,66,3.9642127278568,-1.09357592492601,-0.0776699029126213
"United States","Alaska","AK",2021-01-24,2021-01-30,7,2021,"4",731545,89,3,102,-13,86,0.410090971847255,-1.77706087800477,-0.127450980392157
"United States","Alaska","AK",2021-01-31,2021-02-06,7,2021,"5",731545,86,16,98,-12,70,2.18715184985203,-1.64036388738902,-0.122448979591837
"United States","Alaska","AK",2021-02-07,2021-02-13,7,2021,"6",731545,91,2,98,-7,89,0.273393981231503,-0.956878934310261,-0.0714285714285714
"United States","Alaska","AK",2021-02-14,2021-02-20,7,2021,"7",731545,85,8,97,-12,77,1.09357592492601,-1.64036388738902,-0.123711340206186
"United States","Alaska","AK",2021-02-21,2021-02-27,7,2021,"8",731545,91,1,97,-6,90,0.136696990615752,-0.82018194369451,-0.0618556701030928
"United States","Alaska","AK",2021-02-28,2021-03-06,7,2021,"9",731545,98,12,96,2,86,1.64036388738902,0.273393981231503,0.0208333333333333
"United States","Alaska","AK",2021-03-07,2021-03-13,7,2021,"10",731545,82,1,98,-16,81,0.136696990615752,-2.18715184985203,-0.163265306122449
"United States","Alaska","AK",2021-03-14,2021-03-20,7,2021,"11",731545,99,4,95,4,95,0.546787962463006,0.546787962463006,0.0421052631578946
"United States","Alaska","AK",2021-03-21,2021-03-27,7,2021,"12",731545,87,3,93,-6,84,0.410090971847255,-0.82018194369451,-0.0645161290322581
"United States","Alaska","AK",2021-03-28,2021-04-03,7,2021,"13",731545,78,0,92,-14,78,0,-1.91375786862052,-0.152173913043478
"United States","Alaska","AK",2021-04-04,2021-04-10,7,2021,"14",731545,87,11,93,-6,76,1.50366689677327,-0.82018194369451,-0.0645161290322581
"United States","Alaska","AK",2021-04-11,2021-04-17,7,2021,"15",731545,77,20,93,-16,57,2.73393981231503,-2.18715184985203,-0.172043010752688
"United States","Alaska","AK",2021-04-18,2021-04-24,7,2021,"16",731545,62,0,94,-32,62,0,-4.37430369970405,-0.340425531914894
"United States","Alaska","AK",2021-04-25,2021-05-01,7,2021,"17",731545,71,12,92,-21,59,1.64036388738902,-2.87063680293078,-0.228260869565217
"United States","Arizona","AZ",2019-12-29,2020-01-04,7,2020,"1",7278717,1301,0,1323,-22,1301,0,-0.302251069797054,-0.0166288737717309
"United States","Arizona","AZ",2020-01-05,2020-01-11,7,2020,"2",7278717,1391,0,1342,49,1391,0,0.673195564547983,0.0365126676602086
"United States","Arizona","AZ",2020-01-12,2020-01-18,7,2020,"3",7278717,1315,0,1340,-25,1315,0,-0.343467124769379,-0.0186567164179104
"United States","Arizona","AZ",2020-01-19,2020-01-25,7,2020,"4",7278717,1275,0,1327,-52,1275,0,-0.714411619520308,-0.0391861341371514
"United States","Arizona","AZ",2020-01-26,2020-02-01,7,2020,"5",7278717,1265,0,1328,-63,1265,0,-0.865537154418835,-0.0474397590361446
"United States","Arizona","AZ",2020-02-02,2020-02-08,7,2020,"6",7278717,1264,0,1324,-60,1264,0,-0.82432109944651,-0.0453172205438066
"United States","Arizona","AZ",2020-02-09,2020-02-15,7,2020,"7",7278717,1314,0,1313,1,1314,0,0.0137386849907752,0.000761614623000728
"United States","Arizona","AZ",2020-02-16,2020-02-22,7,2020,"8",7278717,1342,0,1300,42,1342,0,0.577024769612557,0.0323076923076924
"United States","Arizona","AZ",2020-02-23,2020-02-29,7,2020,"9",7278717,1353,0,1303,50,1353,0,0.686934249538758,0.0383729854182655
"United States","Arizona","AZ",2020-03-01,2020-03-07,7,2020,"10",7278717,1380,0,1310,70,1380,0,0.961707949354261,0.0534351145038168
"United States","Arizona","AZ",2020-03-08,2020-03-14,7,2020,"11",7278717,1349,0,1326,23,1349,0,0.315989754787829,0.0173453996983408
"United States","Arizona","AZ",2020-03-15,2020-03-21,7,2020,"12",7278717,1290,1,1319,-29,1289,0.0137386849907752,-0.39842186473248,-0.021986353297953
"United States","Arizona","AZ",2020-03-22,2020-03-28,7,2020,"13",7278717,1324,14,1308,16,1310,0.192341589870852,0.219818959852403,0.0122324159021407
"United States","Arizona","AZ",2020-03-29,2020-04-04,7,2020,"14",7278717,1357,37,1293,64,1320,0.508331344658681,0.87927583940961,0.0494972931167827
"United States","Arizona","AZ",2020-04-05,2020-04-11,7,2020,"15",7278717,1403,56,1279,124,1347,0.769366359483409,1.70359693885612,0.0969507427677874
"United States","Arizona","AZ",2020-04-12,2020-04-18,7,2020,"16",7278717,1316,68,1275,41,1248,0.934230579372711,0.563286084621782,0.0321568627450981
"United States","Arizona","AZ",2020-04-19,2020-04-25,7,2020,"17",7278717,1384,96,1256,128,1288,1.31891375911442,1.75855167881922,0.101910828025478
"United States","Arizona","AZ",2020-04-26,2020-05-02,7,2020,"18",7278717,1404,74,1228,176,1330,1.01666268931736,2.41800855837643,0.143322475570033
"United States","Arizona","AZ",2020-05-03,2020-05-09,7,2020,"19",7278717,1427,183,1221,206,1244,2.51417935331185,2.83016910809968,0.168714168714169
"United States","Arizona","AZ",2020-05-10,2020-05-16,7,2020,"20",7278717,1306,147,1206,100,1159,2.01958669364395,1.37386849907752,0.0829187396351576
"United States","Arizona","AZ",2020-05-17,2020-05-23,7,2020,"21",7278717,1289,119,1197,92,1170,1.63490351390224,1.26395901915131,0.076858813700919
"United States","Arizona","AZ",2020-05-24,2020-05-30,7,2020,"22",7278717,1310,101,1188,122,1209,1.38760718406829,1.67611956887457,0.102693602693603
"United States","Arizona","AZ",2020-05-31,2020-06-06,7,2020,"23",7278717,1399,139,1175,224,1260,1.90967721371775,3.07746543793364,0.19063829787234
"United States","Arizona","AZ",2020-06-07,2020-06-13,7,2020,"24",7278717,1463,148,1185,278,1315,2.03332537863472,3.81935442743549,0.234599156118144
"United States","Arizona","AZ",2020-06-14,2020-06-20,7,2020,"25",7278717,1550,154,1202,348,1396,2.11575748857937,4.78106237678976,0.289517470881864
"United States","Arizona","AZ",2020-06-21,2020-06-27,7,2020,"26",7278717,1617,242,1193,424,1375,3.32476176776759,5.82520243608867,0.355406538139145
"United States","Arizona","AZ",2020-06-28,2020-07-04,7,2020,"27",7278717,1774,226,1172,602,1548,3.10494280791519,8.27068836444665,0.513651877133106
"United States","Arizona","AZ",2020-07-05,2020-07-11,7,2020,"28",7278717,1954,346,1165,789,1608,4.7535850068082,10.8398224577216,0.67725321888412
"United States","Arizona","AZ",2020-07-12,2020-07-18,7,2020,"29",7278717,1995,579,1163,832,1416,7.95469860965882,11.4305859123249,0.715391229578676
"United States","Arizona","AZ",2020-07-19,2020-07-25,7,2020,"30",7278717,1863,556,1157,706,1307,7.63870885487099,9.69951160348726,0.610198789974071
"United States","Arizona","AZ",2020-07-26,2020-08-01,7,2020,"31",7278717,1792,461,1151,641,1331,6.33353378074735,8.80649707908688,0.556907037358819
"United States","Arizona","AZ",2020-08-02,2020-08-08,7,2020,"32",7278717,1586,390,1135,451,1196,5.35808714640231,6.1961469308396,0.397356828193833
"United States","Arizona","AZ",2020-08-09,2020-08-15,7,2020,"33",7278717,1526,355,1126,400,1171,4.87723317172518,5.49547399631006,0.355239786856128
"United States","Arizona","AZ",2020-08-16,2020-08-22,7,2020,"34",7278717,1505,264,1122,383,1241,3.62701283756464,5.26191635146689,0.341354723707665
"United States","Arizona","AZ",2020-08-23,2020-08-29,7,2020,"35",7278717,1467,251,1130,337,1216,3.44840993268456,4.62993684189123,0.298230088495575
"United States","Arizona","AZ",2020-08-30,2020-09-05,7,2020,"36",7278717,1296,200,1131,165,1096,2.74773699815503,2.2668830234779,0.145888594164456
"United States","Arizona","AZ",2020-09-06,2020-09-12,7,2020,"37",7278717,1282,108,1139,143,1174,1.48377797900372,1.96463195368085,0.125548726953468
"United States","Arizona","AZ",2020-09-13,2020-09-19,7,2020,"38",7278717,1259,152,1129,130,1107,2.08828011859782,1.78602904880077,0.115146147032772
"United States","Arizona","AZ",2020-09-20,2020-09-26,7,2020,"39",7278717,1285,155,1119,166,1130,2.12949617357015,2.28062170846868,0.148346738159071
"United States","Arizona","AZ",2020-09-27,2020-10-03,7,2020,"40",7278717,1202,83,1118,84,1119,1.14031085423434,1.15404953922511,0.075134168157424
"United States","Arizona","AZ",2020-10-04,2020-10-10,7,2020,"41",7278717,1241,54,1122,119,1187,0.741888989501859,1.63490351390224,0.106060606060606
"United States","Arizona","AZ",2020-10-11,2020-10-17,7,2020,"42",7278717,1236,65,1120,116,1171,0.893014524400385,1.59368745892992,0.103571428571429
"United States","Arizona","AZ",2020-10-18,2020-10-24,7,2020,"43",7278717,1282,45,1137,145,1237,0.618240824584882,1.9921093236624,0.127528583992964
"United States","Arizona","AZ",2020-10-25,2020-10-31,7,2020,"44",7278717,1312,109,1144,168,1203,1.49751666399449,2.30809907845023,0.146853146853147
"United States","Arizona","AZ",2020-11-01,2020-11-07,7,2020,"45",7278717,1399,169,1154,245,1230,2.321837763441,3.36597782273991,0.212305025996534
"United States","Arizona","AZ",2020-11-08,2020-11-14,7,2020,"46",7278717,1252,152,1166,86,1100,2.08828011859782,1.18152690920666,0.0737564322469983
"United States","Arizona","AZ",2020-11-15,2020-11-21,7,2020,"47",7278717,1525,157,1194,331,1368,2.1569735435517,4.54750473194658,0.277219430485762
"United States","Arizona","AZ",2020-11-22,2020-11-28,7,2020,"48",7278717,1531,168,1201,330,1363,2.30809907845023,4.5337660469558,0.274771024146545
"United States","Arizona","AZ",2020-11-29,2020-12-05,7,2020,"49",7278717,1696,301,1233,463,1395,4.13534418222332,6.3610111507289,0.375506893755069
"United States","Arizona","AZ",2020-12-06,2020-12-12,7,2020,"50",7278717,2004,397,1235,769,1607,5.45425794133774,10.5650487579061,0.622672064777328
"United States","Arizona","AZ",2020-12-13,2020-12-19,7,2020,"51",7278717,2098,615,1273,825,1483,8.44929126932672,11.3344151173895,0.648075412411626
"United States","Arizona","AZ",2020-12-20,2020-12-26,7,2020,"52",7278717,2205,34,1295,910,2171,0.467115289686355,12.5022033416054,0.702702702702703
"United States","Arizona","AZ",2020-12-27,2021-01-02,7,2020,"53",7278717,2301,1090,1342,959,1211,14.9751666399449,13.1753989061534,0.714605067064084
"United States","Arizona","AZ",2021-01-03,2021-01-09,7,2021,"1",7278717,2423,975,1357,1066,1448,13.3952178660058,14.6454382001663,0.785556374355195
"United States","Arizona","AZ",2021-01-10,2021-01-16,7,2021,"2",7278717,2465,1212,1369,1096,1253,16.6512862088195,15.0575987498896,0.800584368151936
"United States","Arizona","AZ",2021-01-17,2021-01-23,7,2021,"3",7278717,2404,922,1351,1053,1482,12.6670675614947,14.4668352952862,0.779422649888971
"United States","Arizona","AZ",2021-01-24,2021-01-30,7,2021,"4",7278717,2082,927,1327,755,1155,12.7357609864486,10.3727071680352,0.568952524491334
"United States","Arizona","AZ",2021-01-31,2021-02-06,7,2021,"5",7278717,1994,910,1319,675,1084,12.5022033416054,9.27361236877323,0.511751326762699
"United States","Arizona","AZ",2021-02-07,2021-02-13,7,2021,"6",7278717,1739,939,1280,459,800,12.9006252063379,6.3060564107658,0.35859375
"United States","Arizona","AZ",2021-02-14,2021-02-20,7,2021,"7",7278717,1552,533,1275,277,1019,7.32271910008316,3.80561574244472,0.217254901960784
"United States","Arizona","AZ",2021-02-21,2021-02-27,7,2021,"8",7278717,1523,501,1281,242,1022,6.88308118037836,3.32476176776759,0.188914910226386
"United States","Arizona","AZ",2021-02-28,2021-03-06,7,2021,"9",7278717,1502,289,1271,231,1213,3.97047996233402,3.17363623286906,0.181746656176239
"United States","Arizona","AZ",2021-03-07,2021-03-13,7,2021,"10",7278717,1418,284,1264,154,1134,3.90178653738015,2.11575748857937,0.121835443037975
"United States","Arizona","AZ",2021-03-14,2021-03-20,7,2021,"11",7278717,1397,139,1252,145,1258,1.90967721371775,1.9921093236624,0.115814696485623
"United States","Arizona","AZ",2021-03-21,2021-03-27,7,2021,"12",7278717,1295,226,1264,31,1069,3.10494280791519,0.42589923471403,0.0245253164556962
"United States","Arizona","AZ",2021-03-28,2021-04-03,7,2021,"13",7278717,1353,87,1247,106,1266,1.19526559419744,1.45630060902217,0.0850040096230955
"United States","Arizona","AZ",2021-04-04,2021-04-10,7,2021,"14",7278717,1279,81,1236,43,1198,1.11283348425279,0.590763454603332,0.0347896440129449
"United States","Arizona","AZ",2021-04-11,2021-04-17,7,2021,"15",7278717,1326,65,1220,106,1261,0.893014524400385,1.45630060902217,0.0868852459016394
"United States","Arizona","AZ",2021-04-18,2021-04-24,7,2021,"16",7278717,1256,117,1200,56,1139,1.60742614392069,0.769366359483409,0.0466666666666666
"United States","Arizona","AZ",2021-04-25,2021-05-01,7,2021,"17",7278717,1284,70,1197,87,1214,0.961707949354261,1.19526559419744,0.0726817042606516
"United States","Arizona","AZ",2021-05-02,2021-05-08,7,2021,"18",7278717,1420,69,1179,241,1351,0.947969264363486,3.31102308277681,0.204410517387617
"United States","Arizona","AZ",2021-05-09,2021-05-15,7,2021,"19",7278717,1322,59,1163,159,1263,0.810582414455735,2.18445091353325,0.136715391229579
"United States","Arizona","AZ",2021-05-16,2021-05-22,7,2021,"20",7278717,1260,81,1154,106,1179,1.11283348425279,1.45630060902217,0.0918544194107451
"United States","Arizona","AZ",2021-05-23,2021-05-29,7,2021,"21",7278717,1256,81,1146,110,1175,1.11283348425279,1.51125534898527,0.0959860383944153
"United States","Arizona","AZ",2021-05-30,2021-06-05,7,2021,"22",7278717,1336,72,1144,192,1264,0.989185319335812,2.63782751822883,0.167832167832168
"United States","Arizona","AZ",2021-06-06,2021-06-12,7,2021,"23",7278717,1309,40,1156,153,1269,0.549547399631006,2.1020188035886,0.132352941176471
"United States","Arizona","AZ",2021-06-13,2021-06-19,7,2021,"24",7278717,1369,82,1150,219,1287,1.12657216924356,3.00877201297976,0.190434782608696
"United States","Arizona","AZ",2021-06-20,2021-06-26,7,2021,"25",7278717,1400,81,1163,237,1319,1.11283348425279,3.25606834281371,0.20378331900258
"United States","Arizona","AZ",2021-06-27,2021-07-03,7,2021,"26",7278717,1336,58,1158,178,1278,0.796843729464959,2.44548592835798,0.153713298791019
"United States","Arizona","AZ",2021-07-04,2021-07-10,7,2021,"27",7278717,1298,48,1165,133,1250,0.659456879557208,1.8272451037731,0.114163090128755
"United States","Arizona","AZ",2021-07-11,2021-07-17,7,2021,"28",7278717,1358,91,1173,185,1267,1.25022033416054,2.5416567232934,0.15771526001705
"United States","Arizona","AZ",2021-07-18,2021-07-24,7,2021,"29",7278717,1260,44,1160,100,1216,0.604502139594107,1.37386849907752,0.0862068965517242
"United States","Arizona","AZ",2021-07-25,2021-07-31,7,2021,"30",7278717,1300,80,1142,158,1220,1.09909479926201,2.17071222854248,0.138353765323993
"United States","Arizona","AZ",2021-08-01,2021-08-07,7,2021,"31",7278717,1249,118,1125,124,1131,1.62116482891147,1.70359693885612,0.110222222222222
"United States","Arkansas","AR",2019-12-29,2020-01-04,7,2020,"1",3017825,672,0,740,-68,672,0,-2.25327843728513,-0.0918918918918918
"United States","Arkansas","AR",2020-01-05,2020-01-11,7,2020,"2",3017825,686,0,730,-44,686,0,-1.45800369471391,-0.0602739726027397
"United States","Arkansas","AR",2020-01-12,2020-01-18,7,2020,"3",3017825,658,0,692,-34,658,0,-1.12663921864257,-0.0491329479768786
"United States","Arkansas","AR",2020-01-19,2020-01-25,7,2020,"4",3017825,616,0,681,-65,616,0,-2.15386909446373,-0.0954478707782672
"United States","Arkansas","AR",2020-01-26,2020-02-01,7,2020,"5",3017825,681,0,680,1,681,0,0.0331364476071343,0.00147058823529411
"United States","Arkansas","AR",2020-02-02,2020-02-08,7,2020,"6",3017825,673,0,671,2,673,0,0.0662728952142686,0.00298062593144555
"United States","Arkansas","AR",2020-02-09,2020-02-15,7,2020,"7",3017825,688,0,675,13,688,0,0.430773818892746,0.0192592592592593
"United States","Arkansas","AR",2020-02-16,2020-02-22,7,2020,"8",3017825,697,0,670,27,697,0,0.894684085392626,0.0402985074626865
"United States","Arkansas","AR",2020-02-23,2020-02-29,7,2020,"9",3017825,656,0,655,1,656,0,0.0331364476071343,0.00152671755725198
"United States","Arkansas","AR",2020-03-01,2020-03-07,7,2020,"10",3017825,697,0,652,45,697,0,1.49114014232104,0.0690184049079754
"United States","Arkansas","AR",2020-03-08,2020-03-14,7,2020,"11",3017825,628,0,645,-17,628,0,-0.563319609321283,-0.0263565891472868
"United States","Arkansas","AR",2020-03-15,2020-03-21,7,2020,"12",3017825,640,0,643,-3,640,0,-0.0994093428214028,-0.00466562986003105
"United States","Arkansas","AR",2020-03-22,2020-03-28,7,2020,"13",3017825,641,5,633,8,636,0.165682238035671,0.265091580857074,0.0126382306477093
"United States","Arkansas","AR",2020-03-29,2020-04-04,7,2020,"14",3017825,606,8,625,-19,598,0.265091580857074,-0.629592504535551,-0.0304
"United States","Arkansas","AR",2020-04-05,2020-04-11,7,2020,"15",3017825,636,12,624,12,624,0.397637371285611,0.397637371285611,0.0192307692307692
"United States","Arkansas","AR",2020-04-12,2020-04-18,7,2020,"16",3017825,637,12,622,15,625,0.397637371285611,0.497046714107014,0.0241157556270097
"United States","Arkansas","AR",2020-04-19,2020-04-25,7,2020,"17",3017825,615,10,620,-5,605,0.331364476071343,-0.165682238035671,-0.00806451612903225
"United States","Arkansas","AR",2020-04-26,2020-05-02,7,2020,"18",3017825,630,25,610,20,605,0.828411190178357,0.662728952142685,0.0327868852459017
"United States","Arkansas","AR",2020-05-03,2020-05-09,7,2020,"19",3017825,661,16,609,52,645,0.530183161714148,1.72309527557098,0.0853858784893267
"United States","Arkansas","AR",2020-05-10,2020-05-16,7,2020,"20",3017825,583,10,608,-25,573,0.331364476071343,-0.828411190178357,-0.0411184210526315
"United States","Arkansas","AR",2020-05-17,2020-05-23,7,2020,"21",3017825,642,17,602,40,625,0.563319609321283,1.32545790428537,0.0664451827242525
"United States","Arkansas","AR",2020-05-24,2020-05-30,7,2020,"22",3017825,610,18,601,9,592,0.596456056928417,0.298228028464209,0.0149750415973378
"United States","Arkansas","AR",2020-05-31,2020-06-06,7,2020,"23",3017825,649,20,595,54,629,0.662728952142685,1.78936817078525,0.0907563025210083
"United States","Arkansas","AR",2020-06-07,2020-06-13,7,2020,"24",3017825,652,24,587,65,628,0.795274742571223,2.15386909446373,0.110732538330494
"United States","Arkansas","AR",2020-06-14,2020-06-20,7,2020,"25",3017825,708,47,590,118,661,1.55741303753531,3.91010081764184,0.2
"United States","Arkansas","AR",2020-06-21,2020-06-27,7,2020,"26",3017825,663,35,599,64,628,1.1597756662497,2.12073264685659,0.106844741235392
"United States","Arkansas","AR",2020-06-28,2020-07-04,7,2020,"27",3017825,687,27,600,87,660,0.894684085392626,2.88287094182068,0.145
"United States","Arkansas","AR",2020-07-05,2020-07-11,7,2020,"28",3017825,661,33,598,63,628,1.09350277103543,2.08759619924946,0.105351170568562
"United States","Arkansas","AR",2020-07-12,2020-07-18,7,2020,"29",3017825,695,38,586,109,657,1.2591850090711,3.61187278917764,0.186006825938567
"United States","Arkansas","AR",2020-07-19,2020-07-25,7,2020,"30",3017825,714,42,583,131,672,1.39173079949964,4.34087463653459,0.224699828473413
"United States","Arkansas","AR",2020-07-26,2020-08-01,7,2020,"31",3017825,750,59,575,175,691,1.95505040882092,5.7988783312485,0.304347826086957
"United States","Arkansas","AR",2020-08-02,2020-08-08,7,2020,"32",3017825,736,77,571,165,659,2.55150646574934,5.46751385517716,0.288966725043783
"United States","Arkansas","AR",2020-08-09,2020-08-15,7,2020,"33",3017825,766,65,571,195,701,2.15386909446373,6.46160728339118,0.341506129597198
"United States","Arkansas","AR",2020-08-16,2020-08-22,7,2020,"34",3017825,750,74,563,187,676,2.45209712292794,6.19651570253411,0.33214920071048
"United States","Arkansas","AR",2020-08-23,2020-08-29,7,2020,"35",3017825,739,98,574,165,641,3.24737186549916,5.46751385517716,0.287456445993031
"United States","Arkansas","AR",2020-08-30,2020-09-05,7,2020,"36",3017825,713,110,575,138,603,3.64500923678477,4.57282976978453,0.24
"United States","Arkansas","AR",2020-09-06,2020-09-12,7,2020,"37",3017825,722,71,576,146,651,2.35268778010653,4.8379213506416,0.253472222222222
"United States","Arkansas","AR",2020-09-13,2020-09-19,7,2020,"38",3017825,736,228,576,160,508,7.55511005442661,5.30183161714148,0.277777777777778
"United States","Arkansas","AR",2020-09-20,2020-09-26,7,2020,"39",3017825,746,104,577,169,642,3.44619055114196,5.60005964560569,0.292894280762565
"United States","Arkansas","AR",2020-09-27,2020-10-03,7,2020,"40",3017825,784,122,571,213,662,4.04264660807038,7.0580633403196,0.373029772329247
"United States","Arkansas","AR",2020-10-04,2020-10-10,7,2020,"41",3017825,785,145,562,223,640,4.80478490303447,7.38942781639094,0.396797153024911
"United States","Arkansas","AR",2020-10-11,2020-10-17,7,2020,"42",3017825,778,132,585,193,646,4.37401108414173,6.39533438817692,0.32991452991453
"United States","Arkansas","AR",2020-10-18,2020-10-24,7,2020,"43",3017825,794,113,588,206,681,3.74441857960617,6.82610820706966,0.350340136054422
"United States","Arkansas","AR",2020-10-25,2020-10-31,7,2020,"44",3017825,790,127,603,187,663,4.20832884610605,6.19651570253411,0.310116086235489
"United States","Arkansas","AR",2020-11-01,2020-11-07,7,2020,"45",3017825,845,142,620,225,703,4.70537556021307,7.45570071160521,0.362903225806452
"United States","Arkansas","AR",2020-11-08,2020-11-14,7,2020,"46",3017825,893,89,627,266,804,2.94914383703495,8.81429506349772,0.424242424242424
"United States","Arkansas","AR",2020-11-15,2020-11-21,7,2020,"47",3017825,876,174,629,247,702,5.76574188364136,8.18470255896217,0.39268680445151
"United States","Arkansas","AR",2020-11-22,2020-11-28,7,2020,"48",3017825,833,107,645,188,726,3.54559989396337,6.22965215014124,0.291472868217054
"United States","Arkansas","AR",2020-11-29,2020-12-05,7,2020,"49",3017825,944,184,662,282,760,6.09710635971271,9.34447822521187,0.425981873111782
"United States","Arkansas","AR",2020-12-06,2020-12-12,7,2020,"50",3017825,912,290,671,241,622,9.60956980606894,7.98588387331936,0.359165424739195
"United States","Arkansas","AR",2020-12-13,2020-12-19,7,2020,"51",3017825,936,281,689,247,655,9.31134177760473,8.18470255896217,0.358490566037736
"United States","Arkansas","AR",2020-12-20,2020-12-26,7,2020,"52",3017825,922,250,698,224,672,8.28411190178357,7.42256426399808,0.320916905444126
"United States","Arkansas","AR",2020-12-27,2021-01-02,7,2020,"53",3017825,968,288,700,268,680,9.54329691085467,8.88056795871199,0.382857142857143
"United States","Arkansas","AR",2021-01-03,2021-01-09,7,2021,"1",3017825,962,281,702,260,681,9.31134177760473,8.61547637785491,0.37037037037037
"United States","Arkansas","AR",2021-01-10,2021-01-16,7,2021,"2",3017825,962,283,700,262,679,9.377614672819,8.68174927306918,0.374285714285714
"United States","Arkansas","AR",2021-01-17,2021-01-23,7,2021,"3",3017825,983,270,675,308,713,8.94684085392626,10.2060258629974,0.456296296296296
"United States","Arkansas","AR",2021-01-24,2021-01-30,7,2021,"4",3017825,873,275,674,199,598,9.11252309196193,6.59415307381972,0.295252225519288
"United States","Arkansas","AR",2021-01-31,2021-02-06,7,2021,"5",3017825,863,223,679,184,640,7.38942781639094,6.09710635971271,0.270986745213549
"United States","Arkansas","AR",2021-02-07,2021-02-13,7,2021,"6",3017825,802,191,673,129,611,6.32906149296265,4.27460174132032,0.191679049034175
"United States","Arkansas","AR",2021-02-14,2021-02-20,7,2021,"7",3017825,773,96,663,110,677,3.18109897028489,3.64500923678477,0.165912518853695
"United States","Arkansas","AR",2021-02-21,2021-02-27,7,2021,"8",3017825,795,72,661,134,723,2.38582422771367,4.44028397935599,0.202723146747352
"United States","Arkansas","AR",2021-02-28,2021-03-06,7,2021,"9",3017825,747,19,651,96,728,0.629592504535551,3.18109897028489,0.147465437788018
"United States","Arkansas","AR",2021-03-07,2021-03-13,7,2021,"10",3017825,724,87,639,85,637,2.88287094182068,2.81659804660641,0.13302034428795
"United States","Arkansas","AR",2021-03-14,2021-03-20,7,2021,"11",3017825,649,67,631,18,582,2.220141989678,0.596456056928417,0.0285261489698891
"United States","Arkansas","AR",2021-03-21,2021-03-27,7,2021,"12",3017825,705,49,624,81,656,1.62368593274958,2.68405225617788,0.129807692307692
"United States","Arkansas","AR",2021-03-28,2021-04-03,7,2021,"13",3017825,603,-1,613,-10,604,-0.0331364476071343,-0.331364476071343,-0.0163132137030995
"United States","Arkansas","AR",2021-04-04,2021-04-10,7,2021,"14",3017825,694,20,605,89,674,0.662728952142685,2.94914383703495,0.147107438016529
"United States","Arkansas","AR",2021-04-11,2021-04-17,7,2021,"15",3017825,613,32,601,12,581,1.0603663234283,0.397637371285611,0.0199667221297837
"United States","Arkansas","AR",2021-04-18,2021-04-24,7,2021,"16",3017825,663,24,595,68,639,0.795274742571223,2.25327843728513,0.114285714285714
"United States","Arkansas","AR",2021-04-25,2021-05-01,7,2021,"17",3017825,651,24,592,59,627,0.795274742571223,1.95505040882092,0.0996621621621621
"United States","Arkansas","AR",2021-05-02,2021-05-08,7,2021,"18",3017825,700,19,591,109,681,0.629592504535551,3.61187278917764,0.184433164128596
"United States","Arkansas","AR",2021-05-09,2021-05-15,7,2021,"19",3017825,693,33,595,98,660,1.09350277103543,3.24737186549916,0.164705882352941
"United States","Arkansas","AR",2021-05-16,2021-05-22,7,2021,"20",3017825,681,23,595,86,658,0.762138294964088,2.84973449421355,0.14453781512605
"United States","Arkansas","AR",2021-05-23,2021-05-29,7,2021,"21",3017825,653,14,594,59,639,0.46391026649988,1.95505040882092,0.0993265993265993
"United States","Arkansas","AR",2021-05-30,2021-06-05,7,2021,"22",3017825,675,16,590,85,659,0.530183161714148,2.81659804660641,0.14406779661017
"United States","Arkansas","AR",2021-06-06,2021-06-12,7,2021,"23",3017825,660,14,584,76,646,0.46391026649988,2.51837001814221,0.13013698630137
"United States","Arkansas","AR",2021-06-13,2021-06-19,7,2021,"24",3017825,693,14,585,108,679,0.46391026649988,3.5787363415705,0.184615384615385
"United States","Arkansas","AR",2021-06-20,2021-06-26,7,2021,"25",3017825,659,19,585,74,640,0.629592504535551,2.45209712292794,0.126495726495726
"United States","Arkansas","AR",2021-06-27,2021-07-03,7,2021,"26",3017825,680,20,583,97,660,0.662728952142685,3.21423541789202,0.166380789022298
"United States","Arkansas","AR",2021-07-04,2021-07-10,7,2021,"27",3017825,687,35,582,105,652,1.1597756662497,3.4793269987491,0.180412371134021
"United States","Arkansas","AR",2021-07-11,2021-07-17,7,2021,"28",3017825,717,33,584,133,684,1.09350277103543,4.40714753174886,0.227739726027397
"United States","Arkansas","AR",2021-07-18,2021-07-24,7,2021,"29",3017825,716,60,582,134,656,1.98818685642806,4.44028397935599,0.230240549828179
"United States","Arkansas","AR",2021-07-25,2021-07-31,7,2021,"30",3017825,800,82,579,221,718,2.71718870378501,7.32315492117668,0.381692573402418
"United States","Arkansas","AR",2021-08-01,2021-08-07,7,2021,"31",3017825,723,146,577,146,577,4.8379213506416,4.8379213506416,0.253032928942808
"United States","California","CA",2019-12-29,2020-01-04,7,2020,"1",39512223,5888,0,6316,-428,5888,0,-1.083209112279,-0.0677644078530716
"United States","California","CA",2020-01-05,2020-01-11,7,2020,"2",39512223,5873,0,6305,-432,5873,0,-1.09333256192647,-0.0685170499603489
"United States","California","CA",2020-01-12,2020-01-18,7,2020,"3",39512223,5830,0,6165,-335,5830,0,-0.847838907975388,-0.0543390105433901
"United States","California","CA",2020-01-19,2020-01-25,7,2020,"4",39512223,5832,0,6058,-226,5832,0,-0.571974905081903,-0.0373060415978871
"United States","California","CA",2020-01-26,2020-02-01,7,2020,"5",39512223,5686,0,6010,-324,5686,0,-0.819999421444853,-0.053910149750416
"United States","California","CA",2020-02-02,2020-02-08,7,2020,"6",39512223,5913,1,5893,20,5912,0.00253086241186683,0.0506172482373366,0.0033938571186154
"United States","California","CA",2020-02-09,2020-02-15,7,2020,"7",39512223,5588,0,5859,-271,5588,0,-0.685863713615911,-0.0462536268987882
"United States","California","CA",2020-02-16,2020-02-22,7,2020,"8",39512223,5797,1,5763,34,5796,0.00253086241186683,0.0860493220034722,0.00589970501474935
"United States","California","CA",2020-02-23,2020-02-29,7,2020,"9",39512223,5680,0,5723,-43,5680,0,-0.108827083710274,-0.0075135418486808
"United States","California","CA",2020-03-01,2020-03-07,7,2020,"10",39512223,5736,2,5766,-30,5734,0.00506172482373366,-0.0759258723560049,-0.00520291363163372
"United States","California","CA",2020-03-08,2020-03-14,7,2020,"11",39512223,5465,3,5703,-238,5462,0.00759258723560049,-0.602345254024305,-0.0417324215325268
"United States","California","CA",2020-03-15,2020-03-21,7,2020,"12",39512223,5681,23,5636,45,5658,0.0582098354729371,0.113888808534007,0.00798438608942509
"United States","California","CA",2020-03-22,2020-03-28,7,2020,"13",39512223,5689,94,5486,203,5595,0.237901066715482,0.513765069608966,0.0370032810791106
"United States","California","CA",2020-03-29,2020-04-04,7,2020,"14",39512223,5986,199,5392,594,5787,0.503641619961499,1.5033322726489,0.110163204747775
"United States","California","CA",2020-04-05,2020-04-11,7,2020,"15",39512223,6047,309,5352,695,5738,0.78203648526685,1.75894937624745,0.129857997010463
"United States","California","CA",2020-04-12,2020-04-18,7,2020,"16",39512223,6131,515,5316,815,5616,1.30339414211142,2.06265286567147,0.153310759969902
"United States","California","CA",2020-04-19,2020-04-25,7,2020,"17",39512223,5938,543,5262,676,5395,1.37425828964369,1.71086299042198,0.128468263017864
"United States","California","CA",2020-04-26,2020-05-02,7,2020,"18",39512223,5744,495,5169,575,5249,1.25277689387408,1.45524588682343,0.111240085122848
"United States","California","CA",2020-05-03,2020-05-09,7,2020,"19",39512223,5671,504,5112,559,5167,1.27555465558088,1.41475208823356,0.109350547730829
"United States","California","CA",2020-05-10,2020-05-16,7,2020,"20",39512223,5695,519,5091,604,5176,1.31351759175888,1.52864089676756,0.11864073855824
"United States","California","CA",2020-05-17,2020-05-23,7,2020,"21",39512223,5530,527,5068,462,5003,1.33376449105382,1.16925843428248,0.0911602209944751
"United States","California","CA",2020-05-24,2020-05-30,7,2020,"22",39512223,5593,406,4984,609,5187,1.02753013921793,1.5412952088269,0.122191011235955
"United States","California","CA",2020-05-31,2020-06-06,7,2020,"23",39512223,5518,463,4956,562,5055,1.17178929669434,1.42234467546916,0.113397901533495
"United States","California","CA",2020-06-07,2020-06-13,7,2020,"24",39512223,5570,451,4940,630,5119,1.14141894775194,1.5944433194761,0.12753036437247
"United States","California","CA",2020-06-14,2020-06-20,7,2020,"25",39512223,5489,431,4959,530,5058,1.0908016995146,1.34135707828942,0.106876386368219
"United States","California","CA",2020-06-21,2020-06-27,7,2020,"26",39512223,5701,412,4953,748,5289,1.04271531368913,1.89308508407639,0.15101958409045
"United States","California","CA",2020-06-28,2020-07-04,7,2020,"27",39512223,5901,432,4923,978,5469,1.09333256192647,2.47518343880576,0.198659354052407
"United States","California","CA",2020-07-05,2020-07-11,7,2020,"28",39512223,6042,696,4890,1152,5346,1.76148023865931,2.91555349847059,0.23558282208589
"United States","California","CA",2020-07-12,2020-07-18,7,2020,"29",39512223,6230,676,4846,1384,5554,1.71086299042198,3.50271357802369,0.285596368138671
"United States","California","CA",2020-07-19,2020-07-25,7,2020,"30",39512223,6250,726,4858,1392,5524,1.83740611101532,3.52296047731863,0.286537669822972
"United States","California","CA",2020-07-26,2020-08-01,7,2020,"31",39512223,6339,933,4820,1519,5406,2.36129463027175,3.84438000362571,0.315145228215768
"United States","California","CA",2020-08-02,2020-08-08,7,2020,"32",39512223,6309,924,4795,1514,5385,2.33851686856495,3.83172569156638,0.315745568300313
"United States","California","CA",2020-08-09,2020-08-15,7,2020,"33",39512223,6291,937,4734,1557,5354,2.37141807991922,3.94055277527665,0.328897338403042
"United States","California","CA",2020-08-16,2020-08-22,7,2020,"34",39512223,6478,894,4733,1745,5584,2.26259099620894,4.41635490870762,0.368687935770125
"United States","California","CA",2020-08-23,2020-08-29,7,2020,"35",39512223,5878,789,4721,1157,5089,1.99685044296293,2.92820781052992,0.245075195933065
"United States","California","CA",2020-08-30,2020-09-05,7,2020,"36",39512223,5784,802,4721,1063,4982,2.0297516543172,2.69030674381444,0.225164160135565
"United States","California","CA",2020-09-06,2020-09-12,7,2020,"37",39512223,5874,626,4732,1142,5248,1.58431986982864,2.89024487435192,0.241335587489434
"United States","California","CA",2020-09-13,2020-09-19,7,2020,"38",39512223,5755,654,4765,990,5101,1.65518401736091,2.50555378774816,0.207764952780693
"United States","California","CA",2020-09-20,2020-09-26,7,2020,"39",39512223,5563,547,4745,818,5016,1.38438173929116,2.07024545290707,0.172391991570074
"United States","California","CA",2020-09-27,2020-10-03,7,2020,"40",39512223,5671,608,4754,917,5063,1.53876434641503,2.32080083168188,0.192890197728229
"United States","California","CA",2020-10-04,2020-10-10,7,2020,"41",39512223,5568,447,4781,787,5121,1.13129549810447,1.99178871813919,0.164609914243882
"United States","California","CA",2020-10-11,2020-10-17,7,2020,"42",39512223,5621,375,4820,801,5246,0.949073404450061,2.02722079190533,0.166182572614108
"United States","California","CA",2020-10-18,2020-10-24,7,2020,"43",39512223,5351,381,4831,520,4970,0.964258578921262,1.31604845417075,0.107638170151107
"United States","California","CA",2020-10-25,2020-10-31,7,2020,"44",39512223,5529,314,4866,663,5215,0.794690797326184,1.67796177906771,0.136251541307028
"United States","California","CA",2020-11-01,2020-11-07,7,2020,"45",39512223,5872,305,4891,981,5567,0.771913035619383,2.48277602604136,0.200572480065426
"United States","California","CA",2020-11-08,2020-11-14,7,2020,"46",39512223,6004,288,4924,1080,5716,0.728888374617647,2.73333140481618,0.219333874898457
"United States","California","CA",2020-11-15,2020-11-21,7,2020,"47",39512223,6350,345,4987,1363,6005,0.873147532094056,3.44956546737449,0.273310607579707
"United States","California","CA",2020-11-22,2020-11-28,7,2020,"48",39512223,6390,536,5077,1313,5854,1.35654225276062,3.32302234678115,0.258617293677369
"United States","California","CA",2020-11-29,2020-12-05,7,2020,"49",39512223,7164,746,5157,2007,6418,1.88802335925265,5.07944086061673,0.389179755671902
"United States","California","CA",2020-12-06,2020-12-12,7,2020,"50",39512223,8149,1092,5265,2884,7057,2.76370175375858,7.29900719582394,0.547768281101614
"United States","California","CA",2020-12-13,2020-12-19,7,2020,"51",39512223,9233,1612,5379,3854,7621,4.07975020792933,9.75394373533476,0.716490053913367
"United States","California","CA",2020-12-20,2020-12-26,7,2020,"52",39512223,10563,1400,5514,5049,9163,3.54320737661356,12.7783243175156,0.915669205658324
"United States","California","CA",2020-12-27,2021-01-02,7,2020,"53",39512223,11270,2374,5659,5611,8896,6.00826736577185,14.2006689929848,0.991517936031101
"United States","California","CA",2021-01-03,2021-01-09,7,2021,"1",39512223,11898,2876,5845,6053,9022,7.278760296529,15.3193101790299,1.03558597091531
"United States","California","CA",2021-01-10,2021-01-16,7,2021,"2",39512223,11570,3727,5878,5692,7843,9.43252420902767,14.405668848346,0.968356583872065
"United States","California","CA",2021-01-17,2021-01-23,7,2021,"3",39512223,10400,3400,5862,4538,7000,8.60493220034722,11.4850536250517,0.774138519276697
"United States","California","CA",2021-01-24,2021-01-30,7,2021,"4",39512223,9587,3856,5829,3758,5731,9.75900546015849,9.51098094379554,0.64470749699777
"United States","California","CA",2021-01-31,2021-02-06,7,2021,"5",39512223,8765,3431,5794,2971,5334,8.68338893511509,7.51919222565635,0.512771832930618
"United States","California","CA",2021-02-07,2021-02-13,7,2021,"6",39512223,7856,2788,5723,2133,5068,7.05604440428472,5.39832952451195,0.372706622400839
"United States","California","CA",2021-02-14,2021-02-20,7,2021,"7",39512223,7005,2390,5718,1287,4615,6.04876116436172,3.25721992407261,0.22507869884575
"United States","California","CA",2021-02-21,2021-02-27,7,2021,"8",39512223,6736,2996,5726,1010,3740,7.58246378595302,2.5561710359855,0.176388403772267
"United States","California","CA",2021-02-28,2021-03-06,7,2021,"9",39512223,6462,1901,5720,742,4561,4.81116944495884,1.87789990960519,0.12972027972028
"United States","California","CA",2021-03-07,2021-03-13,7,2021,"10",39512223,6218,1513,5659,559,4705,3.82919482915451,1.41475208823356,0.0987807033044708
"United States","California","CA",2021-03-14,2021-03-20,7,2021,"11",39512223,5995,883,5539,456,5112,2.23475150967841,1.15407325981127,0.082325329481856
"United States","California","CA",2021-03-21,2021-03-27,7,2021,"12",39512223,5792,1628,5432,360,4164,4.1202440065192,0.911110468272058,0.0662739322533137
"United States","California","CA",2021-03-28,2021-04-03,7,2021,"13",39512223,5755,683,5349,406,5072,1.72857902730504,1.02753013921793,0.075902037764068
"United States","California","CA",2021-04-04,2021-04-10,7,2021,"14",39512223,5425,684,5243,182,4741,1.73110988971691,0.460616958959763,0.034712950600801
"United States","California","CA",2021-04-11,2021-04-17,7,2021,"15",39512223,5348,577,5199,149,4771,1.46030761164716,0.377098499368158,0.0286593575687633
"United States","California","CA",2021-04-18,2021-04-24,7,2021,"16",39512223,5363,445,5081,282,4918,1.12623377328074,0.713703200146446,0.0555008856524306
"United States","California","CA",2021-04-25,2021-05-01,7,2021,"17",39512223,5388,490,5026,362,4898,1.24012258181475,0.916172193095792,0.0720254675686431
"United States","California","CA",2021-05-02,2021-05-08,7,2021,"18",39512223,5362,542,5029,333,4820,1.37172742723182,0.842777183151654,0.0662159475044741
"United States","California","CA",2021-05-09,2021-05-15,7,2021,"19",39512223,5268,277,5006,262,4991,0.701048888087112,0.663085951909109,0.0523371953655614
"United States","California","CA",2021-05-16,2021-05-22,7,2021,"20",39512223,5256,278,4994,262,4978,0.703579750498978,0.663085951909109,0.052462955546656
"United States","California","CA",2021-05-23,2021-05-29,7,2021,"21",39512223,5350,59,4963,387,5291,0.149320882300143,0.979443753392463,0.0779770300221641
"United States","California","CA",2021-05-30,2021-06-05,7,2021,"22",39512223,5194,247,4937,257,4947,0.625123015731107,0.650431639849775,0.0520559043953819
"United States","California","CA",2021-06-06,2021-06-12,7,2021,"23",39512223,5169,258,4988,181,4911,0.652962502261642,0.458086096547896,0.0362870890136326
"United States","California","CA",2021-06-13,2021-06-19,7,2021,"24",39512223,5469,130,4982,487,5339,0.329012113542688,1.23252999457915,0.097751906864713
"United States","California","CA",2021-06-20,2021-06-26,7,2021,"25",39512223,5323,323,4971,352,5000,0.817468559032986,0.890863568977124,0.0708107020720177
"United States","California","CA",2021-06-27,2021-07-03,7,2021,"26",39512223,5216,250,4887,329,4966,0.632715602966707,0.832653733504187,0.0673214651115204
"United States","California","CA",2021-07-04,2021-07-10,7,2021,"27",39512223,5186,237,4885,301,4949,0.599814391612439,0.761789585971915,0.0616171954964175
"United States","California","CA",2021-07-11,2021-07-17,7,2021,"28",39512223,5126,225,4885,241,4901,0.569444042670037,0.609937841259906,0.0493346980552711
"United States","California","CA",2021-07-18,2021-07-24,7,2021,"29",39512223,5094,144,4876,218,4950,0.364444187308823,0.551728005786969,0.0447087776866284
"United States","California","CA",2021-07-25,2021-07-31,7,2021,"30",39512223,4773,196,4885,-112,4577,0.496049032725899,-0.283456590129085,-0.0229273285568066
"United States","California","CA",2021-08-01,2021-08-07,7,2021,"31",39512223,3885,300,4820,-935,3585,0.759258723560049,-2.36635635509549,-0.193983402489627
"United States","Colorado","CO",2019-12-29,2020-01-04,7,2020,"1",5758736,854,0,846,8,854,0,0.138919373973733,0.00945626477541373
"United States","Colorado","CO",2020-01-05,2020-01-11,7,2020,"2",5758736,872,0,848,24,872,0,0.416758121921199,0.0283018867924529
"United States","Colorado","CO",2020-01-12,2020-01-18,7,2020,"3",5758736,848,0,852,-4,848,0,-0.0694596869868666,-0.00469483568075113
"United States","Colorado","CO",2020-01-19,2020-01-25,7,2020,"4",5758736,853,0,842,11,853,0,0.191014139213883,0.013064133016627
"United States","Colorado","CO",2020-01-26,2020-02-01,7,2020,"5",5758736,793,0,826,-33,793,0,-0.573042417641649,-0.0399515738498789
"United States","Colorado","CO",2020-02-02,2020-02-08,7,2020,"6",5758736,847,0,826,21,847,0,0.364663356681049,0.0254237288135593
"United States","Colorado","CO",2020-02-09,2020-02-15,7,2020,"7",5758736,807,0,820,-13,807,0,-0.225743982707316,-0.0158536585365854
"United States","Colorado","CO",2020-02-16,2020-02-22,7,2020,"8",5758736,881,0,814,67,881,0,1.16344975703002,0.0823095823095823
"United States","Colorado","CO",2020-02-23,2020-02-29,7,2020,"9",5758736,842,0,811,31,842,0,0.538312574148216,0.0382244143033292
"United States","Colorado","CO",2020-03-01,2020-03-07,7,2020,"10",5758736,821,0,813,8,821,0,0.138919373973733,0.0098400984009841
"United States","Colorado","CO",2020-03-08,2020-03-14,7,2020,"11",5758736,822,1,806,16,821,0.0173649217467166,0.277838747947466,0.0198511166253101
"United States","Colorado","CO",2020-03-15,2020-03-21,7,2020,"12",5758736,891,5,807,84,886,0.0868246087335832,1.4586534267242,0.104089219330855
"United States","Colorado","CO",2020-03-22,2020-03-28,7,2020,"13",5758736,860,38,805,55,822,0.659867026375232,0.955070696069415,0.0683229813664596
"United States","Colorado","CO",2020-03-29,2020-04-04,7,2020,"14",5758736,967,82,801,166,885,1.42392358323076,2.88257700995496,0.207240948813983
"United States","Colorado","CO",2020-04-05,2020-04-11,7,2020,"15",5758736,1096,148,797,299,948,2.57000841851406,5.19211160226827,0.375156838143036
"United States","Colorado","CO",2020-04-12,2020-04-18,7,2020,"16",5758736,1106,137,792,314,969,2.37899427930018,5.45258542846903,0.396464646464646
"United States","Colorado","CO",2020-04-19,2020-04-25,7,2020,"17",5758736,1067,259,791,276,808,4.49751473239961,4.79271840209379,0.348925410872313
"United States","Colorado","CO",2020-04-26,2020-05-02,7,2020,"18",5758736,999,162,774,225,837,2.8131173229681,3.90710739301124,0.290697674418605
"United States","Colorado","CO",2020-05-03,2020-05-09,7,2020,"19",5758736,906,135,762,144,771,2.34426443580675,2.5005487315272,0.188976377952756
"United States","Colorado","CO",2020-05-10,2020-05-16,7,2020,"20",5758736,887,225,753,134,662,3.90710739301124,2.32689951406003,0.177954847277557
"United States","Colorado","CO",2020-05-17,2020-05-23,7,2020,"21",5758736,847,133,740,107,714,2.30953459231331,1.85804662689868,0.144594594594595
"United States","Colorado","CO",2020-05-24,2020-05-30,7,2020,"22",5758736,834,117,730,104,717,2.03169584436585,1.80595186165853,0.142465753424658
"United States","Colorado","CO",2020-05-31,2020-06-06,7,2020,"23",5758736,820,82,730,90,738,1.42392358323076,1.5628429572045,0.123287671232877
"United States","Colorado","CO",2020-06-07,2020-06-13,7,2020,"24",5758736,816,73,721,95,743,1.26763928751031,1.64966756593808,0.131761442441054
"United States","Colorado","CO",2020-06-14,2020-06-20,7,2020,"25",5758736,863,49,718,145,814,0.850881165589115,2.51791365327391,0.201949860724234
"United States","Colorado","CO",2020-06-21,2020-06-27,7,2020,"26",5758736,877,28,721,156,849,0.486217808908066,2.7089277924878,0.216366158113731
"United States","Colorado","CO",2020-06-28,2020-07-04,7,2020,"27",5758736,788,27,716,72,761,0.468852887161349,1.2502743657636,0.100558659217877
"United States","Colorado","CO",2020-07-05,2020-07-11,7,2020,"28",5758736,815,24,715,100,791,0.416758121921199,1.73649217467166,0.13986013986014
"United States","Colorado","CO",2020-07-12,2020-07-18,7,2020,"29",5758736,808,27,721,87,781,0.468852887161349,1.51074819196435,0.120665742024965
"United States","Colorado","CO",2020-07-19,2020-07-25,7,2020,"30",5758736,833,42,727,106,791,0.729326713362099,1.84068170515196,0.145804676753783
"United States","Colorado","CO",2020-07-26,2020-08-01,7,2020,"31",5758736,813,50,716,97,763,0.868246087335832,1.68439740943151,0.135474860335196
"United States","Colorado","CO",2020-08-02,2020-08-08,7,2020,"32",5758736,841,13,723,118,828,0.225743982707316,2.04906076611256,0.163208852005533
"United States","Colorado","CO",2020-08-09,2020-08-15,7,2020,"33",5758736,836,39,727,109,797,0.677231948121949,1.89277647039211,0.149931224209078
"United States","Colorado","CO",2020-08-16,2020-08-22,7,2020,"34",5758736,863,22,728,135,841,0.382028278427766,2.34426443580675,0.18543956043956
"United States","Colorado","CO",2020-08-23,2020-08-29,7,2020,"35",5758736,817,26,730,87,791,0.451487965414633,1.51074819196435,0.119178082191781
"United States","Colorado","CO",2020-08-30,2020-09-05,7,2020,"36",5758736,743,22,734,9,721,0.382028278427766,0.15628429572045,0.0122615803814714
"United States","Colorado","CO",2020-09-06,2020-09-12,7,2020,"37",5758736,850,22,735,115,828,0.382028278427766,1.99696600087241,0.156462585034014
"United States","Colorado","CO",2020-09-13,2020-09-19,7,2020,"38",5758736,804,25,737,67,779,0.434123043667916,1.16344975703002,0.0909090909090908
"United States","Colorado","CO",2020-09-20,2020-09-26,7,2020,"39",5758736,838,27,745,93,811,0.468852887161349,1.61493772244465,0.124832214765101
"United States","Colorado","CO",2020-09-27,2020-10-03,7,2020,"40",5758736,782,17,749,33,765,0.295203669694183,0.573042417641649,0.0440587449933245
"United States","Colorado","CO",2020-10-04,2020-10-10,7,2020,"41",5758736,801,55,747,54,746,0.955070696069415,0.937705774322699,0.072289156626506
"United States","Colorado","CO",2020-10-11,2020-10-17,7,2020,"42",5758736,867,64,759,108,803,1.11135499178986,1.8754115486454,0.142292490118577
"United States","Colorado","CO",2020-10-18,2020-10-24,7,2020,"43",5758736,869,42,754,115,827,0.729326713362099,1.99696600087241,0.152519893899204
"United States","Colorado","CO",2020-10-25,2020-10-31,7,2020,"44",5758736,907,58,760,147,849,1.00716546130957,2.55264349676735,0.193421052631579
"United States","Colorado","CO",2020-11-01,2020-11-07,7,2020,"45",5758736,1007,111,761,246,896,1.92750631388555,4.27177074969229,0.323258869908016
"United States","Colorado","CO",2020-11-08,2020-11-14,7,2020,"46",5758736,1040,137,767,273,903,2.37899427930018,4.74062363685364,0.35593220338983
"United States","Colorado","CO",2020-11-15,2020-11-21,7,2020,"47",5758736,1132,263,764,368,869,4.56697441938648,6.39029120279172,0.481675392670157
"United States","Colorado","CO",2020-11-22,2020-11-28,7,2020,"48",5758736,1216,196,774,442,1020,3.40352466235646,7.67529541204875,0.571059431524548
"United States","Colorado","CO",2020-11-29,2020-12-05,7,2020,"49",5758736,1256,373,776,480,883,6.47711581152531,8.33516243842399,0.618556701030928
"United States","Colorado","CO",2020-12-06,2020-12-12,7,2020,"50",5758736,1258,515,772,486,743,8.94293469955907,8.43935196890429,0.629533678756477
"United States","Colorado","CO",2020-12-13,2020-12-19,7,2020,"51",5758736,1201,468,782,419,733,8.12678337746339,7.27590221187427,0.535805626598465
"United States","Colorado","CO",2020-12-20,2020-12-26,7,2020,"52",5758736,1100,253,802,298,847,4.39332520191931,5.17474668052156,0.371571072319202
"United States","Colorado","CO",2020-12-27,2021-01-02,7,2020,"53",5758736,1098,320,822,276,778,5.55677495894933,4.79271840209379,0.335766423357664
"United States","Colorado","CO",2021-01-03,2021-01-09,7,2021,"1",5758736,1080,278,834,246,802,4.82744824558723,4.27177074969229,0.294964028776978
"United States","Colorado","CO",2021-01-10,2021-01-16,7,2021,"2",5758736,1007,167,838,169,840,2.89994193170168,2.93467177519511,0.201670644391408
"United States","Colorado","CO",2021-01-17,2021-01-23,7,2021,"3",5758736,985,123,841,144,862,2.13588537484615,2.5005487315272,0.171224732461356
"United States","Colorado","CO",2021-01-24,2021-01-30,7,2021,"4",5758736,932,136,843,89,796,2.36162935755346,1.54547803545778,0.105575326215896
"United States","Colorado","CO",2021-01-31,2021-02-06,7,2021,"5",5758736,931,106,835,96,825,1.84068170515196,1.6670324876848,0.114970059880239
"United States","Colorado","CO",2021-02-07,2021-02-13,7,2021,"6",5758736,833,97,841,-8,736,1.68439740943151,-0.138919373973733,-0.00951248513674197
"United States","Colorado","CO",2021-02-14,2021-02-20,7,2021,"7",5758736,894,75,839,55,819,1.30236913100375,0.955070696069415,0.065554231227652
"United States","Colorado","CO",2021-02-21,2021-02-27,7,2021,"8",5758736,877,62,838,39,815,1.07662514829643,0.677231948121949,0.0465393794749402
"United States","Colorado","CO",2021-02-28,2021-03-06,7,2021,"9",5758736,869,40,834,35,829,0.694596869868666,0.607772261135082,0.0419664268585132
"United States","Colorado","CO",2021-03-07,2021-03-13,7,2021,"10",5758736,846,53,829,17,793,0.920340852575982,0.295203669694183,0.0205066344993969
"United States","Colorado","CO",2021-03-14,2021-03-20,7,2021,"11",5758736,902,27,817,85,875,0.468852887161349,1.47601834847091,0.104039167686659
"United States","Colorado","CO",2021-03-21,2021-03-27,7,2021,"12",5758736,889,27,822,67,862,0.468852887161349,1.16344975703002,0.0815085158150852
"United States","Colorado","CO",2021-03-28,2021-04-03,7,2021,"13",5758736,840,30,813,27,810,0.520947652401499,0.468852887161349,0.033210332103321
"United States","Colorado","CO",2021-04-04,2021-04-10,7,2021,"14",5758736,808,23,810,-2,785,0.399393200174483,-0.0347298434934333,-0.0024691358024691
"United States","Colorado","CO",2021-04-11,2021-04-17,7,2021,"15",5758736,875,33,801,74,842,0.573042417641649,1.28500420925703,0.0923845193508115
"United States","Colorado","CO",2021-04-18,2021-04-24,7,2021,"16",5758736,841,61,794,47,780,1.05926022654972,0.816151322095682,0.0591939546599496
"United States","Colorado","CO",2021-04-25,2021-05-01,7,2021,"17",5758736,849,53,792,57,796,0.920340852575982,0.989800539562849,0.071969696969697
"United States","Colorado","CO",2021-05-02,2021-05-08,7,2021,"18",5758736,853,53,783,70,800,0.920340852575982,1.21554452227016,0.0893997445721584
"United States","Colorado","CO",2021-05-09,2021-05-15,7,2021,"19",5758736,881,87,787,94,794,1.51074819196435,1.63230264419136,0.119440914866582
"United States","Colorado","CO",2021-05-16,2021-05-22,7,2021,"20",5758736,852,61,776,76,791,1.05926022654972,1.31973405275046,0.097938144329897
"United States","Colorado","CO",2021-05-23,2021-05-29,7,2021,"21",5758736,822,73,770,52,749,1.26763928751031,0.902975930829265,0.0675324675324676
"United States","Colorado","CO",2021-05-30,2021-06-05,7,2021,"22",5758736,831,37,762,69,794,0.642502104628516,1.19817960052345,0.0905511811023623
"United States","Colorado","CO",2021-06-06,2021-06-12,7,2021,"23",5758736,887,75,759,128,812,1.30236913100375,2.22270998357973,0.168642951251647
"United States","Colorado","CO",2021-06-13,2021-06-19,7,2021,"24",5758736,839,44,754,85,795,0.764056556855532,1.47601834847091,0.112732095490716
"United States","Colorado","CO",2021-06-20,2021-06-26,7,2021,"25",5758736,797,38,747,50,759,0.659867026375232,0.868246087335832,0.0669344042838018
"United States","Colorado","CO",2021-06-27,2021-07-03,7,2021,"26",5758736,843,44,745,98,799,0.764056556855532,1.70176233117823,0.131543624161074
"United States","Colorado","CO",2021-07-04,2021-07-10,7,2021,"27",5758736,836,23,739,97,813,0.399393200174483,1.68439740943151,0.131258457374831
"United States","Colorado","CO",2021-07-11,2021-07-17,7,2021,"28",5758736,839,47,739,100,792,0.816151322095682,1.73649217467166,0.13531799729364
"United States","Colorado","CO",2021-07-18,2021-07-24,7,2021,"29",5758736,842,25,739,103,817,0.434123043667916,1.78858693991181,0.139377537212449
"United States","Colorado","CO",2021-07-25,2021-07-31,7,2021,"30",5758736,812,35,736,76,777,0.607772261135082,1.31973405275046,0.103260869565217
"United States","Colorado","CO",2021-08-01,2021-08-07,7,2021,"31",5758736,742,25,738,4,717,0.434123043667916,0.0694596869868666,0.00542005420054203
"United States","Connecticut","CT",2019-12-29,2020-01-04,7,2020,"1",3565287,633,0,693,-60,633,0,-1.68289397178965,-0.0865800865800865
"United States","Connecticut","CT",2020-01-05,2020-01-11,7,2020,"2",3565287,631,0,697,-66,631,0,-1.85118336896861,-0.0946915351506457
"United States","Connecticut","CT",2020-01-12,2020-01-18,7,2020,"3",3565287,639,0,691,-52,639,0,-1.45850810888436,-0.0752532561505065
"United States","Connecticut","CT",2020-01-19,2020-01-25,7,2020,"4",3565287,653,0,693,-40,653,0,-1.12192931452643,-0.0577200577200577
"United States","Connecticut","CT",2020-01-26,2020-02-01,7,2020,"5",3565287,686,0,688,-2,686,0,-0.0560964657263216,-0.00290697674418605
"United States","Connecticut","CT",2020-02-02,2020-02-08,7,2020,"6",3565287,652,0,677,-25,652,0,-0.70120582157902,-0.0369276218611522
"United States","Connecticut","CT",2020-02-09,2020-02-15,7,2020,"7",3565287,635,0,660,-25,635,0,-0.70120582157902,-0.0378787878787878
"United States","Connecticut","CT",2020-02-16,2020-02-22,7,2020,"8",3565287,653,0,658,-5,653,0,-0.140241164315804,-0.00759878419452886
"United States","Connecticut","CT",2020-02-23,2020-02-29,7,2020,"9",3565287,638,0,650,-12,638,0,-0.33657879435793,-0.0184615384615384
"United States","Connecticut","CT",2020-03-01,2020-03-07,7,2020,"10",3565287,625,0,645,-20,625,0,-0.560964657263216,-0.0310077519379846
"United States","Connecticut","CT",2020-03-08,2020-03-14,7,2020,"11",3565287,632,0,642,-10,632,0,-0.280482328631608,-0.0155763239875389
"United States","Connecticut","CT",2020-03-15,2020-03-21,7,2020,"12",3565287,665,5,637,28,660,0.140241164315804,0.785350520168502,0.043956043956044
"United States","Connecticut","CT",2020-03-22,2020-03-28,7,2020,"13",3565287,751,28,649,102,723,0.785350520168502,2.8609197520424,0.157164869029276
"United States","Connecticut","CT",2020-03-29,2020-04-04,7,2020,"14",3565287,891,132,650,241,759,3.70236673793723,6.75962412002175,0.370769230769231
"United States","Connecticut","CT",2020-04-05,2020-04-11,7,2020,"15",3565287,1260,329,649,611,931,9.22786861197991,17.1374702793913,0.941448382126348
"United States","Connecticut","CT",2020-04-12,2020-04-18,7,2020,"16",3565287,1389,592,643,746,797,16.6045538549912,20.923981715918,1.1601866251944
"United States","Connecticut","CT",2020-04-19,2020-04-25,7,2020,"17",3565287,1338,775,629,709,563,21.7373804689496,19.886197099981,1.12718600953895
"United States","Connecticut","CT",2020-04-26,2020-05-02,7,2020,"18",3565287,1165,575,613,552,590,16.1277338963175,15.4826245404648,0.900489396411093
"United States","Connecticut","CT",2020-05-03,2020-05-09,7,2020,"19",3565287,1052,496,604,448,556,13.9119235001278,12.565608322696,0.741721854304636
"United States","Connecticut","CT",2020-05-10,2020-05-16,7,2020,"20",3565287,954,406,588,366,548,11.3875825424433,10.2656532279169,0.622448979591837
"United States","Connecticut","CT",2020-05-17,2020-05-23,7,2020,"21",3565287,823,336,584,239,487,9.42420624202203,6.70352765429543,0.409246575342466
"United States","Connecticut","CT",2020-05-24,2020-05-30,7,2020,"22",3565287,759,238,582,177,521,6.67547942143227,4.96453721677946,0.304123711340206
"United States","Connecticut","CT",2020-05-31,2020-06-06,7,2020,"23",3565287,669,143,585,84,526,4.01089729943199,2.35605156050551,0.143589743589744
"United States","Connecticut","CT",2020-06-07,2020-06-13,7,2020,"24",3565287,636,131,588,48,505,3.67431850507407,1.34631517743172,0.0816326530612246
"United States","Connecticut","CT",2020-06-14,2020-06-20,7,2020,"25",3565287,581,65,592,-11,516,1.82313513610545,-0.308530561494769,-0.018581081081081
"United States","Connecticut","CT",2020-06-21,2020-06-27,7,2020,"26",3565287,598,60,586,12,538,1.68289397178965,0.33657879435793,0.0204778156996588
"United States","Connecticut","CT",2020-06-28,2020-07-04,7,2020,"27",3565287,553,24,586,-33,529,0.673157588715859,-0.925591684484307,-0.0563139931740614
"United States","Connecticut","CT",2020-07-05,2020-07-11,7,2020,"28",3565287,611,13,584,27,598,0.36462702722109,0.757302287305342,0.0462328767123288
"United States","Connecticut","CT",2020-07-12,2020-07-18,7,2020,"29",3565287,569,48,576,-7,521,1.34631517743172,-0.196337630042126,-0.0121527777777778
"United States","Connecticut","CT",2020-07-19,2020-07-25,7,2020,"30",3565287,586,17,568,18,569,0.476819958673734,0.504868191536894,0.0316901408450705
"United States","Connecticut","CT",2020-07-26,2020-08-01,7,2020,"31",3565287,555,19,560,-5,536,0.532916424400055,-0.140241164315804,-0.0089285714285714
"United States","Connecticut","CT",2020-08-02,2020-08-08,7,2020,"32",3565287,593,9,557,36,584,0.252434095768447,1.00973638307379,0.0646319569120288
"United States","Connecticut","CT",2020-08-09,2020-08-15,7,2020,"33",3565287,574,12,559,15,562,0.33657879435793,0.420723492947412,0.0268336314847943
"United States","Connecticut","CT",2020-08-16,2020-08-22,7,2020,"34",3565287,571,7,550,21,564,0.196337630042126,0.589012890126377,0.0381818181818181
"United States","Connecticut","CT",2020-08-23,2020-08-29,7,2020,"35",3565287,532,5,544,-12,527,0.140241164315804,-0.33657879435793,-0.0220588235294118
"United States","Connecticut","CT",2020-08-30,2020-09-05,7,2020,"36",3565287,574,3,549,25,571,0.0841446985894824,0.70120582157902,0.0455373406193078
"United States","Connecticut","CT",2020-09-06,2020-09-12,7,2020,"37",3565287,571,12,549,22,559,0.33657879435793,0.617061122989538,0.0400728597449909
"United States","Connecticut","CT",2020-09-13,2020-09-19,7,2020,"38",3565287,579,12,556,23,567,0.33657879435793,0.645109355852699,0.0413669064748201
"United States","Connecticut","CT",2020-09-20,2020-09-26,7,2020,"39",3565287,644,9,565,79,635,0.252434095768447,2.2158103961897,0.139823008849558
"United States","Connecticut","CT",2020-09-27,2020-10-03,7,2020,"40",3565287,623,12,568,55,611,0.33657879435793,1.54265280747384,0.096830985915493
"United States","Connecticut","CT",2020-10-04,2020-10-10,7,2020,"41",3565287,637,17,572,65,620,0.476819958673734,1.82313513610545,0.113636363636364
"United States","Connecticut","CT",2020-10-11,2020-10-17,7,2020,"42",3565287,619,12,573,46,607,0.33657879435793,1.2902187117054,0.0802792321116927
"United States","Connecticut","CT",2020-10-18,2020-10-24,7,2020,"43",3565287,683,35,583,100,648,0.981688150210628,2.80482328631608,0.171526586620926
"United States","Connecticut","CT",2020-10-25,2020-10-31,7,2020,"44",3565287,639,38,588,51,601,1.06583284880011,1.4304598760212,0.0867346938775511
"United States","Connecticut","CT",2020-11-01,2020-11-07,7,2020,"45",3565287,727,55,596,131,672,1.54265280747384,3.67431850507407,0.219798657718121
"United States","Connecticut","CT",2020-11-08,2020-11-14,7,2020,"46",3565287,685,67,604,81,618,1.87923160183177,2.27190686191603,0.134105960264901
"United States","Connecticut","CT",2020-11-15,2020-11-21,7,2020,"47",3565287,759,91,611,148,668,2.55238919054763,4.1511384637478,0.242225859247136
"United States","Connecticut","CT",2020-11-22,2020-11-28,7,2020,"48",3565287,757,133,621,136,624,3.73041497080039,3.81455966938987,0.219001610305958
"United States","Connecticut","CT",2020-11-29,2020-12-05,7,2020,"49",3565287,844,185,630,214,659,5.18892307968475,6.00232183271641,0.33968253968254
"United States","Connecticut","CT",2020-12-06,2020-12-12,7,2020,"50",3565287,846,217,634,212,629,6.08646653130589,5.94622536699009,0.334384858044164
"United States","Connecticut","CT",2020-12-13,2020-12-19,7,2020,"51",3565287,871,218,639,232,653,6.11451476416905,6.50719002425331,0.363067292644757
"United States","Connecticut","CT",2020-12-20,2020-12-26,7,2020,"52",3565287,920,210,648,272,710,5.89012890126377,7.62911933877974,0.419753086419753
"United States","Connecticut","CT",2020-12-27,2021-01-02,7,2020,"53",3565287,912,308,647,265,604,8.63885572185353,7.43278170873761,0.409582689335394
"United States","Connecticut","CT",2021-01-03,2021-01-09,7,2021,"1",3565287,851,225,660,191,626,6.31085239421118,5.35721247686371,0.289393939393939
"United States","Connecticut","CT",2021-01-10,2021-01-16,7,2021,"2",3565287,862,269,668,194,593,7.54497464019026,5.4413571754532,0.290419161676647
"United States","Connecticut","CT",2021-01-17,2021-01-23,7,2021,"3",3565287,853,226,676,177,627,6.33890062707434,4.96453721677946,0.261834319526627
"United States","Connecticut","CT",2021-01-24,2021-01-30,7,2021,"4",3565287,818,227,679,139,591,6.3669488599375,3.89870436797935,0.204712812960236
"United States","Connecticut","CT",2021-01-31,2021-02-06,7,2021,"5",3565287,774,168,678,96,606,4.71210312101102,2.69263035486344,0.141592920353982
"United States","Connecticut","CT",2021-02-07,2021-02-13,7,2021,"6",3565287,726,167,667,59,559,4.68405488814785,1.65484573892649,0.088455772113943
"United States","Connecticut","CT",2021-02-14,2021-02-20,7,2021,"7",3565287,679,142,661,18,537,3.98284906656883,0.504868191536894,0.027231467473525
"United States","Connecticut","CT",2021-02-21,2021-02-27,7,2021,"8",3565287,673,104,657,16,569,2.91701621776872,0.448771725810573,0.0243531202435312
"United States","Connecticut","CT",2021-02-28,2021-03-06,7,2021,"9",3565287,640,77,649,-9,563,2.15971393046338,-0.252434095768447,-0.0138674884437596
"United States","Connecticut","CT",2021-03-07,2021-03-13,7,2021,"10",3565287,646,61,641,5,585,1.71094220465281,0.140241164315804,0.00780031201248055
"United States","Connecticut","CT",2021-03-14,2021-03-20,7,2021,"11",3565287,638,68,641,-3,570,1.90727983469493,-0.0841446985894824,-0.00468018720748831
"United States","Connecticut","CT",2021-03-21,2021-03-27,7,2021,"12",3565287,664,36,645,19,628,1.00973638307379,0.532916424400055,0.0294573643410854
"United States","Connecticut","CT",2021-03-28,2021-04-03,7,2021,"13",3565287,618,37,645,-27,581,1.03778461593695,-0.757302287305342,-0.0418604651162791
"United States","Connecticut","CT",2021-04-04,2021-04-10,7,2021,"14",3565287,590,38,636,-46,552,1.06583284880011,-1.2902187117054,-0.0723270440251572
"United States","Connecticut","CT",2021-04-11,2021-04-17,7,2021,"15",3565287,632,51,639,-7,581,1.4304598760212,-0.196337630042126,-0.0109546165884195
"United States","Connecticut","CT",2021-04-18,2021-04-24,7,2021,"16",3565287,661,52,627,34,609,1.45850810888436,0.953639917347467,0.0542264752791068
"United States","Connecticut","CT",2021-04-25,2021-05-01,7,2021,"17",3565287,729,50,611,118,679,1.40241164315804,3.30969147785297,0.193126022913257
"United States","Connecticut","CT",2021-05-02,2021-05-08,7,2021,"18",3565287,726,40,596,130,686,1.12192931452643,3.6462702722109,0.218120805369127
"United States","Connecticut","CT",2021-05-09,2021-05-15,7,2021,"19",3565287,651,36,588,63,615,1.00973638307379,1.76703867037913,0.107142857142857
"United States","Connecticut","CT",2021-05-16,2021-05-22,7,2021,"20",3565287,696,39,580,116,657,1.09388108166327,3.25359501212665,0.2
"United States","Connecticut","CT",2021-05-23,2021-05-29,7,2021,"21",3565287,731,26,576,155,705,0.729254054442181,4.34747609378992,0.269097222222222
"United States","Connecticut","CT",2021-05-30,2021-06-05,7,2021,"22",3565287,554,8,568,-14,546,0.224385862905286,-0.392675260084251,-0.0246478873239436
"United States","Connecticut","CT",2021-06-06,2021-06-12,7,2021,"23",3565287,576,15,573,3,561,0.420723492947412,0.0841446985894824,0.00523560209424079
"United States","Connecticut","CT",2021-06-13,2021-06-19,7,2021,"24",3565287,564,9,571,-7,555,0.252434095768447,-0.196337630042126,-0.0122591943957968
"United States","Connecticut","CT",2021-06-20,2021-06-26,7,2021,"25",3565287,570,5,579,-9,565,0.140241164315804,-0.252434095768447,-0.0155440414507773
"United States","Connecticut","CT",2021-06-27,2021-07-03,7,2021,"26",3565287,476,4,580,-104,472,0.112192931452643,-2.91701621776872,-0.179310344827586
"United States","Connecticut","CT",2021-07-04,2021-07-10,7,2021,"27",3565287,363,0,587,-224,363,0,-6.28280416134802,-0.38160136286201
"United States","Delaware","DE",2019-12-29,2020-01-04,7,2020,"1",973764,199,0,213,-14,199,0,-1.43772002251059,-0.0657276995305164
"United States","Delaware","DE",2020-01-05,2020-01-11,7,2020,"2",973764,194,0,213,-19,194,0,-1.95119145912151,-0.0892018779342723
"United States","Delaware","DE",2020-01-12,2020-01-18,7,2020,"3",973764,190,0,216,-26,190,0,-2.67005147037681,-0.12037037037037
"United States","Delaware","DE",2020-01-19,2020-01-25,7,2020,"4",973764,190,0,210,-20,190,0,-2.0538857464437,-0.0952380952380952
"United States","Delaware","DE",2020-01-26,2020-02-01,7,2020,"5",973764,183,0,211,-28,183,0,-2.87544004502118,-0.132701421800948
"United States","Delaware","DE",2020-02-02,2020-02-08,7,2020,"6",973764,191,0,209,-18,191,0,-1.84849717179933,-0.0861244019138756
"United States","Delaware","DE",2020-02-09,2020-02-15,7,2020,"7",973764,202,0,203,-1,202,0,-0.102694287322185,-0.00492610837438423
"United States","Delaware","DE",2020-02-16,2020-02-22,7,2020,"8",973764,194,0,203,-9,194,0,-0.924248585899664,-0.0443349753694581
"United States","Delaware","DE",2020-02-23,2020-02-29,7,2020,"9",973764,164,0,204,-40,164,0,-4.10777149288739,-0.196078431372549
"United States","Delaware","DE",2020-03-01,2020-03-07,7,2020,"10",973764,200,0,202,-2,200,0,-0.20538857464437,-0.00990099009900991
"United States","Delaware","DE",2020-03-08,2020-03-14,7,2020,"11",973764,189,0,205,-16,189,0,-1.64310859715496,-0.0780487804878048
"United States","Delaware","DE",2020-03-15,2020-03-21,7,2020,"12",973764,221,0,207,14,221,0,1.43772002251059,0.067632850241546
"United States","Delaware","DE",2020-03-22,2020-03-28,7,2020,"13",973764,188,5,205,-17,183,0.513471436610924,-1.74580288447714,-0.0829268292682926
"United States","Delaware","DE",2020-03-29,2020-04-04,7,2020,"14",973764,214,9,210,4,205,0.924248585899664,0.410777149288739,0.019047619047619
"United States","Delaware","DE",2020-04-05,2020-04-11,7,2020,"15",973764,219,19,208,11,200,1.95119145912151,1.12963716054403,0.0528846153846154
"United States","Delaware","DE",2020-04-12,2020-04-18,7,2020,"16",973764,229,34,200,29,195,3.49160576895428,2.97813433234336,0.145
"United States","Delaware","DE",2020-04-19,2020-04-25,7,2020,"17",973764,285,45,192,93,240,4.62124292949832,9.55056872096319,0.484375
"United States","Delaware","DE",2020-04-26,2020-05-02,7,2020,"18",973764,251,56,187,64,195,5.75088009004235,6.57243438861983,0.342245989304813
"United States","Delaware","DE",2020-05-03,2020-05-09,7,2020,"19",973764,271,34,183,88,237,3.49160576895428,9.03709728435227,0.480874316939891
"United States","Delaware","DE",2020-05-10,2020-05-16,7,2020,"20",973764,276,84,176,100,192,8.62632013506353,10.2694287322185,0.568181818181818
"United States","Delaware","DE",2020-05-17,2020-05-23,7,2020,"21",973764,222,38,178,44,184,3.90238291824302,4.51854864217613,0.247191011235955
"United States","Delaware","DE",2020-05-24,2020-05-30,7,2020,"22",973764,226,37,178,48,189,3.79968863092084,4.92932579146487,0.269662921348315
"United States","Delaware","DE",2020-05-31,2020-06-06,7,2020,"23",973764,182,29,178,4,153,2.97813433234336,0.410777149288739,0.0224719101123596
"United States","Delaware","DE",2020-06-07,2020-06-13,7,2020,"24",973764,200,29,175,25,171,2.97813433234336,2.56735718305462,0.142857142857143
"United States","Delaware","DE",2020-06-14,2020-06-20,7,2020,"25",973764,162,15,182,-20,147,1.54041430983277,-2.0538857464437,-0.10989010989011
"United States","Delaware","DE",2020-06-21,2020-06-27,7,2020,"26",973764,201,73,178,23,128,7.49668297451949,2.36196860841025,0.129213483146067
"United States","Delaware","DE",2020-06-28,2020-07-04,7,2020,"27",973764,201,5,181,20,196,0.513471436610924,2.0538857464437,0.110497237569061
"United States","Delaware","DE",2020-07-05,2020-07-11,7,2020,"28",973764,194,3,183,11,191,0.308082861966554,1.12963716054403,0.0601092896174864
"United States","Delaware","DE",2020-07-12,2020-07-18,7,2020,"29",973764,191,8,181,10,183,0.821554298577479,1.02694287322185,0.0552486187845305
"United States","Delaware","DE",2020-07-19,2020-07-25,7,2020,"30",973764,201,56,177,24,145,5.75088009004235,2.46466289573244,0.135593220338983
"United States","Delaware","DE",2020-07-26,2020-08-01,7,2020,"31",973764,195,6,178,17,189,0.616165723933109,1.74580288447714,0.095505617977528
"United States","Delaware","DE",2020-08-02,2020-08-08,7,2020,"32",973764,197,5,177,20,192,0.513471436610924,2.0538857464437,0.112994350282486
"United States","Delaware","DE",2020-08-09,2020-08-15,7,2020,"33",973764,189,3,178,11,186,0.308082861966554,1.12963716054403,0.0617977528089888
"United States","Delaware","DE",2020-08-16,2020-08-22,7,2020,"34",973764,194,7,177,17,187,0.718860011255294,1.74580288447714,0.0960451977401129
"United States","Delaware","DE",2020-08-23,2020-08-29,7,2020,"35",973764,190,4,177,13,186,0.410777149288739,1.3350257351884,0.0734463276836159
"United States","Delaware","DE",2020-08-30,2020-09-05,7,2020,"36",973764,208,4,176,32,204,0.410777149288739,3.28621719430991,0.181818181818182
"United States","Delaware","DE",2020-09-06,2020-09-12,7,2020,"37",973764,198,5,176,22,193,0.513471436610924,2.25927432108807,0.125
"United States","Delaware","DE",2020-09-13,2020-09-19,7,2020,"38",973764,161,8,173,-12,153,0.821554298577479,-1.23233144786622,-0.0693641618497109
"United States","Delaware","DE",2020-09-20,2020-09-26,7,2020,"39",973764,202,12,178,24,190,1.23233144786622,2.46466289573244,0.134831460674157
"United States","Delaware","DE",2020-09-27,2020-10-03,7,2020,"40",973764,202,12,178,24,190,1.23233144786622,2.46466289573244,0.134831460674157
"United States","Delaware","DE",2020-10-04,2020-10-10,7,2020,"41",973764,203,8,181,22,195,0.821554298577479,2.25927432108807,0.121546961325967
"United States","Delaware","DE",2020-10-11,2020-10-17,7,2020,"42",973764,203,12,180,23,191,1.23233144786622,2.36196860841025,0.127777777777778
"United States","Delaware","DE",2020-10-18,2020-10-24,7,2020,"43",973764,215,16,182,33,199,1.64310859715496,3.3889114816321,0.181318681318681
"United States","Delaware","DE",2020-10-25,2020-10-31,7,2020,"44",973764,195,28,182,13,167,2.87544004502118,1.3350257351884,0.0714285714285714
"United States","Delaware","DE",2020-11-01,2020-11-07,7,2020,"45",973764,199,7,189,10,192,0.718860011255294,1.02694287322185,0.052910052910053
"United States","Delaware","DE",2020-11-08,2020-11-14,7,2020,"46",973764,172,20,190,-18,152,2.0538857464437,-1.84849717179933,-0.0947368421052631
"United States","Delaware","DE",2020-11-15,2020-11-21,7,2020,"47",973764,232,12,192,40,220,1.23233144786622,4.10777149288739,0.208333333333333
"United States","Delaware","DE",2020-11-22,2020-11-28,7,2020,"48",973764,199,21,192,7,178,2.15658003376588,0.718860011255294,0.0364583333333333
"United States","Delaware","DE",2020-11-29,2020-12-05,7,2020,"49",973764,231,24,188,43,207,2.46466289573244,4.41585435485395,0.228723404255319
"United States","Delaware","DE",2020-12-06,2020-12-12,7,2020,"50",973764,277,22,191,86,255,2.25927432108807,8.8317087097079,0.450261780104712
"United States","Delaware","DE",2020-12-13,2020-12-19,7,2020,"51",973764,281,43,191,90,238,4.41585435485395,9.24248585899664,0.471204188481675
"United States","Delaware","DE",2020-12-20,2020-12-26,7,2020,"52",973764,289,36,196,93,253,3.69699434359865,9.55056872096319,0.474489795918367
"United States","Delaware","DE",2020-12-27,2021-01-02,7,2020,"53",973764,285,36,197,88,249,3.69699434359865,9.03709728435227,0.446700507614213
"United States","Delaware","DE",2021-01-03,2021-01-09,7,2021,"1",973764,276,39,198,78,237,4.00507720556521,8.01015441113042,0.393939393939394
"United States","Delaware","DE",2021-01-10,2021-01-16,7,2021,"2",973764,287,47,197,90,240,4.82663150414269,9.24248585899664,0.456852791878173
"United States","Delaware","DE",2021-01-17,2021-01-23,7,2021,"3",973764,283,20,198,85,263,2.0538857464437,8.72901442238571,0.429292929292929
"United States","Delaware","DE",2021-01-24,2021-01-30,7,2021,"4",973764,264,45,194,70,219,4.62124292949832,7.18860011255294,0.360824742268041
"United States","Delaware","DE",2021-01-31,2021-02-06,7,2021,"5",973764,262,121,196,66,141,12.4260087659844,6.7778229632642,0.336734693877551
"United States","Delaware","DE",2021-02-07,2021-02-13,7,2021,"6",973764,234,80,193,41,154,8.21554298577479,4.21046578020958,0.212435233160622
"United States","Delaware","DE",2021-02-14,2021-02-20,7,2021,"7",973764,205,84,192,13,121,8.62632013506353,1.3350257351884,0.0677083333333333
"United States","Delaware","DE",2021-02-21,2021-02-27,7,2021,"8",973764,219,56,194,25,163,5.75088009004235,2.56735718305462,0.128865979381443
"United States","Delaware","DE",2021-02-28,2021-03-06,7,2021,"9",973764,223,42,193,30,181,4.31316006753176,3.08082861966555,0.155440414507772
"United States","Delaware","DE",2021-03-07,2021-03-13,7,2021,"10",973764,207,32,192,15,175,3.28621719430991,1.54041430983277,0.078125
"United States","Delaware","DE",2021-03-14,2021-03-20,7,2021,"11",973764,230,26,191,39,204,2.67005147037681,4.00507720556521,0.204188481675393
"United States","Delaware","DE",2021-03-21,2021-03-27,7,2021,"12",973764,209,22,184,25,187,2.25927432108807,2.56735718305462,0.135869565217391
"United States","Delaware","DE",2021-03-28,2021-04-03,7,2021,"13",973764,158,22,187,-29,136,2.25927432108807,-2.97813433234336,-0.155080213903743
"United States","Delaware","DE",2021-04-04,2021-04-10,7,2021,"14",973764,192,7,190,2,185,0.718860011255294,0.20538857464437,0.0105263157894737
"United States","Delaware","DE",2021-04-11,2021-04-17,7,2021,"15",973764,211,29,183,28,182,2.97813433234336,2.87544004502118,0.153005464480874
"United States","Delaware","DE",2021-04-18,2021-04-24,7,2021,"16",973764,213,13,177,36,200,1.3350257351884,3.69699434359865,0.203389830508474
"United States","Delaware","DE",2021-04-25,2021-05-01,7,2021,"17",973764,207,11,178,29,196,1.12963716054403,2.97813433234336,0.162921348314607
"United States","Delaware","DE",2021-05-02,2021-05-08,7,2021,"18",973764,198,10,176,22,188,1.02694287322185,2.25927432108807,0.125
"United States","Delaware","DE",2021-05-09,2021-05-15,7,2021,"19",973764,208,15,176,32,193,1.54041430983277,3.28621719430991,0.181818181818182
"United States","Delaware","DE",2021-05-16,2021-05-22,7,2021,"20",973764,217,8,175,42,209,0.821554298577479,4.31316006753176,0.24
"United States","Delaware","DE",2021-05-23,2021-05-29,7,2021,"21",973764,207,2,178,29,205,0.20538857464437,2.97813433234336,0.162921348314607
"United States","Delaware","DE",2021-05-30,2021-06-05,7,2021,"22",973764,178,16,177,1,162,1.64310859715496,0.102694287322185,0.00564971751412435
"United States","Delaware","DE",2021-06-06,2021-06-12,7,2021,"23",973764,209,2,174,35,207,0.20538857464437,3.59430005627647,0.201149425287356
"United States","Delaware","DE",2021-06-13,2021-06-19,7,2021,"24",973764,181,0,173,8,181,0,0.821554298577479,0.046242774566474
"United States","Delaware","DE",2021-06-20,2021-06-26,7,2021,"25",973764,226,14,176,50,212,1.43772002251059,5.13471436610924,0.284090909090909
"United States","Delaware","DE",2021-06-27,2021-07-03,7,2021,"26",973764,214,2,173,41,212,0.20538857464437,4.21046578020958,0.236994219653179
"United States","Delaware","DE",2021-07-04,2021-07-10,7,2021,"27",973764,192,0,174,18,192,0,1.84849717179933,0.103448275862069
"United States","Delaware","DE",2021-07-11,2021-07-17,7,2021,"28",973764,184,2,172,12,182,0.20538857464437,1.23233144786622,0.069767441860465
"United States","Delaware","DE",2021-07-18,2021-07-24,7,2021,"29",973764,197,1,168,29,196,0.102694287322185,2.97813433234336,0.172619047619048
"United States","Delaware","DE",2021-07-25,2021-07-31,7,2021,"30",973764,194,2,169,25,192,0.20538857464437,2.56735718305462,0.14792899408284
"United States","Delaware","DE",2021-08-01,2021-08-07,7,2021,"31",973764,153,133,168,-15,20,13.6583402138506,-1.54041430983277,-0.0892857142857143
"United States","District of Columbia","DC",2019-12-29,2020-01-04,7,2020,"1",705749,132,0,138,-6,132,0,-0.85016060950848,-0.0434782608695652
"United States","District of Columbia","DC",2020-01-05,2020-01-11,7,2020,"2",705749,128,0,134,-6,128,0,-0.85016060950848,-0.0447761194029851
"United States","District of Columbia","DC",2020-01-12,2020-01-18,7,2020,"3",705749,140,0,136,4,140,0,0.56677373967232,0.0294117647058822
"United States","District of Columbia","DC",2020-01-19,2020-01-25,7,2020,"4",705749,131,0,133,-2,131,0,-0.28338686983616,-0.0150375939849624
"United States","District of Columbia","DC",2020-01-26,2020-02-01,7,2020,"5",705749,143,0,132,11,143,0,1.55862778409888,0.0833333333333333
"United States","District of Columbia","DC",2020-02-02,2020-02-08,7,2020,"6",705749,131,0,130,1,131,0,0.14169343491808,0.00769230769230766
"United States","District of Columbia","DC",2020-02-09,2020-02-15,7,2020,"7",705749,122,0,128,-6,122,0,-0.85016060950848,-0.046875
"United States","District of Columbia","DC",2020-02-16,2020-02-22,7,2020,"8",705749,104,0,127,-23,104,0,-3.25894900311584,-0.181102362204724
"United States","District of Columbia","DC",2020-02-23,2020-02-29,7,2020,"9",705749,135,0,124,11,135,0,1.55862778409888,0.0887096774193548
"United States","District of Columbia","DC",2020-03-01,2020-03-07,7,2020,"10",705749,118,0,122,-4,118,0,-0.56677373967232,-0.0327868852459017
"United States","District of Columbia","DC",2020-03-08,2020-03-14,7,2020,"11",705749,114,0,125,-11,114,0,-1.55862778409888,-0.088
"United States","District of Columbia","DC",2020-03-15,2020-03-21,7,2020,"12",705749,129,1,124,5,128,0.14169343491808,0.7084671745904,0.0403225806451613
"United States","District of Columbia","DC",2020-03-22,2020-03-28,7,2020,"13",705749,130,4,125,5,126,0.56677373967232,0.7084671745904,0.04
"United States","District of Columbia","DC",2020-03-29,2020-04-04,7,2020,"14",705749,156,16,122,34,140,2.26709495868928,4.81757678721472,0.278688524590164
"United States","District of Columbia","DC",2020-04-05,2020-04-11,7,2020,"15",705749,194,1,126,68,193,0.14169343491808,9.63515357442944,0.53968253968254
"United States","District of Columbia","DC",2020-04-12,2020-04-18,7,2020,"16",705749,202,69,125,77,133,9.77684700934752,10.9103944886922,0.616
"United States","District of Columbia","DC",2020-04-19,2020-04-25,7,2020,"17",705749,242,74,121,121,168,10.4853141839379,17.1449056250877,1
"United States","District of Columbia","DC",2020-04-26,2020-05-02,7,2020,"18",705749,215,75,118,97,140,10.627007618856,13.7442631870538,0.822033898305085
"United States","District of Columbia","DC",2020-05-03,2020-05-09,7,2020,"19",705749,214,71,119,95,143,10.0602338791837,13.4608763172176,0.798319327731092
"United States","District of Columbia","DC",2020-05-10,2020-05-16,7,2020,"20",705749,185,64,114,71,121,9.06837983475712,10.0602338791837,0.62280701754386
"United States","District of Columbia","DC",2020-05-17,2020-05-23,7,2020,"21",705749,181,52,110,71,129,7.36805861574016,10.0602338791837,0.645454545454546
"United States","District of Columbia","DC",2020-05-24,2020-05-30,7,2020,"22",705749,169,35,111,58,134,4.9592702221328,8.21821922524864,0.522522522522523
"United States","District of Columbia","DC",2020-05-31,2020-06-06,7,2020,"23",705749,149,21,109,40,128,2.97556213327968,5.6677373967232,0.36697247706422
"United States","District of Columbia","DC",2020-06-07,2020-06-13,7,2020,"24",705749,147,28,109,38,119,3.96741617770624,5.38435052688704,0.348623853211009
"United States","District of Columbia","DC",2020-06-14,2020-06-20,7,2020,"25",705749,132,20,112,20,112,2.8338686983616,2.8338686983616,0.178571428571429
"United States","District of Columbia","DC",2020-06-21,2020-06-27,7,2020,"26",705749,130,17,112,18,113,2.40878839360736,2.55048182852544,0.160714285714286
"United States","District of Columbia","DC",2020-06-28,2020-07-04,7,2020,"27",705749,122,9,111,11,113,1.27524091426272,1.55862778409888,0.0990990990990992
"United States","District of Columbia","DC",2020-07-05,2020-07-11,7,2020,"28",705749,138,11,111,27,127,1.55862778409888,3.82572274278816,0.243243243243243
"United States","District of Columbia","DC",2020-07-12,2020-07-18,7,2020,"29",705749,121,10,112,9,111,1.4169343491808,1.27524091426272,0.0803571428571428
"United States","District of Columbia","DC",2020-07-19,2020-07-25,7,2020,"30",705749,123,3,108,15,120,0.42508030475424,2.1254015237712,0.138888888888889
"United States","District of Columbia","DC",2020-07-26,2020-08-01,7,2020,"31",705749,130,4,108,22,126,0.56677373967232,3.11725556819776,0.203703703703704
"United States","District of Columbia","DC",2020-08-02,2020-08-08,7,2020,"32",705749,118,5,107,11,113,0.7084671745904,1.55862778409888,0.102803738317757
"United States","District of Columbia","DC",2020-08-09,2020-08-15,7,2020,"33",705749,117,7,106,11,110,0.99185404442656,1.55862778409888,0.10377358490566
"United States","District of Columbia","DC",2020-08-16,2020-08-22,7,2020,"34",705749,113,7,104,9,106,0.99185404442656,1.27524091426272,0.0865384615384615
"United States","District of Columbia","DC",2020-08-23,2020-08-29,7,2020,"35",705749,140,1,105,35,139,0.14169343491808,4.9592702221328,0.333333333333333
"United States","District of Columbia","DC",2020-08-30,2020-09-05,7,2020,"36",705749,143,6,104,39,137,0.85016060950848,5.52604396180512,0.375
"United States","District of Columbia","DC",2020-09-06,2020-09-12,7,2020,"37",705749,125,5,105,20,120,0.7084671745904,2.8338686983616,0.19047619047619
"United States","District of Columbia","DC",2020-09-13,2020-09-19,7,2020,"38",705749,109,0,108,1,109,0,0.14169343491808,0.0092592592592593
"United States","District of Columbia","DC",2020-09-20,2020-09-26,7,2020,"39",705749,112,8,109,3,104,1.13354747934464,0.42508030475424,0.0275229357798166
"United States","District of Columbia","DC",2020-09-27,2020-10-03,7,2020,"40",705749,138,5,110,28,133,0.7084671745904,3.96741617770624,0.254545454545455
"United States","District of Columbia","DC",2020-10-04,2020-10-10,7,2020,"41",705749,146,7,112,34,139,0.99185404442656,4.81757678721472,0.303571428571429
"United States","District of Columbia","DC",2020-10-11,2020-10-17,7,2020,"42",705749,118,5,109,9,113,0.7084671745904,1.27524091426272,0.0825688073394495
"United States","District of Columbia","DC",2020-10-18,2020-10-24,7,2020,"43",705749,105,1,107,-2,104,0.14169343491808,-0.28338686983616,-0.0186915887850467
"United States","District of Columbia","DC",2020-10-25,2020-10-31,7,2020,"44",705749,128,4,107,21,124,0.56677373967232,2.97556213327968,0.196261682242991
"United States","District of Columbia","DC",2020-11-01,2020-11-07,7,2020,"45",705749,137,8,106,31,129,1.13354747934464,4.39249648246048,0.292452830188679
"United States","District of Columbia","DC",2020-11-08,2020-11-14,7,2020,"46",705749,130,4,103,27,126,0.56677373967232,3.82572274278816,0.262135922330097
"United States","District of Columbia","DC",2020-11-15,2020-11-21,7,2020,"47",705749,135,12,104,31,123,1.70032121901696,4.39249648246048,0.298076923076923
"United States","District of Columbia","DC",2020-11-22,2020-11-28,7,2020,"48",705749,120,8,107,13,112,1.13354747934464,1.84201465393504,0.121495327102804
"United States","District of Columbia","DC",2020-11-29,2020-12-05,7,2020,"49",705749,153,17,108,45,136,2.40878839360736,6.3762045713136,0.416666666666667
"United States","District of Columbia","DC",2020-12-06,2020-12-12,7,2020,"50",705749,175,18,109,66,157,2.55048182852544,9.35176670459328,0.605504587155963
"United States","District of Columbia","DC",2020-12-13,2020-12-19,7,2020,"51",705749,144,17,111,33,127,2.40878839360736,4.67588335229664,0.297297297297297
"United States","District of Columbia","DC",2020-12-20,2020-12-26,7,2020,"52",705749,165,32,116,49,133,4.53418991737856,6.94297831098592,0.422413793103448
"United States","District of Columbia","DC",2020-12-27,2021-01-02,7,2020,"53",705749,178,30,115,63,148,4.2508030475424,8.92668639983904,0.547826086956522
"United States","District of Columbia","DC",2021-01-03,2021-01-09,7,2021,"1",705749,173,21,112,61,152,2.97556213327968,8.64329953000288,0.544642857142857
"United States","District of Columbia","DC",2021-01-10,2021-01-16,7,2021,"2",705749,171,34,113,58,137,4.81757678721472,8.21821922524864,0.513274336283186
"United States","District of Columbia","DC",2021-01-17,2021-01-23,7,2021,"3",705749,163,23,113,50,140,3.25894900311584,7.084671745904,0.442477876106195
"United States","District of Columbia","DC",2021-01-24,2021-01-30,7,2021,"4",705749,181,39,109,72,142,5.52604396180512,10.2019273141018,0.660550458715596
"United States","District of Columbia","DC",2021-01-31,2021-02-06,7,2021,"5",705749,164,38,110,54,126,5.38435052688704,7.65144548557632,0.490909090909091
"United States","District of Columbia","DC",2021-02-07,2021-02-13,7,2021,"6",705749,153,32,108,45,121,4.53418991737856,6.3762045713136,0.416666666666667
"United States","District of Columbia","DC",2021-02-14,2021-02-20,7,2021,"7",705749,167,15,107,60,152,2.1254015237712,8.5016060950848,0.560747663551402
"United States","District of Columbia","DC",2021-02-21,2021-02-27,7,2021,"8",705749,146,11,105,41,135,1.55862778409888,5.80943083164128,0.39047619047619
"United States","District of Columbia","DC",2021-02-28,2021-03-06,7,2021,"9",705749,136,25,102,34,111,3.542335872952,4.81757678721472,0.333333333333333
"United States","District of Columbia","DC",2021-03-07,2021-03-13,7,2021,"10",705749,127,10,101,26,117,1.4169343491808,3.68402930787008,0.257425742574257
"United States","District of Columbia","DC",2021-03-14,2021-03-20,7,2021,"11",705749,148,9,106,42,139,1.27524091426272,5.95112426655936,0.39622641509434
"United States","District of Columbia","DC",2021-03-21,2021-03-27,7,2021,"12",705749,137,7,103,34,130,0.99185404442656,4.81757678721472,0.330097087378641
"United States","District of Columbia","DC",2021-03-28,2021-04-03,7,2021,"13",705749,128,14,103,25,114,1.98370808885312,3.542335872952,0.242718446601942
"United States","District of Columbia","DC",2021-04-04,2021-04-10,7,2021,"14",705749,160,11,106,54,149,1.55862778409888,7.65144548557632,0.509433962264151
"United States","District of Columbia","DC",2021-04-11,2021-04-17,7,2021,"15",705749,123,14,109,14,109,1.98370808885312,1.98370808885312,0.128440366972477
"United States","District of Columbia","DC",2021-04-18,2021-04-24,7,2021,"16",705749,130,4,108,22,126,0.56677373967232,3.11725556819776,0.203703703703704
"United States","District of Columbia","DC",2021-04-25,2021-05-01,7,2021,"17",705749,124,7,107,17,117,0.99185404442656,2.40878839360736,0.158878504672897
"United States","District of Columbia","DC",2021-05-02,2021-05-08,7,2021,"18",705749,126,4,107,19,122,0.56677373967232,2.69217526344352,0.177570093457944
"United States","District of Columbia","DC",2021-05-09,2021-05-15,7,2021,"19",705749,126,8,105,21,118,1.13354747934464,2.97556213327968,0.2
"United States","District of Columbia","DC",2021-05-16,2021-05-22,7,2021,"20",705749,136,7,104,32,129,0.99185404442656,4.53418991737856,0.307692307692308
"United States","District of Columbia","DC",2021-05-23,2021-05-29,7,2021,"21",705749,122,7,101,21,115,0.99185404442656,2.97556213327968,0.207920792079208
"United States","District of Columbia","DC",2021-05-30,2021-06-05,7,2021,"22",705749,125,4,103,22,121,0.56677373967232,3.11725556819776,0.213592233009709
"United States","District of Columbia","DC",2021-06-06,2021-06-12,7,2021,"23",705749,140,1,102,38,139,0.14169343491808,5.38435052688704,0.372549019607843
"United States","District of Columbia","DC",2021-06-13,2021-06-19,7,2021,"24",705749,129,4,104,25,125,0.56677373967232,3.542335872952,0.240384615384615
"United States","District of Columbia","DC",2021-06-20,2021-06-26,7,2021,"25",705749,113,0,105,8,113,0,1.13354747934464,0.0761904761904761
"United States","District of Columbia","DC",2021-06-27,2021-07-03,7,2021,"26",705749,108,0,109,-1,108,0,-0.14169343491808,-0.00917431192660545
"United States","District of Columbia","DC",2021-07-04,2021-07-10,7,2021,"27",705749,151,2,109,42,149,0.28338686983616,5.95112426655936,0.385321100917431
"United States","District of Columbia","DC",2021-07-11,2021-07-17,7,2021,"28",705749,121,3,109,12,118,0.42508030475424,1.70032121901696,0.110091743119266
"United States","District of Columbia","DC",2021-07-18,2021-07-24,7,2021,"29",705749,126,0,110,16,126,0,2.26709495868928,0.145454545454546
"United States","District of Columbia","DC",2021-07-25,2021-07-31,7,2021,"30",705749,85,3,113,-28,82,0.42508030475424,-3.96741617770624,-0.247787610619469
"United States","District of Columbia","DC",2021-08-01,2021-08-07,7,2021,"31",705749,81,0,111,-30,81,0,-4.2508030475424,-0.27027027027027
"United States","Florida","FL",2019-12-29,2020-01-04,7,2020,"1",21477737,4341,0,4459,-118,4341,0,-0.549406112943836,-0.0264633325857816
"United States","Florida","FL",2020-01-05,2020-01-11,7,2020,"2",21477737,4410,0,4526,-116,4410,0,-0.540094144927838,-0.0256296950950067
"United States","Florida","FL",2020-01-12,2020-01-18,7,2020,"3",21477737,4385,0,4686,-301,4385,0,-1.40145118640758,-0.0642338881775502
"United States","Florida","FL",2020-01-19,2020-01-25,7,2020,"4",21477737,4387,0,4697,-310,4387,0,-1.44335504247957,-0.0659995741962955
"United States","Florida","FL",2020-01-26,2020-02-01,7,2020,"5",21477737,4419,0,4676,-257,4419,0,-1.19658789005564,-0.054961505560308
"United States","Florida","FL",2020-02-02,2020-02-08,7,2020,"6",21477737,4385,0,4625,-240,4385,0,-1.11743616191967,-0.0518918918918919
"United States","Florida","FL",2020-02-09,2020-02-15,7,2020,"7",21477737,4358,0,4584,-226,4358,0,-1.05225238580769,-0.0493019197207679
"United States","Florida","FL",2020-02-16,2020-02-22,7,2020,"8",21477737,4416,0,4531,-115,4416,0,-0.53543816091984,-0.0253807106598984
"United States","Florida","FL",2020-02-23,2020-02-29,7,2020,"9",21477737,4399,0,4543,-144,4399,0,-0.670461697151799,-0.0316971164428792
"United States","Florida","FL",2020-03-01,2020-03-07,7,2020,"10",21477737,4520,2,4527,-7,4518,0.00931196801599722,-0.0325918880559903,-0.00154627788822614
"United States","Florida","FL",2020-03-08,2020-03-14,7,2020,"11",21477737,4435,1,4504,-69,4434,0.00465598400799861,-0.321262896551904,-0.0153197158081705
"United States","Florida","FL",2020-03-15,2020-03-21,7,2020,"12",21477737,4362,7,4490,-128,4355,0.0325918880559903,-0.595965953023822,-0.0285077951002227
"United States","Florida","FL",2020-03-22,2020-03-28,7,2020,"13",21477737,4461,46,4464,-3,4415,0.214175264367936,-0.0139679520239958,-0.000672043010752743
"United States","Florida","FL",2020-03-29,2020-04-04,7,2020,"14",21477737,4497,139,4389,108,4358,0.647181777111806,0.50284627286385,0.024606971975393
"United States","Florida","FL",2020-04-05,2020-04-11,7,2020,"15",21477737,4544,251,4333,211,4293,1.16865198600765,0.982412625687706,0.0486960535425802
"United States","Florida","FL",2020-04-12,2020-04-18,7,2020,"16",21477737,4416,304,4250,166,4112,1.41541913843158,0.772893345327769,0.0390588235294118
"United States","Florida","FL",2020-04-19,2020-04-25,7,2020,"17",21477737,4555,304,4205,350,4251,1.41541913843158,1.62959440279951,0.0832342449464922
"United States","Florida","FL",2020-04-26,2020-05-02,7,2020,"18",21477737,4352,310,4153,199,4042,1.44335504247957,0.926540817591723,0.0479171683120636
"United States","Florida","FL",2020-05-03,2020-05-09,7,2020,"19",21477737,4407,349,4090,317,4058,1.62493841879151,1.47594693053556,0.0775061124694376
"United States","Florida","FL",2020-05-10,2020-05-16,7,2020,"20",21477737,4279,250,4066,213,4029,1.16399600199965,0.991724593703704,0.0523856369896705
"United States","Florida","FL",2020-05-17,2020-05-23,7,2020,"21",21477737,4360,269,4027,333,4091,1.25245969815163,1.55044267466354,0.0826918301465112
"United States","Florida","FL",2020-05-24,2020-05-30,7,2020,"22",21477737,4211,214,4012,199,3997,0.996380577711702,0.926540817591723,0.0496011964107677
"United States","Florida","FL",2020-05-31,2020-06-06,7,2020,"23",21477737,4265,242,4002,263,4023,1.12674812993566,1.22452379410363,0.0657171414292854
"United States","Florida","FL",2020-06-07,2020-06-13,7,2020,"24",21477737,4256,237,3976,280,4019,1.10346820989567,1.30367552223961,0.0704225352112675
"United States","Florida","FL",2020-06-14,2020-06-20,7,2020,"25",21477737,4408,219,3974,434,4189,1.0196604977517,2.0206970594714,0.109209864116759
"United States","Florida","FL",2020-06-21,2020-06-27,7,2020,"26",21477737,4504,246,3927,577,4258,1.14537206596766,2.6865027726152,0.146931499872676
"United States","Florida","FL",2020-06-28,2020-07-04,7,2020,"27",21477737,4725,312,3928,797,4413,1.45266701049557,3.71081925437489,0.202902240325866
"United States","Florida","FL",2020-07-05,2020-07-11,7,2020,"28",21477737,5084,495,3924,1160,4589,2.30471208395931,5.40094144927839,0.295616717635066
"United States","Florida","FL",2020-07-12,2020-07-18,7,2020,"29",21477737,5509,698,3889,1620,4811,3.24987683758303,7.54269409295774,0.416559526870661
"United States","Florida","FL",2020-07-19,2020-07-25,7,2020,"30",21477737,5704,882,3848,1856,4822,4.10657789505477,8.64150631884542,0.482328482328482
"United States","Florida","FL",2020-07-26,2020-08-01,7,2020,"31",21477737,5791,1245,3843,1948,4546,5.79670008995827,9.06985684758129,0.506895654436638
"United States","Florida","FL",2020-08-02,2020-08-08,7,2020,"32",21477737,5585,1087,3862,1723,4498,5.06105461669449,8.0222604457816,0.446141895390989
"United States","Florida","FL",2020-08-09,2020-08-15,7,2020,"33",21477737,5510,1236,3859,1651,4274,5.75479623388628,7.6870295972057,0.427831044311998
"United States","Florida","FL",2020-08-16,2020-08-22,7,2020,"34",21477737,5203,929,3854,1349,4274,4.32540914343071,6.28092242679012,0.350025947067981
"United States","Florida","FL",2020-08-23,2020-08-29,7,2020,"35",21477737,5015,831,3864,1151,4184,3.86912271064684,5.3590375932064,0.29787784679089
"United States","Florida","FL",2020-08-30,2020-09-05,7,2020,"36",21477737,4758,706,3855,903,4052,3.28712470964702,4.20435355922274,0.234241245136187
"United States","Florida","FL",2020-09-06,2020-09-12,7,2020,"37",21477737,4513,789,3859,654,3724,3.6735713823109,3.04501354123109,0.169473956983675
"United States","Florida","FL",2020-09-13,2020-09-19,7,2020,"38",21477737,4667,687,3865,802,3980,3.19866101349504,3.73409917441488,0.207503234152652
"United States","Florida","FL",2020-09-20,2020-09-26,7,2020,"39",21477737,4444,735,3892,552,3709,3.42214824587898,2.57010317241523,0.141829393627955
"United States","Florida","FL",2020-09-27,2020-10-03,7,2020,"40",21477737,4346,606,3873,473,3740,2.82152630884716,2.20228043578334,0.122127549703072
"United States","Florida","FL",2020-10-04,2020-10-10,7,2020,"41",21477737,4525,736,3886,639,3789,3.42680422988698,2.97517378111111,0.164436438497169
"United States","Florida","FL",2020-10-11,2020-10-17,7,2020,"42",21477737,4389,553,3857,532,3836,2.57475915642323,2.47698349225526,0.137931034482759
"United States","Florida","FL",2020-10-18,2020-10-24,7,2020,"43",21477737,4335,500,3871,464,3835,2.3279920039993,2.16037657971135,0.119865667786102
"United States","Florida","FL",2020-10-25,2020-10-31,7,2020,"44",21477737,4265,344,3875,390,3921,1.60165849875152,1.81583376311946,0.100645161290323
"United States","Florida","FL",2020-11-01,2020-11-07,7,2020,"45",21477737,4305,339,3901,404,3966,1.57837857871153,1.88101753923144,0.103563188925917
"United States","Florida","FL",2020-11-08,2020-11-14,7,2020,"46",21477737,4487,388,3919,568,4099,1.80652179510346,2.64459891654321,0.144934932380709
"United States","Florida","FL",2020-11-15,2020-11-21,7,2020,"47",21477737,4561,442,3983,578,4119,2.05794493153538,2.6911587566232,0.145116746171228
"United States","Florida","FL",2020-11-22,2020-11-28,7,2020,"48",21477737,4634,507,4006,628,4127,2.36058389205529,2.92395795702313,0.156764852720919
"United States","Florida","FL",2020-11-29,2020-12-05,7,2020,"49",21477737,4911,632,4038,873,4279,2.94258189305512,4.06467403898278,0.216196136701337
"United States","Florida","FL",2020-12-06,2020-12-12,7,2020,"50",21477737,5085,716,4087,998,4369,3.333684549727,4.64667203998261,0.244188891607536
"United States","Florida","FL",2020-12-13,2020-12-19,7,2020,"51",21477737,4945,688,4134,811,4257,3.20331699750304,3.77600303048687,0.196178035800677
"United States","Florida","FL",2020-12-20,2020-12-26,7,2020,"52",21477737,5137,661,4160,977,4476,3.07760542928708,4.54889637581464,0.234855769230769
"United States","Florida","FL",2020-12-27,2021-01-02,7,2020,"53",21477737,5709,753,4245,1464,4956,3.50595595802295,6.81636058770996,0.344876325088339
"United States","Florida","FL",2021-01-03,2021-01-09,7,2021,"1",21477737,5497,917,4290,1207,4580,4.26953733533472,5.61977269765432,0.281351981351981
"United States","Florida","FL",2021-01-10,2021-01-16,7,2021,"2",21477737,5923,1200,4305,1618,4723,5.58718080959833,7.53338212494175,0.375842044134727
"United States","Florida","FL",2021-01-17,2021-01-23,7,2021,"3",21477737,5664,1160,4402,1262,4504,5.40094144927839,5.87585181809424,0.286687869150386
"United States","Florida","FL",2021-01-24,2021-01-30,7,2021,"4",21477737,5488,1196,4466,1022,4292,5.56855687356634,4.75841565617458,0.22884012539185
"United States","Florida","FL",2021-01-31,2021-02-06,7,2021,"5",21477737,5569,1243,4414,1155,4326,5.78738812194227,5.37766152923839,0.261667421839601
"United States","Florida","FL",2021-02-07,2021-02-13,7,2021,"6",21477737,5459,1085,4426,1033,4374,5.05174264867849,4.80963148026256,0.23339358337099
"United States","Florida","FL",2021-02-14,2021-02-20,7,2021,"7",21477737,5119,1126,4324,795,3993,5.24263799300643,3.70150728635889,0.183857539315449
"United States","Florida","FL",2021-02-21,2021-02-27,7,2021,"8",21477737,4910,926,4290,620,3984,4.31144119140671,2.88671008495914,0.144522144522145
"United States","Florida","FL",2021-02-28,2021-03-06,7,2021,"9",21477737,4839,886,4272,567,3953,4.12520183108677,2.63994293253521,0.132724719101124
"United States","Florida","FL",2021-03-07,2021-03-13,7,2021,"10",21477737,4652,628,4286,366,4024,2.92395795702313,1.70409014692749,0.0853943070461969
"United States","Florida","FL",2021-03-14,2021-03-20,7,2021,"11",21477737,4600,477,4286,314,4123,2.22090437181534,1.46197897851156,0.0732617825478301
"United States","Florida","FL",2021-03-21,2021-03-27,7,2021,"12",21477737,4749,444,4292,457,4305,2.06725689955138,2.12778469165536,0.106477166821994
"United States","Florida","FL",2021-03-28,2021-04-03,7,2021,"13",21477737,4491,497,4258,233,3994,2.31402405197531,1.08484427386368,0.0547205260685768
"United States","Florida","FL",2021-04-04,2021-04-10,7,2021,"14",21477737,4714,342,4200,514,4372,1.59234653073552,2.39317578011128,0.122380952380952
"United States","Florida","FL",2021-04-11,2021-04-17,7,2021,"15",21477737,4659,390,4154,505,4269,1.81583376311946,2.3512719240393,0.121569571497352
"United States","Florida","FL",2021-04-18,2021-04-24,7,2021,"16",21477737,4735,408,4138,597,4327,1.89964147526343,2.77962245277517,0.144272595456742
"United States","Florida","FL",2021-04-25,2021-05-01,7,2021,"17",21477737,4488,427,4064,424,4061,1.98810517141541,1.97413721939141,0.104330708661417
"United States","Florida","FL",2021-05-02,2021-05-08,7,2021,"18",21477737,4605,461,4009,596,4144,2.14640862768736,2.77496646876717,0.148665502619107
"United States","Florida","FL",2021-05-09,2021-05-15,7,2021,"19",21477737,4530,356,3955,575,4174,1.6575303068475,2.6771908045992,0.145385587863464
"United States","Florida","FL",2021-05-16,2021-05-22,7,2021,"20",21477737,4591,407,3944,647,4184,1.89498549125543,3.0124216531751,0.164046653144016
"United States","Florida","FL",2021-05-23,2021-05-29,7,2021,"21",21477737,4534,311,3918,616,4223,1.44801102648757,2.86808614892714,0.157223072996427
"United States","Florida","FL",2021-05-30,2021-06-05,7,2021,"22",21477737,4404,199,3885,519,4205,0.926540817591723,2.41645570015128,0.133590733590734
"United States","Florida","FL",2021-06-06,2021-06-12,7,2021,"23",21477737,4440,292,3864,576,4148,1.35954733033559,2.6818467886072,0.149068322981367
"United States","Florida","FL",2021-06-13,2021-06-19,7,2021,"24",21477737,4409,290,3847,562,4119,1.3502353623196,2.61666301249522,0.146087860670652
"United States","Florida","FL",2021-06-20,2021-06-26,7,2021,"25",21477737,4512,217,3853,659,4295,1.0103485297357,3.06829346127108,0.171035556709058
"United States","Florida","FL",2021-06-27,2021-07-03,7,2021,"26",21477737,4405,213,3832,573,4192,0.991724593703704,2.6678788365832,0.149530271398747
"United States","Florida","FL",2021-07-04,2021-07-10,7,2021,"27",21477737,4472,190,3819,653,4282,0.884636961519736,3.04035755722309,0.170987169416078
"United States","Florida","FL",2021-07-11,2021-07-17,7,2021,"28",21477737,4472,229,3795,677,4243,1.06622033783168,3.15210117341506,0.178392621870883
"United States","Florida","FL",2021-07-18,2021-07-24,7,2021,"29",21477737,4775,291,3763,1012,4484,1.35489134632759,4.71185581609459,0.268934360882275
"United States","Florida","FL",2021-07-25,2021-07-31,7,2021,"30",21477737,4997,416,3748,1249,4581,1.93688934732742,5.81532402599026,0.33324439701174
"United States","Florida","FL",2021-08-01,2021-08-07,7,2021,"31",21477737,4732,703,3770,962,4029,3.27315675762302,4.47905661569466,0.255172413793104
"United States","Georgia","GA",2019-12-29,2020-01-04,7,2020,"1",10617423,1803,0,1898,-95,1803,0,-0.894755723681726,-0.0500526870389885
"United States","Georgia","GA",2020-01-05,2020-01-11,7,2020,"2",10617423,1807,0,1917,-110,1807,0,-1.03603294321042,-0.0573813249869588
"United States","Georgia","GA",2020-01-12,2020-01-18,7,2020,"3",10617423,1746,0,1932,-186,1746,0,-1.7518375221558,-0.0962732919254659
"United States","Georgia","GA",2020-01-19,2020-01-25,7,2020,"4",10617423,1829,0,1925,-96,1829,0,-0.904174204983639,-0.0498701298701298
"United States","Georgia","GA",2020-01-26,2020-02-01,7,2020,"5",10617423,1797,0,1919,-122,1797,0,-1.14905471883337,-0.0635747785304847
"United States","Georgia","GA",2020-02-02,2020-02-08,7,2020,"6",10617423,1781,0,1853,-72,1781,0,-0.678130653737729,-0.0388559093362115
"United States","Georgia","GA",2020-02-09,2020-02-15,7,2020,"7",10617423,1762,0,1814,-52,1762,0,-0.489761027699471,-0.0286659316427784
"United States","Georgia","GA",2020-02-16,2020-02-22,7,2020,"8",10617423,1749,0,1783,-34,1749,0,-0.320228364265039,-0.0190689848569826
"United States","Georgia","GA",2020-02-23,2020-02-29,7,2020,"9",10617423,1860,0,1763,97,1860,0,0.913592686285552,0.0550198525241066
"United States","Georgia","GA",2020-03-01,2020-03-07,7,2020,"10",10617423,1755,0,1769,-14,1755,0,-0.131858738226781,-0.00791407574901071
"United States","Georgia","GA",2020-03-08,2020-03-14,7,2020,"11",10617423,1784,1,1762,22,1783,0.0094184813019129,0.207206588642084,0.0124858115777526
"United States","Georgia","GA",2020-03-15,2020-03-21,7,2020,"12",10617423,1775,19,1765,10,1756,0.178951144736345,0.094184813019129,0.0056657223796035
"United States","Georgia","GA",2020-03-22,2020-03-28,7,2020,"13",10617423,1881,58,1754,127,1823,0.546271915510948,1.19614712534294,0.072405929304447
"United States","Georgia","GA",2020-03-29,2020-04-04,7,2020,"14",10617423,2033,129,1732,301,1904,1.21498408794676,2.83496287187578,0.17378752886836
"United States","Georgia","GA",2020-04-05,2020-04-11,7,2020,"15",10617423,2042,223,1737,305,1819,2.10032133032658,2.87263679708344,0.175590097869891
"United States","Georgia","GA",2020-04-12,2020-04-18,7,2020,"16",10617423,2032,243,1712,320,1789,2.28869095636484,3.01391401661213,0.186915887850467
"United States","Georgia","GA",2020-04-19,2020-04-25,7,2020,"17",10617423,2040,229,1697,343,1811,2.15683221813805,3.23053908655613,0.202121390689452
"United States","Georgia","GA",2020-04-26,2020-05-02,7,2020,"18",10617423,1975,263,1671,304,1712,2.47706058240309,2.86321831578152,0.181926989826451
"United States","Georgia","GA",2020-05-03,2020-05-09,7,2020,"19",10617423,1987,225,1652,335,1762,2.1191582929304,3.15519123614082,0.202784503631961
"United States","Georgia","GA",2020-05-10,2020-05-16,7,2020,"20",10617423,1961,194,1642,319,1767,1.8271853725711,3.00449553531022,0.194275274056029
"United States","Georgia","GA",2020-05-17,2020-05-23,7,2020,"21",10617423,1911,234,1619,292,1677,2.20392462464762,2.75019654015857,0.18035824583076
"United States","Georgia","GA",2020-05-24,2020-05-30,7,2020,"22",10617423,1785,180,1601,184,1605,1.69532663434432,1.73300055955197,0.114928169893816
"United States","Georgia","GA",2020-05-31,2020-06-06,7,2020,"23",10617423,1782,173,1598,184,1609,1.62939726523093,1.73300055955197,0.11514392991239
"United States","Georgia","GA",2020-06-07,2020-06-13,7,2020,"24",10617423,1746,269,1592,154,1477,2.53357147021457,1.45044612049459,0.0967336683417086
"United States","Georgia","GA",2020-06-14,2020-06-20,7,2020,"25",10617423,1780,192,1587,193,1588,1.80834840996728,1.81776689126919,0.121613106490233
"United States","Georgia","GA",2020-06-21,2020-06-27,7,2020,"26",10617423,1823,145,1583,240,1678,1.36567978877737,2.2604355124591,0.151610865445357
"United States","Georgia","GA",2020-06-28,2020-07-04,7,2020,"27",10617423,1880,83,1576,304,1797,0.781733948058771,2.86321831578152,0.192893401015228
"United States","Georgia","GA",2020-07-05,2020-07-11,7,2020,"28",10617423,1983,137,1576,407,1846,1.29033193836207,3.83332188987855,0.258248730964467
"United States","Georgia","GA",2020-07-12,2020-07-18,7,2020,"29",10617423,2177,171,1572,605,2006,1.61056030262711,5.69818118765731,0.384860050890585
"United States","Georgia","GA",2020-07-19,2020-07-25,7,2020,"30",10617423,2177,327,1587,590,1850,3.07984338572552,5.55690396812861,0.37177063642092
"United States","Georgia","GA",2020-07-26,2020-08-01,7,2020,"31",10617423,2193,330,1591,602,1863,3.10809882963126,5.66992574375157,0.378378378378378
"United States","Georgia","GA",2020-08-02,2020-08-08,7,2020,"32",10617423,2192,361,1609,583,1831,3.40007174999056,5.49097459901522,0.362336855189559
"United States","Georgia","GA",2020-08-09,2020-08-15,7,2020,"33",10617423,2245,483,1609,636,1762,4.54912646882393,5.99015410801661,0.3952765692977
"United States","Georgia","GA",2020-08-16,2020-08-22,7,2020,"34",10617423,2247,423,1602,645,1824,3.98401759070916,6.07492043973382,0.402621722846442
"United States","Georgia","GA",2020-08-23,2020-08-29,7,2020,"35",10617423,2132,484,1608,524,1648,4.55854495012585,4.93528420220236,0.325870646766169
"United States","Georgia","GA",2020-08-30,2020-09-05,7,2020,"36",10617423,2044,401,1603,441,1643,3.77681100206707,4.15355025414359,0.275109170305677
"United States","Georgia","GA",2020-09-06,2020-09-12,7,2020,"37",10617423,2073,310,1587,486,1763,2.919729203593,4.57738191272967,0.306238185255199
"United States","Georgia","GA",2020-09-13,2020-09-19,7,2020,"38",10617423,1928,312,1586,342,1616,2.93856616619683,3.22112060525421,0.215636822194199
"United States","Georgia","GA",2020-09-20,2020-09-26,7,2020,"39",10617423,1997,315,1590,407,1682,2.96682161010256,3.83332188987855,0.255974842767296
"United States","Georgia","GA",2020-09-27,2020-10-03,7,2020,"40",10617423,1926,220,1591,335,1706,2.07206588642084,3.15519123614082,0.210559396605908
"United States","Georgia","GA",2020-10-04,2020-10-10,7,2020,"41",10617423,1886,259,1587,299,1627,2.43938665719544,2.81612590927196,0.188405797101449
"United States","Georgia","GA",2020-10-11,2020-10-17,7,2020,"42",10617423,1923,214,1607,316,1709,2.01555499860936,2.97624009140448,0.196639701306783
"United States","Georgia","GA",2020-10-18,2020-10-24,7,2020,"43",10617423,1960,201,1608,352,1759,1.89311474168449,3.31530541827334,0.218905472636816
"United States","Georgia","GA",2020-10-25,2020-10-31,7,2020,"44",10617423,1944,163,1628,316,1781,1.5352124522118,2.97624009140448,0.194103194103194
"United States","Georgia","GA",2020-11-01,2020-11-07,7,2020,"45",10617423,2020,219,1645,375,1801,2.06264740511893,3.53193048821734,0.227963525835866
"United States","Georgia","GA",2020-11-08,2020-11-14,7,2020,"46",10617423,2050,257,1650,400,1793,2.42054969459162,3.76739252076516,0.242424242424242
"United States","Georgia","GA",2020-11-15,2020-11-21,7,2020,"47",10617423,1978,166,1671,307,1812,1.56346789611754,2.89147375968726,0.183722321962897
"United States","Georgia","GA",2020-11-22,2020-11-28,7,2020,"48",10617423,2070,158,1699,371,1912,1.48812004570224,3.49425656300969,0.218363743378458
"United States","Georgia","GA",2020-11-29,2020-12-05,7,2020,"49",10617423,2171,196,1722,449,1975,1.84602233517493,4.22889810455889,0.260743321718931
"United States","Georgia","GA",2020-12-06,2020-12-12,7,2020,"50",10617423,2241,236,1738,503,2005,2.22276158725145,4.73749609486219,0.289413118527043
"United States","Georgia","GA",2020-12-13,2020-12-19,7,2020,"51",10617423,2422,231,1762,660,2191,2.17566918074188,6.21619765926252,0.374574347332577
"United States","Georgia","GA",2020-12-20,2020-12-26,7,2020,"52",10617423,2379,274,1790,589,2105,2.58066387672414,5.5474854868267,0.329050279329609
"United States","Georgia","GA",2020-12-27,2021-01-02,7,2020,"53",10617423,2724,183,1815,909,2541,1.72358207825006,8.56139950343883,0.500826446280992
"United States","Georgia","GA",2021-01-03,2021-01-09,7,2021,"1",10617423,2860,389,1829,1031,2471,3.66378922644412,9.7104542222722,0.56369600874795
"United States","Georgia","GA",2021-01-10,2021-01-16,7,2021,"2",10617423,3086,749,1838,1248,2337,7.05444249513276,11.7542646647873,0.678998911860718
"United States","Georgia","GA",2021-01-17,2021-01-23,7,2021,"3",10617423,2942,769,1848,1094,2173,7.24281212117102,10.3038185442927,0.591991341991342
"United States","Georgia","GA",2021-01-24,2021-01-30,7,2021,"4",10617423,2756,770,1828,928,1986,7.25223060247294,8.74035064817517,0.507658643326039
"United States","Georgia","GA",2021-01-31,2021-02-06,7,2021,"5",10617423,2699,756,1806,893,1943,7.12037186424615,8.41070380260822,0.494462901439646
"United States","Georgia","GA",2021-02-07,2021-02-13,7,2021,"6",10617423,2373,638,1769,604,1735,6.00899107062043,5.68876270635539,0.34143583945732
"United States","Georgia","GA",2021-02-14,2021-02-20,7,2021,"7",10617423,2268,668,1739,529,1600,6.29154550967782,4.98237660871193,0.304197814836113
"United States","Georgia","GA",2021-02-21,2021-02-27,7,2021,"8",10617423,2108,438,1706,402,1670,4.12529481023785,3.78622948336899,0.235638921453693
"United States","Georgia","GA",2021-02-28,2021-03-06,7,2021,"9",10617423,1943,536,1713,230,1407,5.04830597782532,2.16625069943997,0.134267367192061
"United States","Georgia","GA",2021-03-07,2021-03-13,7,2021,"10",10617423,1991,285,1706,285,1706,2.68426717104518,2.68426717104518,0.167057444314185
"United States","Georgia","GA",2021-03-14,2021-03-20,7,2021,"11",10617423,1923,275,1723,200,1648,2.59008235802605,1.88369626038258,0.116076610562972
"United States","Georgia","GA",2021-03-21,2021-03-27,7,2021,"12",10617423,1886,336,1719,167,1550,3.16460971744274,1.57288637741945,0.0971495055264688
"United States","Georgia","GA",2021-03-28,2021-04-03,7,2021,"13",10617423,1751,2710,1716,35,-959,25.524084328184,0.329646845566952,0.0203962703962703
"United States","Georgia","GA",2021-04-04,2021-04-10,7,2021,"14",10617423,1943,278,1712,231,1665,2.61833780193179,2.17566918074188,0.134929906542056
"United States","Georgia","GA",2021-04-11,2021-04-17,7,2021,"15",10617423,1875,269,1699,176,1606,2.53357147021457,1.65765270913667,0.103590347263096
"United States","Georgia","GA",2021-04-18,2021-04-24,7,2021,"16",10617423,1884,216,1703,181,1668,2.03439196121319,1.70474511564624,0.106283029947152
"United States","Georgia","GA",2021-04-25,2021-05-01,7,2021,"17",10617423,1817,239,1685,132,1578,2.25101703115718,1.2432395318525,0.0783382789317508
"United States","Georgia","GA",2021-05-02,2021-05-08,7,2021,"18",10617423,1804,156,1682,122,1648,1.46928308309841,1.14905471883337,0.0725326991676576
"United States","Georgia","GA",2021-05-09,2021-05-15,7,2021,"19",10617423,1767,137,1656,111,1630,1.29033193836207,1.04545142451233,0.0670289855072463
"United States","Georgia","GA",2021-05-16,2021-05-22,7,2021,"20",10617423,1853,156,1635,218,1697,1.46928308309841,2.05322892381701,0.133333333333333
"United States","Georgia","GA",2021-05-23,2021-05-29,7,2021,"21",10617423,1846,176,1633,213,1670,1.65765270913667,2.00613651730745,0.130434782608696
"United States","Georgia","GA",2021-05-30,2021-06-05,7,2021,"22",10617423,1743,149,1614,129,1594,1.40335371398502,1.21498408794676,0.0799256505576209
"United States","Georgia","GA",2021-06-06,2021-06-12,7,2021,"23",10617423,1741,172,1611,130,1569,1.61997878392902,1.22440256924868,0.0806952203600249
"United States","Georgia","GA",2021-06-13,2021-06-19,7,2021,"24",10617423,1675,161,1601,74,1514,1.51637548960798,0.696967616341555,0.0462211118051219
"United States","Georgia","GA",2021-06-20,2021-06-26,7,2021,"25",10617423,1716,74,1588,128,1642,0.696967616341555,1.20556560664485,0.0806045340050379
"United States","Georgia","GA",2021-06-27,2021-07-03,7,2021,"26",10617423,1694,50,1590,104,1644,0.470924065095645,0.979522055398942,0.0654088050314465
"United States","Georgia","GA",2021-07-04,2021-07-10,7,2021,"27",10617423,1691,43,1592,99,1648,0.404994695982255,0.932429648889377,0.0621859296482412
"United States","Georgia","GA",2021-07-11,2021-07-17,7,2021,"28",10617423,1628,72,1613,15,1556,0.678130653737729,0.141277219528694,0.00929944203347799
"United States","Georgia","GA",2021-07-18,2021-07-24,7,2021,"29",10617423,1610,56,1614,-4,1554,0.527434952907123,-0.0376739252076516,-0.00247831474597271
"United States","Georgia","GA",2021-07-25,2021-07-31,7,2021,"30",10617423,1539,62,1605,-66,1477,0.5839458407186,-0.621619765926252,-0.0411214953271029
"United States","Georgia","GA",2021-08-01,2021-08-07,7,2021,"31",10617423,1150,126,1616,-466,1024,1.18672864404103,-4.38901228669141,-0.288366336633663
"United States","Hawaii","HI",2019-12-29,2020-01-04,7,2020,"1",1415872,242,0,268,-26,242,0,-1.83632418749717,-0.0970149253731343
"United States","Hawaii","HI",2020-01-05,2020-01-11,7,2020,"2",1415872,242,0,264,-22,242,0,-1.55381277403607,-0.0833333333333334
"United States","Hawaii","HI",2020-01-12,2020-01-18,7,2020,"3",1415872,215,0,262,-47,215,0,-3.31950910816797,-0.179389312977099
"United States","Hawaii","HI",2020-01-19,2020-01-25,7,2020,"4",1415872,242,0,253,-11,242,0,-0.776906387018036,-0.0434782608695652
"United States","Hawaii","HI",2020-01-26,2020-02-01,7,2020,"5",1415872,242,0,247,-5,242,0,-0.35313926682638,-0.0202429149797571
"United States","Hawaii","HI",2020-02-02,2020-02-08,7,2020,"6",1415872,236,0,248,-12,236,0,-0.847534240383311,-0.0483870967741935
"United States","Hawaii","HI",2020-02-09,2020-02-15,7,2020,"7",1415872,281,0,249,32,281,0,2.26009130768883,0.1285140562249
"United States","Hawaii","HI",2020-02-16,2020-02-22,7,2020,"8",1415872,250,0,251,-1,250,0,-0.070627853365276,-0.00398406374501992
"United States","Hawaii","HI",2020-02-23,2020-02-29,7,2020,"9",1415872,238,0,254,-16,238,0,-1.13004565384442,-0.062992125984252
"United States","Hawaii","HI",2020-03-01,2020-03-07,7,2020,"10",1415872,239,0,252,-13,239,0,-0.918162093748587,-0.0515873015873016
"United States","Hawaii","HI",2020-03-08,2020-03-14,7,2020,"11",1415872,243,0,252,-9,243,0,-0.635650680287484,-0.0357142857142857
"United States","Hawaii","HI",2020-03-15,2020-03-21,7,2020,"12",1415872,212,0,253,-41,212,0,-2.89574198797631,-0.162055335968379
"United States","Hawaii","HI",2020-03-22,2020-03-28,7,2020,"13",1415872,235,0,250,-15,235,0,-1.05941780047914,-0.0600000000000001
"United States","Hawaii","HI",2020-03-29,2020-04-04,7,2020,"14",1415872,235,3,239,-4,232,0.211883560095828,-0.282511413461104,-0.0167364016736402
"United States","Hawaii","HI",2020-04-05,2020-04-11,7,2020,"15",1415872,221,5,233,-12,216,0.35313926682638,-0.847534240383311,-0.0515021459227468
"United States","Hawaii","HI",2020-04-12,2020-04-18,7,2020,"16",1415872,211,1,230,-19,210,0.070627853365276,-1.34192921394024,-0.0826086956521739
"United States","Hawaii","HI",2020-04-19,2020-04-25,7,2020,"17",1415872,200,0,230,-30,200,0,-2.11883560095828,-0.130434782608696
"United States","Hawaii","HI",2020-04-26,2020-05-02,7,2020,"18",1415872,223,7,225,-2,216,0.494394973556932,-0.141255706730552,-0.00888888888888884
"United States","Hawaii","HI",2020-05-03,2020-05-09,7,2020,"19",1415872,210,1,228,-18,209,0.070627853365276,-1.27130136057497,-0.0789473684210527
"United States","Hawaii","HI",2020-05-10,2020-05-16,7,2020,"20",1415872,230,0,226,4,230,0,0.282511413461104,0.0176991150442478
"United States","Hawaii","HI",2020-05-17,2020-05-23,7,2020,"21",1415872,210,0,223,-13,210,0,-0.918162093748587,-0.0582959641255605
"United States","Hawaii","HI",2020-05-24,2020-05-30,7,2020,"22",1415872,200,0,225,-25,200,0,-1.7656963341319,-0.111111111111111
"United States","Hawaii","HI",2020-05-31,2020-06-06,7,2020,"23",1415872,217,0,227,-10,217,0,-0.706278533652759,-0.0440528634361234
"United States","Hawaii","HI",2020-06-07,2020-06-13,7,2020,"24",1415872,203,0,226,-23,203,0,-1.62444062740135,-0.101769911504425
"United States","Hawaii","HI",2020-06-14,2020-06-20,7,2020,"25",1415872,246,0,226,20,246,0,1.41255706730552,0.0884955752212389
"United States","Hawaii","HI",2020-06-21,2020-06-27,7,2020,"26",1415872,236,1,225,11,235,0.070627853365276,0.776906387018036,0.048888888888889
"United States","Hawaii","HI",2020-06-28,2020-07-04,7,2020,"27",1415872,207,1,224,-17,206,0.070627853365276,-1.20067350720969,-0.0758928571428571
"United States","Hawaii","HI",2020-07-05,2020-07-11,7,2020,"28",1415872,239,0,221,18,239,0,1.27130136057497,0.0814479638009049
"United States","Hawaii","HI",2020-07-12,2020-07-18,7,2020,"29",1415872,227,5,219,8,222,0.35313926682638,0.565022826922208,0.0365296803652968
"United States","Hawaii","HI",2020-07-19,2020-07-25,7,2020,"30",1415872,219,2,214,5,217,0.141255706730552,0.35313926682638,0.0233644859813085
"United States","Hawaii","HI",2020-07-26,2020-08-01,7,2020,"31",1415872,217,0,214,3,217,0,0.211883560095828,0.014018691588785
"United States","Hawaii","HI",2020-08-02,2020-08-08,7,2020,"32",1415872,231,5,212,19,226,0.35313926682638,1.34192921394024,0.0896226415094339
"United States","Hawaii","HI",2020-08-09,2020-08-15,7,2020,"33",1415872,223,9,213,10,214,0.635650680287484,0.706278533652759,0.0469483568075117
"United States","Hawaii","HI",2020-08-16,2020-08-22,7,2020,"34",1415872,242,7,213,29,235,0.494394973556932,2.048207747593,0.136150234741784
"United States","Hawaii","HI",2020-08-23,2020-08-29,7,2020,"35",1415872,255,15,216,39,240,1.05941780047914,2.75448628124576,0.180555555555556
"United States","Hawaii","HI",2020-08-30,2020-09-05,7,2020,"36",1415872,235,22,217,18,213,1.55381277403607,1.27130136057497,0.0829493087557605
"United States","Hawaii","HI",2020-09-06,2020-09-12,7,2020,"37",1415872,274,13,218,56,261,0.918162093748587,3.95515978845545,0.256880733944954
"United States","Hawaii","HI",2020-09-13,2020-09-19,7,2020,"38",1415872,242,23,214,28,219,1.62444062740135,1.97757989422773,0.130841121495327
"United States","Hawaii","HI",2020-09-20,2020-09-26,7,2020,"39",1415872,242,11,213,29,231,0.776906387018036,2.048207747593,0.136150234741784
"United States","Hawaii","HI",2020-09-27,2020-10-03,7,2020,"40",1415872,214,22,209,5,192,1.55381277403607,0.35313926682638,0.0239234449760766
"United States","Hawaii","HI",2020-10-04,2020-10-10,7,2020,"41",1415872,231,15,210,21,216,1.05941780047914,1.4831849206708,0.1
"United States","Hawaii","HI",2020-10-11,2020-10-17,7,2020,"42",1415872,237,18,207,30,219,1.27130136057497,2.11883560095828,0.144927536231884
"United States","Hawaii","HI",2020-10-18,2020-10-24,7,2020,"43",1415872,237,26,212,25,211,1.83632418749717,1.7656963341319,0.117924528301887
"United States","Hawaii","HI",2020-10-25,2020-10-31,7,2020,"44",1415872,238,7,216,22,231,0.494394973556932,1.55381277403607,0.101851851851852
"United States","Hawaii","HI",2020-11-01,2020-11-07,7,2020,"45",1415872,236,1,218,18,235,0.070627853365276,1.27130136057497,0.0825688073394495
"United States","Hawaii","HI",2020-11-08,2020-11-14,7,2020,"46",1415872,249,2,219,30,247,0.141255706730552,2.11883560095828,0.136986301369863
"United States","Hawaii","HI",2020-11-15,2020-11-21,7,2020,"47",1415872,224,9,229,-5,215,0.635650680287484,-0.35313926682638,-0.0218340611353712
"United States","Hawaii","HI",2020-11-22,2020-11-28,7,2020,"48",1415872,216,9,229,-13,207,0.635650680287484,-0.918162093748587,-0.0567685589519651
"United States","Hawaii","HI",2020-11-29,2020-12-05,7,2020,"49",1415872,237,21,230,7,216,1.4831849206708,0.494394973556932,0.0304347826086957
"United States","Hawaii","HI",2020-12-06,2020-12-12,7,2020,"50",1415872,212,8,236,-24,204,0.565022826922208,-1.69506848076662,-0.101694915254237
"United States","Hawaii","HI",2020-12-13,2020-12-19,7,2020,"51",1415872,249,0,243,6,249,0,0.423767120191656,0.0246913580246915
"United States","Hawaii","HI",2020-12-20,2020-12-26,7,2020,"52",1415872,198,0,239,-41,198,0,-2.89574198797631,-0.171548117154812
"United States","Hawaii","HI",2020-12-27,2021-01-02,7,2020,"53",1415872,225,0,249,-24,225,0,-1.69506848076662,-0.0963855421686747
"United States","Hawaii","HI",2021-01-03,2021-01-09,7,2021,"1",1415872,215,38,252,-37,177,2.68385842788049,-2.61323057451521,-0.146825396825397
"United States","Hawaii","HI",2021-01-10,2021-01-16,7,2021,"2",1415872,246,13,250,-4,233,0.918162093748587,-0.282511413461104,-0.016
"United States","Hawaii","HI",2021-01-17,2021-01-23,7,2021,"3",1415872,205,8,248,-43,197,0.565022826922208,-3.03699769470687,-0.173387096774194
"United States","Hawaii","HI",2021-01-24,2021-01-30,7,2021,"4",1415872,227,73,245,-18,154,5.15583329566515,-1.27130136057497,-0.073469387755102
"United States","Hawaii","HI",2021-01-31,2021-02-06,7,2021,"5",1415872,237,15,243,-6,222,1.05941780047914,-0.423767120191656,-0.0246913580246914
"United States","Hawaii","HI",2021-02-07,2021-02-13,7,2021,"6",1415872,264,9,243,21,255,0.635650680287484,1.4831849206708,0.0864197530864197
"United States","Hawaii","HI",2021-02-14,2021-02-20,7,2021,"7",1415872,250,5,244,6,245,0.35313926682638,0.423767120191656,0.0245901639344261
"United States","Hawaii","HI",2021-02-21,2021-02-27,7,2021,"8",1415872,265,9,246,19,256,0.635650680287484,1.34192921394024,0.0772357723577235
"United States","Hawaii","HI",2021-02-28,2021-03-06,7,2021,"9",1415872,232,5,252,-20,227,0.35313926682638,-1.41255706730552,-0.0793650793650794
"United States","Hawaii","HI",2021-03-07,2021-03-13,7,2021,"10",1415872,255,5,249,6,250,0.35313926682638,0.423767120191656,0.0240963855421688
"United States","Hawaii","HI",2021-03-14,2021-03-20,7,2021,"11",1415872,236,4,253,-17,232,0.282511413461104,-1.20067350720969,-0.067193675889328
"United States","Hawaii","HI",2021-03-21,2021-03-27,7,2021,"12",1415872,244,9,248,-4,235,0.635650680287484,-0.282511413461104,-0.0161290322580645
"United States","Hawaii","HI",2021-03-28,2021-04-03,7,2021,"13",1415872,252,5,242,10,247,0.35313926682638,0.706278533652759,0.0413223140495869
"United States","Hawaii","HI",2021-04-04,2021-04-10,7,2021,"14",1415872,252,4,234,18,248,0.282511413461104,1.27130136057497,0.0769230769230769
"United States","Hawaii","HI",2021-04-11,2021-04-17,7,2021,"15",1415872,220,3,231,-11,217,0.211883560095828,-0.776906387018036,-0.0476190476190477
"United States","Hawaii","HI",2021-04-18,2021-04-24,7,2021,"16",1415872,256,4,226,30,252,0.282511413461104,2.11883560095828,0.132743362831858
"United States","Hawaii","HI",2021-04-25,2021-05-01,7,2021,"17",1415872,236,5,225,11,231,0.35313926682638,0.776906387018036,0.048888888888889
"United States","Hawaii","HI",2021-05-02,2021-05-08,7,2021,"18",1415872,241,4,227,14,237,0.282511413461104,0.988789947113863,0.0616740088105727
"United States","Hawaii","HI",2021-05-09,2021-05-15,7,2021,"19",1415872,234,3,229,5,231,0.211883560095828,0.35313926682638,0.0218340611353711
"United States","Hawaii","HI",2021-05-16,2021-05-22,7,2021,"20",1415872,256,4,228,28,252,0.282511413461104,1.97757989422773,0.12280701754386
"United States","Hawaii","HI",2021-05-23,2021-05-29,7,2021,"21",1415872,215,5,227,-12,210,0.35313926682638,-0.847534240383311,-0.052863436123348
"United States","Hawaii","HI",2021-05-30,2021-06-05,7,2021,"22",1415872,212,3,227,-15,209,0.211883560095828,-1.05941780047914,-0.066079295154185
"United States","Hawaii","HI",2021-06-06,2021-06-12,7,2021,"23",1415872,224,3,229,-5,221,0.211883560095828,-0.35313926682638,-0.0218340611353712
"United States","Hawaii","HI",2021-06-13,2021-06-19,7,2021,"24",1415872,232,5,229,3,227,0.35313926682638,0.211883560095828,0.0131004366812226
"United States","Hawaii","HI",2021-06-20,2021-06-26,7,2021,"25",1415872,225,4,231,-6,221,0.282511413461104,-0.423767120191656,-0.025974025974026
"United States","Hawaii","HI",2021-06-27,2021-07-03,7,2021,"26",1415872,210,4,230,-20,206,0.282511413461104,-1.41255706730552,-0.0869565217391305
"United States","Hawaii","HI",2021-07-04,2021-07-10,7,2021,"27",1415872,236,1,225,11,235,0.070627853365276,0.776906387018036,0.048888888888889
"United States","Hawaii","HI",2021-07-11,2021-07-17,7,2021,"28",1415872,221,4,222,-1,217,0.282511413461104,-0.070627853365276,-0.00450450450450446
"United States","Hawaii","HI",2021-07-18,2021-07-24,7,2021,"29",1415872,223,4,220,3,219,0.282511413461104,0.211883560095828,0.0136363636363637
"United States","Hawaii","HI",2021-07-25,2021-07-31,7,2021,"30",1415872,213,10,216,-3,203,0.706278533652759,-0.211883560095828,-0.0138888888888888
"United States","Hawaii","HI",2021-08-01,2021-08-07,7,2021,"31",1415872,162,3,214,-52,159,0.211883560095828,-3.67264837499435,-0.242990654205608
"United States","Idaho","ID",2019-12-29,2020-01-04,7,2020,"1",1787065,278,0,316,-38,278,0,-2.12639159739573,-0.120253164556962
"United States","Idaho","ID",2020-01-05,2020-01-11,7,2020,"2",1787065,292,0,313,-21,292,0,-1.17511114592922,-0.0670926517571885
"United States","Idaho","ID",2020-01-12,2020-01-18,7,2020,"3",1787065,293,0,314,-21,293,0,-1.17511114592922,-0.0668789808917197
"United States","Idaho","ID",2020-01-19,2020-01-25,7,2020,"4",1787065,275,0,311,-36,275,0,-2.01447625016438,-0.115755627009646
"United States","Idaho","ID",2020-01-26,2020-02-01,7,2020,"5",1787065,249,0,306,-57,249,0,-3.18958739609359,-0.186274509803922
"United States","Idaho","ID",2020-02-02,2020-02-08,7,2020,"6",1787065,292,0,301,-9,292,0,-0.503619062541094,-0.0299003322259136
"United States","Idaho","ID",2020-02-09,2020-02-15,7,2020,"7",1787065,279,0,303,-24,279,0,-1.34298416677625,-0.0792079207920792
"United States","Idaho","ID",2020-02-16,2020-02-22,7,2020,"8",1787065,318,0,299,19,318,0,1.06319579869787,0.0635451505016722
"United States","Idaho","ID",2020-02-23,2020-02-29,7,2020,"9",1787065,290,0,296,-6,290,0,-0.335746041694063,-0.0202702702702703
"United States","Idaho","ID",2020-03-01,2020-03-07,7,2020,"10",1787065,278,0,299,-21,278,0,-1.17511114592922,-0.0702341137123745
"United States","Idaho","ID",2020-03-08,2020-03-14,7,2020,"11",1787065,282,0,300,-18,282,0,-1.00723812508219,-0.0600000000000001
"United States","Idaho","ID",2020-03-15,2020-03-21,7,2020,"12",1787065,308,0,297,11,308,0,0.615534409772448,0.037037037037037
"United States","Idaho","ID",2020-03-22,2020-03-28,7,2020,"13",1787065,332,5,295,37,327,0.279788368078385,2.07043392378005,0.125423728813559
"United States","Idaho","ID",2020-03-29,2020-04-04,7,2020,"14",1787065,271,5,297,-26,266,0.279788368078385,-1.4548995140076,-0.0875420875420876
"United States","Idaho","ID",2020-04-05,2020-04-11,7,2020,"15",1787065,306,17,291,15,289,0.951280451466511,0.839365104235157,0.0515463917525774
"United States","Idaho","ID",2020-04-12,2020-04-18,7,2020,"16",1787065,283,17,286,-3,266,0.951280451466511,-0.167873020847031,-0.0104895104895105
"United States","Idaho","ID",2020-04-19,2020-04-25,7,2020,"17",1787065,262,12,285,-23,250,0.671492083388125,-1.28702649316057,-0.0807017543859649
"United States","Idaho","ID",2020-04-26,2020-05-02,7,2020,"18",1787065,252,7,281,-29,245,0.39170371530974,-1.62277253485464,-0.103202846975089
"United States","Idaho","ID",2020-05-03,2020-05-09,7,2020,"19",1787065,304,4,279,25,300,0.223830694462708,1.39894184039193,0.0896057347670252
"United States","Idaho","ID",2020-05-10,2020-05-16,7,2020,"20",1787065,269,6,286,-17,263,0.335746041694063,-0.951280451466511,-0.0594405594405595
"United States","Idaho","ID",2020-05-17,2020-05-23,7,2020,"21",1787065,262,5,286,-24,257,0.279788368078385,-1.34298416677625,-0.083916083916084
"United States","Idaho","ID",2020-05-24,2020-05-30,7,2020,"22",1787065,279,4,285,-6,275,0.223830694462708,-0.335746041694063,-0.0210526315789473
"United States","Idaho","ID",2020-05-31,2020-06-06,7,2020,"23",1787065,294,1,286,8,293,0.0559576736156771,0.447661388925417,0.0279720279720279
"United States","Idaho","ID",2020-06-07,2020-06-13,7,2020,"24",1787065,286,3,283,3,283,0.167873020847031,0.167873020847031,0.010600706713781
"United States","Idaho","ID",2020-06-14,2020-06-20,7,2020,"25",1787065,282,3,285,-3,279,0.167873020847031,-0.167873020847031,-0.0105263157894737
"United States","Idaho","ID",2020-06-21,2020-06-27,7,2020,"26",1787065,296,2,281,15,294,0.111915347231354,0.839365104235157,0.0533807829181494
"United States","Idaho","ID",2020-06-28,2020-07-04,7,2020,"27",1787065,281,1,282,-1,280,0.0559576736156771,-0.0559576736156771,-0.00354609929078009
"United States","Idaho","ID",2020-07-05,2020-07-11,7,2020,"28",1787065,287,10,280,7,277,0.559576736156771,0.39170371530974,0.0249999999999999
"United States","Idaho","ID",2020-07-12,2020-07-18,7,2020,"29",1787065,312,17,276,36,295,0.951280451466511,2.01447625016438,0.130434782608696
"United States","Idaho","ID",2020-07-19,2020-07-25,7,2020,"30",1787065,328,27,279,49,301,1.51085718762328,2.74192600716818,0.175627240143369
"United States","Idaho","ID",2020-07-26,2020-08-01,7,2020,"31",1787065,327,50,275,52,277,2.79788368078386,2.90979902801521,0.189090909090909
"United States","Idaho","ID",2020-08-02,2020-08-08,7,2020,"32",1787065,312,39,275,37,273,2.18234927101141,2.07043392378005,0.134545454545455
"United States","Idaho","ID",2020-08-09,2020-08-15,7,2020,"33",1787065,319,34,273,46,285,1.90256090293302,2.57405298632115,0.168498168498169
"United States","Idaho","ID",2020-08-16,2020-08-22,7,2020,"34",1787065,360,37,272,88,323,2.07043392378005,4.92427527817958,0.323529411764706
"United States","Idaho","ID",2020-08-23,2020-08-29,7,2020,"35",1787065,327,52,269,58,275,2.90979902801521,3.24554506970927,0.215613382899628
"United States","Idaho","ID",2020-08-30,2020-09-05,7,2020,"36",1787065,352,26,271,81,326,1.4548995140076,4.53257156286985,0.298892988929889
"United States","Idaho","ID",2020-09-06,2020-09-12,7,2020,"37",1787065,321,31,271,50,290,1.73468788208599,2.79788368078386,0.18450184501845
"United States","Idaho","ID",2020-09-13,2020-09-19,7,2020,"38",1787065,320,26,272,48,294,1.4548995140076,2.6859683335525,0.176470588235294
"United States","Idaho","ID",2020-09-20,2020-09-26,7,2020,"39",1787065,292,19,268,24,273,1.06319579869787,1.34298416677625,0.0895522388059702
"United States","Idaho","ID",2020-09-27,2020-10-03,7,2020,"40",1787065,328,20,270,58,308,1.11915347231354,3.24554506970927,0.214814814814815
"United States","Idaho","ID",2020-10-04,2020-10-10,7,2020,"41",1787065,300,27,271,29,273,1.51085718762328,1.62277253485464,0.107011070110701
"United States","Idaho","ID",2020-10-11,2020-10-17,7,2020,"42",1787065,326,22,268,58,304,1.2310688195449,3.24554506970927,0.216417910447761
"United States","Idaho","ID",2020-10-18,2020-10-24,7,2020,"43",1787065,341,42,271,70,299,2.35022229185844,3.9170371530974,0.25830258302583
"United States","Idaho","ID",2020-10-25,2020-10-31,7,2020,"44",1787065,351,57,275,76,294,3.18958739609359,4.25278319479146,0.276363636363636
"United States","Idaho","ID",2020-11-01,2020-11-07,7,2020,"45",1787065,365,54,271,94,311,3.02171437524656,5.26002131987365,0.346863468634686
"United States","Idaho","ID",2020-11-08,2020-11-14,7,2020,"46",1787065,410,68,265,145,342,3.80512180586604,8.11386267427318,0.547169811320755
"United States","Idaho","ID",2020-11-15,2020-11-21,7,2020,"47",1787065,391,95,263,128,296,5.31597899348932,7.16258222280667,0.486692015209125
"United States","Idaho","ID",2020-11-22,2020-11-28,7,2020,"48",1787065,424,68,265,159,356,3.80512180586604,8.89727010489266,0.6
"United States","Idaho","ID",2020-11-29,2020-12-05,7,2020,"49",1787065,397,119,269,128,278,6.65896316026557,7.16258222280667,0.475836431226766
"United States","Idaho","ID",2020-12-06,2020-12-12,7,2020,"50",1787065,373,137,277,96,236,7.66620128534776,5.371936667105,0.346570397111913
"United States","Idaho","ID",2020-12-13,2020-12-19,7,2020,"51",1787065,394,106,280,114,288,5.93151340326177,6.37917479218719,0.407142857142857
"United States","Idaho","ID",2020-12-20,2020-12-26,7,2020,"52",1787065,390,38,289,101,352,2.12639159739573,5.65172503518339,0.349480968858132
"United States","Idaho","ID",2020-12-27,2021-01-02,7,2020,"53",1787065,349,135,291,58,214,7.55428593811641,3.24554506970927,0.199312714776632
"United States","Idaho","ID",2021-01-03,2021-01-09,7,2021,"1",1787065,389,80,294,95,309,4.47661388925417,5.31597899348932,0.32312925170068
"United States","Idaho","ID",2021-01-10,2021-01-16,7,2021,"2",1787065,341,77,293,48,264,4.30874086840714,2.6859683335525,0.16382252559727
"United States","Idaho","ID",2021-01-17,2021-01-23,7,2021,"3",1787065,339,63,297,42,276,3.52533343778766,2.35022229185844,0.141414141414141
"United States","Idaho","ID",2021-01-24,2021-01-30,7,2021,"4",1787065,284,57,294,-10,227,3.18958739609359,-0.559576736156771,-0.0340136054421769
"United States","Idaho","ID",2021-01-31,2021-02-06,7,2021,"5",1787065,328,42,301,27,286,2.35022229185844,1.51085718762328,0.0897009966777409
"United States","Idaho","ID",2021-02-07,2021-02-13,7,2021,"6",1787065,305,37,307,-2,268,2.07043392378005,-0.111915347231354,-0.00651465798045603
"United States","Idaho","ID",2021-02-14,2021-02-20,7,2021,"7",1787065,298,22,311,-13,276,1.2310688195449,-0.727449757003802,-0.0418006430868167
"United States","Idaho","ID",2021-02-21,2021-02-27,7,2021,"8",1787065,305,34,313,-8,271,1.90256090293302,-0.447661388925417,-0.0255591054313099
"United States","Idaho","ID",2021-02-28,2021-03-06,7,2021,"9",1787065,310,17,303,7,293,0.951280451466511,0.39170371530974,0.023102310231023
"United States","Idaho","ID",2021-03-07,2021-03-13,7,2021,"10",1787065,311,33,302,9,278,1.84660322931734,0.503619062541094,0.0298013245033113
"United States","Idaho","ID",2021-03-14,2021-03-20,7,2021,"11",1787065,295,31,298,-3,264,1.73468788208599,-0.167873020847031,-0.0100671140939598
"United States","Idaho","ID",2021-03-21,2021-03-27,7,2021,"12",1787065,303,15,297,6,288,0.839365104235157,0.335746041694063,0.0202020202020201
"United States","Idaho","ID",2021-03-28,2021-04-03,7,2021,"13",1787065,325,10,296,29,315,0.559576736156771,1.62277253485464,0.097972972972973
"United States","Idaho","ID",2021-04-04,2021-04-10,7,2021,"14",1787065,346,23,294,52,323,1.28702649316057,2.90979902801521,0.17687074829932
"United States","Idaho","ID",2021-04-11,2021-04-17,7,2021,"15",1787065,280,28,288,-8,252,1.56681486123896,-0.447661388925417,-0.0277777777777778
"United States","Idaho","ID",2021-04-18,2021-04-24,7,2021,"16",1787065,284,14,287,-3,270,0.783407430619479,-0.167873020847031,-0.0104529616724739
"United States","Idaho","ID",2021-04-25,2021-05-01,7,2021,"17",1787065,276,15,282,-6,261,0.839365104235157,-0.335746041694063,-0.0212765957446809
"United States","Idaho","ID",2021-05-02,2021-05-08,7,2021,"18",1787065,276,15,278,-2,261,0.839365104235157,-0.111915347231354,-0.0071942446043165
"United States","Idaho","ID",2021-05-09,2021-05-15,7,2021,"19",1787065,291,3,277,14,288,0.167873020847031,0.783407430619479,0.0505415162454874
"United States","Idaho","ID",2021-05-16,2021-05-22,7,2021,"20",1787065,329,16,281,48,313,0.895322777850834,2.6859683335525,0.170818505338078
"United States","Idaho","ID",2021-05-23,2021-05-29,7,2021,"21",1787065,325,10,280,45,315,0.559576736156771,2.51809531270547,0.160714285714286
"United States","Idaho","ID",2021-05-30,2021-06-05,7,2021,"22",1787065,294,11,278,16,283,0.615534409772448,0.895322777850834,0.0575539568345325
"United States","Idaho","ID",2021-06-06,2021-06-12,7,2021,"23",1787065,323,15,277,46,308,0.839365104235157,2.57405298632115,0.166064981949458
"United States","Idaho","ID",2021-06-13,2021-06-19,7,2021,"24",1787065,318,6,273,45,312,0.335746041694063,2.51809531270547,0.164835164835165
"United States","Idaho","ID",2021-06-20,2021-06-26,7,2021,"25",1787065,298,23,271,27,275,1.28702649316057,1.51085718762328,0.0996309963099631
"United States","Idaho","ID",2021-06-27,2021-07-03,7,2021,"26",1787065,318,13,271,47,305,0.727449757003802,2.63001065993682,0.173431734317343
"United States","Idaho","ID",2021-07-04,2021-07-10,7,2021,"27",1787065,293,7,269,24,286,0.39170371530974,1.34298416677625,0.0892193308550187
"United States","Idaho","ID",2021-07-11,2021-07-17,7,2021,"28",1787065,300,8,263,37,292,0.447661388925417,2.07043392378005,0.140684410646388
"United States","Idaho","ID",2021-07-18,2021-07-24,7,2021,"29",1787065,310,10,261,49,300,0.559576736156771,2.74192600716818,0.187739463601533
"United States","Idaho","ID",2021-07-25,2021-07-31,7,2021,"30",1787065,312,14,262,50,298,0.783407430619479,2.79788368078386,0.190839694656489
"United States","Idaho","ID",2021-08-01,2021-08-07,7,2021,"31",1787065,250,13,257,-7,237,0.727449757003802,-0.39170371530974,-0.0272373540856031
"United States","Illinois","IL",2019-12-29,2020-01-04,7,2020,"1",12671821,2191,0,2394,-203,2191,0,-1.60197969968168,-0.0847953216374269
"United States","Illinois","IL",2020-01-05,2020-01-11,7,2020,"2",12671821,2252,0,2407,-155,2252,0,-1.2231864702003,-0.0643955130868301
"United States","Illinois","IL",2020-01-12,2020-01-18,7,2020,"3",12671821,2231,0,2365,-134,2231,0,-1.05746443230219,-0.0566596194503172
"United States","Illinois","IL",2020-01-19,2020-01-25,7,2020,"4",12671821,2199,0,2358,-159,2199,0,-1.25475257265708,-0.0674300254452926
"United States","Illinois","IL",2020-01-26,2020-02-01,7,2020,"5",12671821,2137,0,2337,-200,2137,0,-1.57830512283909,-0.0855798031664528
"United States","Illinois","IL",2020-02-02,2020-02-08,7,2020,"6",12671821,2232,0,2310,-78,2232,0,-0.615538997907246,-0.0337662337662338
"United States","Illinois","IL",2020-02-09,2020-02-15,7,2020,"7",12671821,2216,0,2283,-67,2216,0,-0.528732216151096,-0.029347349978099
"United States","Illinois","IL",2020-02-16,2020-02-22,7,2020,"8",12671821,2207,0,2255,-48,2207,0,-0.378793229481382,-0.0212860310421286
"United States","Illinois","IL",2020-02-23,2020-02-29,7,2020,"9",12671821,2209,0,2218,-9,2209,0,-0.0710237305277592,-0.00405770964833185
"United States","Illinois","IL",2020-03-01,2020-03-07,7,2020,"10",12671821,2254,0,2225,29,2254,0,0.228854242811668,0.0130337078651686
"United States","Illinois","IL",2020-03-08,2020-03-14,7,2020,"11",12671821,2191,0,2203,-12,2191,0,-0.0946983073703456,-0.00544711756695415
"United States","Illinois","IL",2020-03-15,2020-03-21,7,2020,"12",12671821,2283,6,2192,91,2277,0.0473491536851728,0.718128830891787,0.0415145985401459
"United States","Illinois","IL",2020-03-22,2020-03-28,7,2020,"13",12671821,2304,41,2171,133,2263,0.323552550182014,1.049572906688,0.061262091202211
"United States","Illinois","IL",2020-03-29,2020-04-04,7,2020,"14",12671821,2622,197,2156,466,2425,1.55463054599651,3.67745093621509,0.216141001855288
"United States","Illinois","IL",2020-04-05,2020-04-11,7,2020,"15",12671821,2870,433,2119,751,2437,3.41703059094664,5.92653573626079,0.354412458706937
"United States","Illinois","IL",2020-04-12,2020-04-18,7,2020,"16",12671821,2912,582,2106,806,2330,4.59286790746176,6.36056964504155,0.382716049382716
"United States","Illinois","IL",2020-04-19,2020-04-25,7,2020,"17",12671821,3010,616,2068,942,2394,4.86117977834441,7.43381712857213,0.455512572533849
"United States","Illinois","IL",2020-04-26,2020-05-02,7,2020,"18",12671821,2952,679,2020,932,2273,5.35834589203872,7.35490187243017,0.461386138613861
"United States","Illinois","IL",2020-05-03,2020-05-09,7,2020,"19",12671821,2962,793,1997,965,2169,6.257979812057,7.61532221769862,0.483224837255884
"United States","Illinois","IL",2020-05-10,2020-05-16,7,2020,"20",12671821,2865,780,1959,906,2085,6.15538997907246,7.14972220646109,0.462480857580398
"United States","Illinois","IL",2020-05-17,2020-05-23,7,2020,"21",12671821,2638,663,1960,678,1975,5.23208148221159,5.35045436642453,0.345918367346939
"United States","Illinois","IL",2020-05-24,2020-05-30,7,2020,"22",12671821,2547,540,1966,581,2007,4.26142383166555,4.58497638184757,0.295523906408952
"United States","Illinois","IL",2020-05-31,2020-06-06,7,2020,"23",12671821,2511,533,1948,563,1978,4.20618315236618,4.44292892079205,0.289014373716632
"United States","Illinois","IL",2020-06-07,2020-06-13,7,2020,"24",12671821,2270,426,1952,318,1844,3.36178991164727,2.50950514531416,0.162909836065574
"United States","Illinois","IL",2020-06-14,2020-06-20,7,2020,"25",12671821,2255,336,1929,326,1919,2.65155260636968,2.57263735022772,0.168999481596682
"United States","Illinois","IL",2020-06-21,2020-06-27,7,2020,"26",12671821,2134,248,1946,188,1886,1.95709835232048,1.48360681546875,0.0966084275436794
"United States","Illinois","IL",2020-06-28,2020-07-04,7,2020,"27",12671821,2182,141,1943,239,2041,1.11270511160156,1.88607462179272,0.12300566134843
"United States","Illinois","IL",2020-07-05,2020-07-11,7,2020,"28",12671821,2189,154,1933,256,2035,1.2152949445861,2.02023055723404,0.132436627004656
"United States","Illinois","IL",2020-07-12,2020-07-18,7,2020,"29",12671821,2087,122,1933,154,1965,0.962766124931847,1.2152949445861,0.0796689084324884
"United States","Illinois","IL",2020-07-19,2020-07-25,7,2020,"30",12671821,2034,107,1928,106,1927,0.844393240718915,0.836501715104719,0.0549792531120332
"United States","Illinois","IL",2020-07-26,2020-08-01,7,2020,"31",12671821,2071,106,1924,147,1965,0.836501715104719,1.16005426528673,0.0764033264033264
"United States","Illinois","IL",2020-08-02,2020-08-08,7,2020,"32",12671821,2138,128,1923,215,2010,1.01011527861702,1.69667800705203,0.111804472178887
"United States","Illinois","IL",2020-08-09,2020-08-15,7,2020,"33",12671821,2126,95,1909,217,2031,0.749694933348569,1.71246105828042,0.113672079622839
"United States","Illinois","IL",2020-08-16,2020-08-22,7,2020,"34",12671821,2151,148,1899,252,2003,1.16794579090093,1.98866445477726,0.132701421800948
"United States","Illinois","IL",2020-08-23,2020-08-29,7,2020,"35",12671821,2120,134,1911,209,1986,1.05746443230219,1.64932885336685,0.109366823652538
"United States","Illinois","IL",2020-08-30,2020-09-05,7,2020,"36",12671821,2198,158,1925,273,2040,1.24686104704288,2.15438649267536,0.141818181818182
"United States","Illinois","IL",2020-09-06,2020-09-12,7,2020,"37",12671821,2080,129,1940,140,1951,1.01800680423121,1.10481358598737,0.0721649484536082
"United States","Illinois","IL",2020-09-13,2020-09-19,7,2020,"38",12671821,2080,141,1953,127,1939,1.11270511160156,1.00222375300282,0.0650281618023554
"United States","Illinois","IL",2020-09-20,2020-09-26,7,2020,"39",12671821,2295,152,1965,330,2143,1.19951189335771,2.6042034526845,0.16793893129771
"United States","Illinois","IL",2020-09-27,2020-10-03,7,2020,"40",12671821,2138,186,1965,173,1952,1.46782376424036,1.36523393125582,0.0880407124681934
"United States","Illinois","IL",2020-10-04,2020-10-10,7,2020,"41",12671821,2333,201,1947,386,2132,1.58619664845329,3.04612888707945,0.198253723677452
"United States","Illinois","IL",2020-10-11,2020-10-17,7,2020,"42",12671821,2281,217,1948,333,2064,1.71246105828042,2.62787802952709,0.170944558521561
"United States","Illinois","IL",2020-10-18,2020-10-24,7,2020,"43",12671821,2290,289,1955,335,2001,2.28065090250249,2.64366108075548,0.171355498721228
"United States","Illinois","IL",2020-10-25,2020-10-31,7,2020,"44",12671821,2455,228,1955,500,2227,1.79926784003657,3.94576280709773,0.255754475703325
"United States","Illinois","IL",2020-11-01,2020-11-07,7,2020,"45",12671821,2699,444,1979,720,2255,3.50383737270279,5.68189844222074,0.363820111167256
"United States","Illinois","IL",2020-11-08,2020-11-14,7,2020,"46",12671821,2905,515,1989,916,2390,4.06413569131066,7.22863746260305,0.460532931121166
"United States","Illinois","IL",2020-11-15,2020-11-21,7,2020,"47",12671821,3186,762,1991,1195,2424,6.01334251801694,9.43037310896358,0.600200904068307
"United States","Illinois","IL",2020-11-22,2020-11-28,7,2020,"48",12671821,3151,707,2014,1137,2444,5.57930860923619,8.97266462334025,0.56454816285998
"United States","Illinois","IL",2020-11-29,2020-12-05,7,2020,"49",12671821,3282,1041,2026,1256,2241,8.21507816437748,9.91175617142951,0.619940769990128
"United States","Illinois","IL",2020-12-06,2020-12-12,7,2020,"50",12671821,3345,998,2032,1313,2347,7.87574256296707,10.3615731314386,0.646161417322835
"United States","Illinois","IL",2020-12-13,2020-12-19,7,2020,"51",12671821,3130,944,2060,1070,2186,7.44960017980052,8.44393240718915,0.519417475728155
"United States","Illinois","IL",2020-12-20,2020-12-26,7,2020,"52",12671821,3040,745,2093,947,2295,5.87918658257562,7.47327475664311,0.452460582895366
"United States","Illinois","IL",2020-12-27,2021-01-02,7,2020,"53",12671821,3031,802,2107,924,2229,6.32900354258476,7.29176966751661,0.438538205980066
"United States","Illinois","IL",2021-01-03,2021-01-09,7,2021,"1",12671821,2794,827,2150,644,1967,6.52629168293965,5.08214249554188,0.29953488372093
"United States","Illinois","IL",2021-01-10,2021-01-16,7,2021,"2",12671821,2733,684,2188,545,2049,5.3978035201097,4.30088145973653,0.24908592321755
"United States","Illinois","IL",2021-01-17,2021-01-23,7,2021,"3",12671821,2608,531,2185,423,2077,4.19040010113779,3.33811533480468,0.193592677345538
"United States","Illinois","IL",2021-01-24,2021-01-30,7,2021,"4",12671821,2585,494,2190,395,2091,3.89841365341256,3.11715261760721,0.180365296803653
"United States","Illinois","IL",2021-01-31,2021-02-06,7,2021,"5",12671821,2562,382,2188,374,2180,3.01456278462267,2.9514305797091,0.170932358318099
"United States","Illinois","IL",2021-02-07,2021-02-13,7,2021,"6",12671821,2476,344,2167,309,2132,2.71468481128324,2.4384814147864,0.142593447161975
"United States","Illinois","IL",2021-02-14,2021-02-20,7,2021,"7",12671821,2438,308,2131,307,2130,2.4305898891722,2.42269836355801,0.144063819802909
"United States","Illinois","IL",2021-02-21,2021-02-27,7,2021,"8",12671821,2340,260,2123,217,2080,2.05179665969082,1.71246105828042,0.102213848327838
"United States","Illinois","IL",2021-02-28,2021-03-06,7,2021,"9",12671821,2184,258,2094,90,1926,2.03601360846243,0.710237305277592,0.0429799426934097
"United States","Illinois","IL",2021-03-07,2021-03-13,7,2021,"10",12671821,2114,174,2101,13,1940,1.37312545687001,0.102589832984541,0.00618752974773917
"United States","Illinois","IL",2021-03-14,2021-03-20,7,2021,"11",12671821,2125,133,2078,47,1992,1.049572906688,0.370901703867187,0.0226179018286814
"United States","Illinois","IL",2021-03-21,2021-03-27,7,2021,"12",12671821,2134,171,2062,72,1963,1.34945088002742,0.568189844222074,0.0349175557710961
"United States","Illinois","IL",2021-03-28,2021-04-03,7,2021,"13",12671821,2186,2402,2065,121,-216,18.9554445252975,0.954874599317651,0.058595641646489
"United States","Illinois","IL",2021-04-04,2021-04-10,7,2021,"14",12671821,2238,142,2042,196,2096,1.12059663721576,1.54673902038231,0.0959843290891282
"United States","Illinois","IL",2021-04-11,2021-04-17,7,2021,"15",12671821,2114,168,2019,95,1946,1.32577630318484,0.749694933348569,0.0470529965329372
"United States","Illinois","IL",2021-04-18,2021-04-24,7,2021,"16",12671821,2228,169,2006,222,2059,1.33366782879903,1.75191868635139,0.110667996011964
"United States","Illinois","IL",2021-04-25,2021-05-01,7,2021,"17",12671821,2232,216,1978,254,2016,1.70456953266622,2.00444750600565,0.128412537917088
"United States","Illinois","IL",2021-05-02,2021-05-08,7,2021,"18",12671821,2164,216,1968,196,1948,1.70456953266622,1.54673902038231,0.0995934959349594
"United States","Illinois","IL",2021-05-09,2021-05-15,7,2021,"19",12671821,2137,179,1950,187,1958,1.41258308494099,1.47571528985455,0.0958974358974358
"United States","Illinois","IL",2021-05-16,2021-05-22,7,2021,"20",12671821,2226,210,1939,287,2016,1.65722037898105,2.2648678512741,0.148014440433213
"United States","Illinois","IL",2021-05-23,2021-05-29,7,2021,"21",12671821,2043,231,1905,138,1812,1.82294241687915,1.08903053475897,0.0724409448818897
"United States","Illinois","IL",2021-05-30,2021-06-05,7,2021,"22",12671821,2206,116,1896,310,2090,0.915416971246674,2.44637294040059,0.163502109704641
"United States","Illinois","IL",2021-06-06,2021-06-12,7,2021,"23",12671821,2135,187,1897,238,1948,1.47571528985455,1.87818309617852,0.125461254612546
"United States","Illinois","IL",2021-06-13,2021-06-19,7,2021,"24",12671821,2046,97,1890,156,1949,0.76547798457696,1.23107799581449,0.0825396825396825
"United States","Illinois","IL",2021-06-20,2021-06-26,7,2021,"25",12671821,2004,71,1874,130,1933,0.560298318607878,1.02589832984541,0.0693703308431164
"United States","Illinois","IL",2021-06-27,2021-07-03,7,2021,"26",12671821,2066,59,1883,183,2007,0.465600011237532,1.44414918739777,0.0971853425385023
"United States","Illinois","IL",2021-07-04,2021-07-10,7,2021,"27",12671821,2110,59,1877,233,2051,0.465600011237532,1.83872546810754,0.124134256792754
"United States","Illinois","IL",2021-07-11,2021-07-17,7,2021,"28",12671821,2116,65,1883,233,2051,0.512949164922705,1.83872546810754,0.123738714816782
"United States","Illinois","IL",2021-07-18,2021-07-24,7,2021,"29",12671821,2068,47,1871,197,2021,0.370901703867187,1.55463054599651,0.10529128808124
"United States","Illinois","IL",2021-07-25,2021-07-31,7,2021,"30",12671821,1987,49,1872,115,1938,0.386684755095578,0.907525445632479,0.0614316239316239
"United States","Illinois","IL",2021-08-01,2021-08-07,7,2021,"31",12671821,1866,76,1858,8,1790,0.599755946678855,0.0631322049135637,0.00430570505920347
"United States","Indiana","IN",2019-12-29,2020-01-04,7,2020,"1",6732219,1470,0,1500,-30,1470,0,-0.445618302078408,-0.02
"United States","Indiana","IN",2020-01-05,2020-01-11,7,2020,"2",6732219,1386,0,1508,-122,1386,0,-1.81218109511886,-0.0809018567639257
"United States","Indiana","IN",2020-01-12,2020-01-18,7,2020,"3",6732219,1389,0,1505,-116,1389,0,-1.72305743470318,-0.0770764119601329
"United States","Indiana","IN",2020-01-19,2020-01-25,7,2020,"4",6732219,1422,0,1484,-62,1422,0,-0.920944490962044,-0.0417789757412399
"United States","Indiana","IN",2020-01-26,2020-02-01,7,2020,"5",6732219,1380,0,1445,-65,1380,0,-0.965506321169885,-0.0449826989619377
"United States","Indiana","IN",2020-02-02,2020-02-08,7,2020,"6",6732219,1363,0,1445,-82,1363,0,-1.21802335901432,-0.0567474048442906
"United States","Indiana","IN",2020-02-09,2020-02-15,7,2020,"7",6732219,1429,0,1419,10,1429,0,0.148539434026136,0.00704721634954186
"United States","Indiana","IN",2020-02-16,2020-02-22,7,2020,"8",6732219,1412,0,1417,-5,1412,0,-0.0742697170130681,-0.00352858151023283
"United States","Indiana","IN",2020-02-23,2020-02-29,7,2020,"9",6732219,1449,0,1397,52,1449,0,0.772405056935908,0.0372226198997851
"United States","Indiana","IN",2020-03-01,2020-03-07,7,2020,"10",6732219,1372,0,1391,-19,1372,0,-0.282224924649659,-0.0136592379583034
"United States","Indiana","IN",2020-03-08,2020-03-14,7,2020,"11",6732219,1407,0,1387,20,1407,0,0.297078868052272,0.0144196106705119
"United States","Indiana","IN",2020-03-15,2020-03-21,7,2020,"12",6732219,1329,9,1381,-52,1320,0.133685490623523,-0.772405056935908,-0.0376538740043447
"United States","Indiana","IN",2020-03-22,2020-03-28,7,2020,"13",6732219,1486,38,1367,119,1448,0.564449849299317,1.76761926491102,0.0870519385515729
"United States","Indiana","IN",2020-03-29,2020-04-04,7,2020,"14",6732219,1581,138,1350,231,1443,2.04984418956068,3.43126092600374,0.171111111111111
"United States","Indiana","IN",2020-04-05,2020-04-11,7,2020,"15",6732219,1633,207,1332,301,1426,3.07476628434102,4.4710369641867,0.225975975975976
"United States","Indiana","IN",2020-04-12,2020-04-18,7,2020,"16",6732219,1510,224,1311,199,1286,3.32728332218545,2.95593473712011,0.151792524790237
"United States","Indiana","IN",2020-04-19,2020-04-25,7,2020,"17",6732219,1597,227,1296,301,1370,3.37184515239329,4.4710369641867,0.232253086419753
"United States","Indiana","IN",2020-04-26,2020-05-02,7,2020,"18",6732219,1537,272,1273,264,1265,4.0402726055109,3.92144105828999,0.20738413197172
"United States","Indiana","IN",2020-05-03,2020-05-09,7,2020,"19",6732219,1583,247,1236,347,1336,3.66892402044556,5.15431836070692,0.280744336569579
"United States","Indiana","IN",2020-05-10,2020-05-16,7,2020,"20",6732219,1572,234,1225,347,1338,3.47582275621158,5.15431836070692,0.283265306122449
"United States","Indiana","IN",2020-05-17,2020-05-23,7,2020,"21",6732219,1474,216,1212,262,1258,3.20845177496454,3.89173317148477,0.216171617161716
"United States","Indiana","IN",2020-05-24,2020-05-30,7,2020,"22",6732219,1383,131,1217,166,1252,1.94586658574238,2.46575460483386,0.136400986031224
"United States","Indiana","IN",2020-05-31,2020-06-06,7,2020,"23",6732219,1396,167,1202,194,1229,2.48060854823647,2.88166502010704,0.161397670549085
"United States","Indiana","IN",2020-06-07,2020-06-13,7,2020,"24",6732219,1392,121,1196,196,1271,1.79732715171625,2.91137290691227,0.163879598662207
"United States","Indiana","IN",2020-06-14,2020-06-20,7,2020,"25",6732219,1353,115,1201,152,1238,1.70820349130057,2.25779939719727,0.126561199000833
"United States","Indiana","IN",2020-06-21,2020-06-27,7,2020,"26",6732219,1380,78,1203,177,1302,1.15860758540386,2.62914798226261,0.14713216957606
"United States","Indiana","IN",2020-06-28,2020-07-04,7,2020,"27",6732219,1345,70,1194,151,1275,1.03977603818295,2.24294545379466,0.126465661641541
"United States","Indiana","IN",2020-07-05,2020-07-11,7,2020,"28",6732219,1352,69,1200,152,1283,1.02492209478034,2.25779939719727,0.126666666666667
"United States","Indiana","IN",2020-07-12,2020-07-18,7,2020,"29",6732219,1383,64,1188,195,1319,0.950652377767271,2.89651896350965,0.164141414141414
"United States","Indiana","IN",2020-07-19,2020-07-25,7,2020,"30",6732219,1318,71,1182,136,1247,1.05462998158557,2.02013630275545,0.115059221658206
"United States","Indiana","IN",2020-07-26,2020-08-01,7,2020,"31",6732219,1367,73,1183,184,1294,1.08433786839079,2.7331255860809,0.155536770921386
"United States","Indiana","IN",2020-08-02,2020-08-08,7,2020,"32",6732219,1344,63,1191,153,1281,0.935798434364657,2.27265334059988,0.128463476070529
"United States","Indiana","IN",2020-08-09,2020-08-15,7,2020,"33",6732219,1372,87,1189,183,1285,1.29229307602738,2.71827164267829,0.153910849453322
"United States","Indiana","IN",2020-08-16,2020-08-22,7,2020,"34",6732219,1359,80,1186,173,1279,1.18831547220909,2.56973220865215,0.145868465430017
"United States","Indiana","IN",2020-08-23,2020-08-29,7,2020,"35",6732219,1356,284,1181,175,1072,4.21851992634227,2.59944009545738,0.14817950889077
"United States","Indiana","IN",2020-08-30,2020-09-05,7,2020,"36",6732219,1271,77,1182,89,1194,1.14375364200125,1.32200096283261,0.0752961082910322
"United States","Indiana","IN",2020-09-06,2020-09-12,7,2020,"37",6732219,1343,75,1172,171,1268,1.11404575519602,2.54002432184693,0.145904436860068
"United States","Indiana","IN",2020-09-13,2020-09-19,7,2020,"38",6732219,1409,66,1169,240,1343,0.980360264572498,3.56494641662727,0.205303678357571
"United States","Indiana","IN",2020-09-20,2020-09-26,7,2020,"39",6732219,1441,74,1174,267,1367,1.09919181179341,3.96600288849783,0.227427597955707
"United States","Indiana","IN",2020-09-27,2020-10-03,7,2020,"40",6732219,1411,92,1184,227,1319,1.36656279304045,3.37184515239329,0.191722972972973
"United States","Indiana","IN",2020-10-04,2020-10-10,7,2020,"41",6732219,1442,113,1189,253,1329,1.67849560449534,3.75804768086124,0.212783851976451
"United States","Indiana","IN",2020-10-11,2020-10-17,7,2020,"42",6732219,1524,136,1201,323,1388,2.02013630275545,4.7978237190442,0.268942547876769
"United States","Indiana","IN",2020-10-18,2020-10-24,7,2020,"43",6732219,1514,200,1197,317,1314,2.97078868052272,4.70870005862851,0.264828738512949
"United States","Indiana","IN",2020-10-25,2020-10-31,7,2020,"44",6732219,1600,213,1208,392,1387,3.1638899447567,5.82274581382454,0.324503311258278
"United States","Indiana","IN",2020-11-01,2020-11-07,7,2020,"45",6732219,1655,260,1218,437,1395,3.86202528467954,6.49117326694215,0.358784893267652
"United States","Indiana","IN",2020-11-08,2020-11-14,7,2020,"46",6732219,1721,296,1227,494,1425,4.39676724717363,7.33784804089112,0.402607986960065
"United States","Indiana","IN",2020-11-15,2020-11-21,7,2020,"47",6732219,1936,359,1229,707,1577,5.33256568153829,10.5017379856478,0.57526444263629
"United States","Indiana","IN",2020-11-22,2020-11-28,7,2020,"48",6732219,2015,417,1252,763,1598,6.19409439888988,11.3335588161942,0.609424920127795
"United States","Indiana","IN",2020-11-29,2020-12-05,7,2020,"49",6732219,1943,544,1262,681,1399,8.08054521102181,10.1155354571799,0.539619651347068
"United States","Indiana","IN",2020-12-06,2020-12-12,7,2020,"50",6732219,2119,550,1287,832,1569,8.16966887143749,12.3584809109745,0.646464646464646
"United States","Indiana","IN",2020-12-13,2020-12-19,7,2020,"51",6732219,2060,581,1303,757,1479,8.63014111691851,11.2444351557785,0.58096699923254
"United States","Indiana","IN",2020-12-20,2020-12-26,7,2020,"52",6732219,2010,463,1326,684,1547,6.8773757954101,10.1600972873877,0.515837104072398
"United States","Indiana","IN",2020-12-27,2021-01-02,7,2020,"53",6732219,2048,609,1347,701,1439,9.04605153219169,10.4126143252321,0.520415738678545
"United States","Indiana","IN",2021-01-03,2021-01-09,7,2021,"1",6732219,1977,556,1372,605,1421,8.25879253185317,8.98663575858123,0.440962099125364
"United States","Indiana","IN",2021-01-10,2021-01-16,7,2021,"2",6732219,1913,321,1384,529,1592,4.76811583223897,7.8577360599826,0.382225433526012
"United States","Indiana","IN",2021-01-17,2021-01-23,7,2021,"3",6732219,1790,405,1388,402,1385,6.01584707805851,5.97128524785067,0.289625360230548
"United States","Indiana","IN",2021-01-24,2021-01-30,7,2021,"4",6732219,1623,275,1384,239,1348,4.08483443571874,3.55009247322465,0.172687861271676
"United States","Indiana","IN",2021-01-31,2021-02-06,7,2021,"5",6732219,1604,1785,1376,228,-181,26.5142889736653,3.3866990957959,0.165697674418605
"United States","Indiana","IN",2021-02-07,2021-02-13,7,2021,"6",6732219,1503,397,1370,133,1106,5.8970155308376,1.97557447254761,0.0970802919708029
"United States","Indiana","IN",2021-02-14,2021-02-20,7,2021,"7",6732219,1462,189,1351,111,1273,2.80739530309397,1.64878771769011,0.0821613619541082
"United States","Indiana","IN",2021-02-21,2021-02-27,7,2021,"8",6732219,1445,222,1339,106,1223,3.29757543538022,1.57451800067704,0.0791635548917102
"United States","Indiana","IN",2021-02-28,2021-03-06,7,2021,"9",6732219,1422,168,1333,89,1254,2.49546249163909,1.32200096283261,0.0667666916729182
"United States","Indiana","IN",2021-03-07,2021-03-13,7,2021,"10",6732219,1383,119,1328,55,1264,1.76761926491102,0.816966887143749,0.0414156626506024
"United States","Indiana","IN",2021-03-14,2021-03-20,7,2021,"11",6732219,1312,82,1333,-21,1230,1.21802335901432,-0.311932811454886,-0.0157539384846211
"United States","Indiana","IN",2021-03-21,2021-03-27,7,2021,"12",6732219,1305,85,1329,-24,1220,1.26258518922216,-0.356494641662727,-0.0180586907449209
"United States","Indiana","IN",2021-03-28,2021-04-03,7,2021,"13",6732219,1284,64,1326,-42,1220,0.950652377767271,-0.623865622909772,-0.0316742081447964
"United States","Indiana","IN",2021-04-04,2021-04-10,7,2021,"14",6732219,1379,60,1316,63,1319,0.891236604156817,0.935798434364657,0.0478723404255319
"United States","Indiana","IN",2021-04-11,2021-04-17,7,2021,"15",6732219,1397,78,1301,96,1319,1.15860758540386,1.42597856665091,0.0737893927747886
"United States","Indiana","IN",2021-04-18,2021-04-24,7,2021,"16",6732219,1288,55,1275,13,1233,0.816966887143749,0.193101264233977,0.0101960784313726
"United States","Indiana","IN",2021-04-25,2021-05-01,7,2021,"17",6732219,1365,67,1273,92,1298,0.995214207975112,1.36656279304045,0.0722702278083267
"United States","Indiana","IN",2021-05-02,2021-05-08,7,2021,"18",6732219,1325,67,1271,54,1258,0.995214207975112,0.802112943741135,0.042486231313926
"United States","Indiana","IN",2021-05-09,2021-05-15,7,2021,"19",6732219,1298,66,1257,41,1232,0.980360264572498,0.609011679507158,0.0326173428798726
"United States","Indiana","IN",2021-05-16,2021-05-22,7,2021,"20",6732219,1357,82,1246,111,1275,1.21802335901432,1.64878771769011,0.0890850722311396
"United States","Indiana","IN",2021-05-23,2021-05-29,7,2021,"21",6732219,1327,62,1223,104,1265,0.920944490962044,1.54481011387182,0.0850367947669666
"United States","Indiana","IN",2021-05-30,2021-06-05,7,2021,"22",6732219,1396,70,1219,177,1326,1.03977603818295,2.62914798226261,0.145200984413454
"United States","Indiana","IN",2021-06-06,2021-06-12,7,2021,"23",6732219,1290,60,1211,79,1230,0.891236604156817,1.17346152880648,0.0652353426919901
"United States","Indiana","IN",2021-06-13,2021-06-19,7,2021,"24",6732219,1401,50,1217,184,1351,0.742697170130681,2.7331255860809,0.151191454396056
"United States","Indiana","IN",2021-06-20,2021-06-26,7,2021,"25",6732219,1259,27,1228,31,1232,0.401056471870568,0.460472245481022,0.025244299674267
"United States","Indiana","IN",2021-06-27,2021-07-03,7,2021,"26",6732219,1264,41,1222,42,1223,0.609011679507158,0.623865622909772,0.0343698854337153
"United States","Indiana","IN",2021-07-04,2021-07-10,7,2021,"27",6732219,1290,51,1211,79,1239,0.757551113533294,1.17346152880648,0.0652353426919901
"United States","Indiana","IN",2021-07-11,2021-07-17,7,2021,"28",6732219,1266,26,1217,49,1240,0.386202528467954,0.727843226728067,0.0402629416598193
"United States","Indiana","IN",2021-07-18,2021-07-24,7,2021,"29",6732219,1188,25,1214,-26,1163,0.37134858506534,-0.386202528467954,-0.0214168039538715
"United States","Indiana","IN",2021-07-25,2021-07-31,7,2021,"30",6732219,1165,40,1220,-55,1125,0.594157736104544,-0.816966887143749,-0.0450819672131147
"United States","Indiana","IN",2021-08-01,2021-08-07,7,2021,"31",6732219,951,49,1208,-257,902,0.727843226728067,-3.8174634544717,-0.212748344370861
"United States","Iowa","IA",2019-12-29,2020-01-04,7,2020,"1",3155070,665,0,694,-29,665,0,-0.919155517944134,-0.0417867435158501
"United States","Iowa","IA",2020-01-05,2020-01-11,7,2020,"2",3155070,647,0,700,-53,647,0,-1.67983594658756,-0.0757142857142857
"United States","Iowa","IA",2020-01-12,2020-01-18,7,2020,"3",3155070,620,0,690,-70,620,0,-2.21865125020998,-0.101449275362319
"United States","Iowa","IA",2020-01-19,2020-01-25,7,2020,"4",3155070,640,0,677,-37,640,0,-1.17271566082527,-0.0546528803545052
"United States","Iowa","IA",2020-01-26,2020-02-01,7,2020,"5",3155070,615,0,671,-56,615,0,-1.77492100016798,-0.0834575260804769
"United States","Iowa","IA",2020-02-02,2020-02-08,7,2020,"6",3155070,637,0,666,-29,637,0,-0.919155517944134,-0.0435435435435435
"United States","Iowa","IA",2020-02-09,2020-02-15,7,2020,"7",3155070,600,0,656,-56,600,0,-1.77492100016798,-0.0853658536585366
"United States","Iowa","IA",2020-02-16,2020-02-22,7,2020,"8",3155070,643,0,648,-5,643,0,-0.158475089300713,-0.00771604938271608
"United States","Iowa","IA",2020-02-23,2020-02-29,7,2020,"9",3155070,642,0,637,5,642,0,0.158475089300713,0.00784929356357922
"United States","Iowa","IA",2020-03-01,2020-03-07,7,2020,"10",3155070,624,0,633,-9,624,0,-0.285255160741283,-0.014218009478673
"United States","Iowa","IA",2020-03-08,2020-03-14,7,2020,"11",3155070,636,0,621,15,636,0,0.475425267902138,0.0241545893719808
"United States","Iowa","IA",2020-03-15,2020-03-21,7,2020,"12",3155070,598,0,616,-18,598,0,-0.570510321482566,-0.0292207792207793
"United States","Iowa","IA",2020-03-22,2020-03-28,7,2020,"13",3155070,595,3,608,-13,592,0.0950850535804277,-0.412035232181853,-0.0213815789473685
"United States","Iowa","IA",2020-03-29,2020-04-04,7,2020,"14",3155070,608,8,603,5,600,0.25356014288114,0.158475089300713,0.00829187396351583
"United States","Iowa","IA",2020-04-05,2020-04-11,7,2020,"15",3155070,597,23,597,0,574,0.728985410783279,0,0
"United States","Iowa","IA",2020-04-12,2020-04-18,7,2020,"16",3155070,633,40,596,37,593,1.2678007144057,1.17271566082527,0.0620805369127517
"United States","Iowa","IA",2020-04-19,2020-04-25,7,2020,"17",3155070,587,38,596,-9,549,1.20441067868542,-0.285255160741283,-0.0151006711409396
"United States","Iowa","IA",2020-04-26,2020-05-02,7,2020,"18",3155070,673,63,587,86,610,1.99678612518898,2.72577153597226,0.146507666098807
"United States","Iowa","IA",2020-05-03,2020-05-09,7,2020,"19",3155070,702,76,580,122,626,2.40882135737083,3.86679217893739,0.210344827586207
"United States","Iowa","IA",2020-05-10,2020-05-16,7,2020,"20",3155070,674,95,558,116,579,3.01102669671354,3.67662207177654,0.207885304659498
"United States","Iowa","IA",2020-05-17,2020-05-23,7,2020,"21",3155070,619,98,548,71,521,3.10611175029397,2.25034626807012,0.12956204379562
"United States","Iowa","IA",2020-05-24,2020-05-30,7,2020,"22",3155070,632,83,546,86,549,2.63068648239183,2.72577153597226,0.157509157509158
"United States","Iowa","IA",2020-05-31,2020-06-06,7,2020,"23",3155070,600,71,544,56,529,2.25034626807012,1.77492100016798,0.102941176470588
"United States","Iowa","IA",2020-06-07,2020-06-13,7,2020,"24",3155070,589,51,546,43,538,1.61644591086727,1.36288576798613,0.0787545787545787
"United States","Iowa","IA",2020-06-14,2020-06-20,7,2020,"25",3155070,575,32,551,24,543,1.01424057152456,0.760680428643422,0.043557168784029
"United States","Iowa","IA",2020-06-21,2020-06-27,7,2020,"26",3155070,552,23,542,10,529,0.728985410783279,0.316950178601426,0.018450184501845
"United States","Iowa","IA",2020-06-28,2020-07-04,7,2020,"27",3155070,596,17,527,69,579,0.538815303622424,2.18695623234984,0.130929791271347
"United States","Iowa","IA",2020-07-05,2020-07-11,7,2020,"28",3155070,567,27,520,47,540,0.855765482223849,1.4896658394267,0.0903846153846153
"United States","Iowa","IA",2020-07-12,2020-07-18,7,2020,"29",3155070,601,39,521,80,562,1.23610569654556,2.5356014288114,0.153550863723608
"United States","Iowa","IA",2020-07-19,2020-07-25,7,2020,"30",3155070,651,39,521,130,612,1.23610569654556,4.12035232181853,0.249520153550864
"United States","Iowa","IA",2020-07-26,2020-08-01,7,2020,"31",3155070,650,46,523,127,604,1.45797082156656,4.02526726823811,0.24282982791587
"United States","Iowa","IA",2020-08-02,2020-08-08,7,2020,"32",3155070,649,53,520,129,596,1.67983594658756,4.08865730395839,0.248076923076923
"United States","Iowa","IA",2020-08-09,2020-08-15,7,2020,"33",3155070,669,48,527,142,621,1.52136085728684,4.50069253614024,0.269449715370019
"United States","Iowa","IA",2020-08-16,2020-08-22,7,2020,"34",3155070,625,57,526,99,568,1.80661601802813,3.13780676815411,0.188212927756654
"United States","Iowa","IA",2020-08-23,2020-08-29,7,2020,"35",3155070,691,78,531,160,613,2.47221139309112,5.07120285762281,0.301318267419962
"United States","Iowa","IA",2020-08-30,2020-09-05,7,2020,"36",3155070,597,52,535,62,545,1.64814092872741,1.96509110732884,0.11588785046729
"United States","Iowa","IA",2020-09-06,2020-09-12,7,2020,"37",3155070,637,48,539,98,589,1.52136085728684,3.10611175029397,0.181818181818182
"United States","Iowa","IA",2020-09-13,2020-09-19,7,2020,"38",3155070,642,56,534,108,586,1.77492100016798,3.4230619288954,0.202247191011236
"United States","Iowa","IA",2020-09-20,2020-09-26,7,2020,"39",3155070,641,47,538,103,594,1.4896658394267,3.26458683959468,0.191449814126394
"United States","Iowa","IA",2020-09-27,2020-10-03,7,2020,"40",3155070,680,66,547,133,614,2.09187117876941,4.21543737539896,0.243144424131627
"United States","Iowa","IA",2020-10-04,2020-10-10,7,2020,"41",3155070,733,77,568,165,656,2.44051637523098,5.22967794692352,0.290492957746479
"United States","Iowa","IA",2020-10-11,2020-10-17,7,2020,"42",3155070,688,72,566,122,616,2.28204128593026,3.86679217893739,0.215547703180212
"United States","Iowa","IA",2020-10-18,2020-10-24,7,2020,"43",3155070,750,103,558,192,647,3.26458683959468,6.08544342914737,0.344086021505376
"United States","Iowa","IA",2020-10-25,2020-10-31,7,2020,"44",3155070,759,86,564,195,673,2.72577153597226,6.1805284827278,0.345744680851064
"United States","Iowa","IA",2020-11-01,2020-11-07,7,2020,"45",3155070,860,100,565,295,760,3.16950178601426,9.35003026874206,0.52212389380531
"United States","Iowa","IA",2020-11-08,2020-11-14,7,2020,"46",3155070,905,154,577,328,751,4.88103275046196,10.3959658581268,0.568457538994801
"United States","Iowa","IA",2020-11-15,2020-11-21,7,2020,"47",3155070,998,186,586,412,812,5.89527332198652,13.0583473583787,0.703071672354949
"United States","Iowa","IA",2020-11-22,2020-11-28,7,2020,"48",3155070,976,192,579,397,784,6.08544342914737,12.5829220904766,0.68566493955095
"United States","Iowa","IA",2020-11-29,2020-12-05,7,2020,"49",3155070,1002,279,580,422,723,8.84290998297977,13.3752975369802,0.727586206896552
"United States","Iowa","IA",2020-12-06,2020-12-12,7,2020,"50",3155070,950,582,586,364,368,18.446500394603,11.5369865010919,0.621160409556314
"United States","Iowa","IA",2020-12-13,2020-12-19,7,2020,"51",3155070,864,242,593,271,622,7.6701943221545,8.58934984009863,0.456998313659359
"United States","Iowa","IA",2020-12-20,2020-12-26,7,2020,"52",3155070,834,293,599,235,541,9.28664023302177,7.4483291971335,0.392320534223706
"United States","Iowa","IA",2020-12-27,2021-01-02,7,2020,"53",3155070,743,201,613,130,542,6.37069858988866,4.12035232181853,0.212071778140294
"United States","Iowa","IA",2021-01-03,2021-01-09,7,2021,"1",3155070,799,183,619,180,616,5.80018826840609,5.70510321482566,0.290791599353796
"United States","Iowa","IA",2021-01-10,2021-01-16,7,2021,"2",3155070,754,194,627,127,560,6.14883346486766,4.02526726823811,0.202551834130781
"United States","Iowa","IA",2021-01-17,2021-01-23,7,2021,"3",3155070,746,165,625,121,581,5.22967794692352,3.83509716107725,0.1936
"United States","Iowa","IA",2021-01-24,2021-01-30,7,2021,"4",3155070,645,165,627,18,480,5.22967794692352,0.570510321482566,0.0287081339712918
"United States","Iowa","IA",2021-01-31,2021-02-06,7,2021,"5",3155070,648,457,629,19,191,14.4846231620852,0.602205339342709,0.0302066772655007
"United States","Iowa","IA",2021-02-07,2021-02-13,7,2021,"6",3155070,608,128,626,-18,480,4.05696228609825,-0.570510321482566,-0.0287539936102237
"United States","Iowa","IA",2021-02-14,2021-02-20,7,2021,"7",3155070,658,100,623,35,558,3.16950178601426,1.10932562510499,0.0561797752808988
"United States","Iowa","IA",2021-02-21,2021-02-27,7,2021,"8",3155070,590,135,628,-38,455,4.27882741111925,-1.20441067868542,-0.0605095541401274
"United States","Iowa","IA",2021-02-28,2021-03-06,7,2021,"9",3155070,622,79,629,-7,543,2.50390641095126,-0.221865125020998,-0.0111287758346582
"United States","Iowa","IA",2021-03-07,2021-03-13,7,2021,"10",3155070,563,84,616,-53,479,2.66238150025198,-1.67983594658756,-0.086038961038961
"United States","Iowa","IA",2021-03-14,2021-03-20,7,2021,"11",3155070,506,40,606,-100,466,1.2678007144057,-3.16950178601426,-0.165016501650165
"United States","Iowa","IA",2021-03-21,2021-03-27,7,2021,"12",3155070,568,43,608,-40,525,1.36288576798613,-1.2678007144057,-0.0657894736842105
"United States","Iowa","IA",2021-03-28,2021-04-03,7,2021,"13",3155070,577,38,606,-29,539,1.20441067868542,-0.919155517944134,-0.0478547854785478
"United States","Iowa","IA",2021-04-04,2021-04-10,7,2021,"14",3155070,632,94,595,37,538,2.9793316788534,1.17271566082527,0.0621848739495798
"United States","Iowa","IA",2021-04-11,2021-04-17,7,2021,"15",3155070,575,32,596,-21,543,1.01424057152456,-0.665595375062994,-0.035234899328859
"United States","Iowa","IA",2021-04-18,2021-04-24,7,2021,"16",3155070,618,26,598,20,592,0.824070464363707,0.633900357202851,0.0334448160535117
"United States","Iowa","IA",2021-04-25,2021-05-01,7,2021,"17",3155070,636,43,589,47,593,1.36288576798613,1.4896658394267,0.0797962648556876
"United States","Iowa","IA",2021-05-02,2021-05-08,7,2021,"18",3155070,571,33,586,-15,538,1.0459355893847,-0.475425267902138,-0.0255972696245734
"United States","Iowa","IA",2021-05-09,2021-05-15,7,2021,"19",3155070,559,15,586,-27,544,0.475425267902138,-0.855765482223849,-0.0460750853242321
"United States","Iowa","IA",2021-05-16,2021-05-22,7,2021,"20",3155070,534,36,576,-42,498,1.14102064296513,-1.33119075012599,-0.0729166666666666
"United States","Iowa","IA",2021-05-23,2021-05-29,7,2021,"21",3155070,586,19,573,13,567,0.602205339342709,0.412035232181853,0.0226876090750436
"United States","Iowa","IA",2021-05-30,2021-06-05,7,2021,"22",3155070,553,14,576,-23,539,0.443730250041996,-0.728985410783279,-0.0399305555555556
"United States","Iowa","IA",2021-06-06,2021-06-12,7,2021,"23",3155070,571,30,573,-2,541,0.950850535804277,-0.0633900357202851,-0.00349040139616053
"United States","Iowa","IA",2021-06-13,2021-06-19,7,2021,"24",3155070,589,12,573,16,577,0.380340214321711,0.507120285762281,0.0279232111692844
"United States","Iowa","IA",2021-06-20,2021-06-26,7,2021,"25",3155070,571,16,583,-12,555,0.507120285762281,-0.380340214321711,-0.0205831903945112
"United States","Iowa","IA",2021-06-27,2021-07-03,7,2021,"26",3155070,529,17,567,-38,512,0.538815303622424,-1.20441067868542,-0.0670194003527337
"United States","Iowa","IA",2021-07-04,2021-07-10,7,2021,"27",3155070,561,7,557,4,554,0.221865125020998,0.12678007144057,0.00718132854578091
"United States","Iowa","IA",2021-07-11,2021-07-17,7,2021,"28",3155070,545,9,558,-13,536,0.285255160741283,-0.412035232181853,-0.0232974910394266
"United States","Iowa","IA",2021-07-18,2021-07-24,7,2021,"29",3155070,558,0,547,11,558,0,0.348645196461568,0.0201096892138939
"United States","Iowa","IA",2021-07-25,2021-07-31,7,2021,"30",3155070,460,12,551,-91,448,0.380340214321711,-2.88424662527297,-0.165154264972777
"United States","Iowa","IA",2021-08-01,2021-08-07,7,2021,"31",3155070,435,23,553,-118,412,0.728985410783279,-3.74001210749682,-0.213381555153707
"United States","Kansas","KS",2019-12-29,2020-01-04,7,2020,"1",2913314,591,0,610,-19,591,0,-0.652178240999769,-0.0311475409836065
"United States","Kansas","KS",2020-01-05,2020-01-11,7,2020,"2",2913314,560,0,618,-58,560,0,-1.99085989357824,-0.0938511326860841
"United States","Kansas","KS",2020-01-12,2020-01-18,7,2020,"3",2913314,576,0,610,-34,576,0,-1.1670557996838,-0.0557377049180328
"United States","Kansas","KS",2020-01-19,2020-01-25,7,2020,"4",2913314,571,0,601,-30,571,0,-1.02975511736806,-0.0499168053244592
"United States","Kansas","KS",2020-01-26,2020-02-01,7,2020,"5",2913314,549,0,597,-48,549,0,-1.64760818778889,-0.0804020100502513
"United States","Kansas","KS",2020-02-02,2020-02-08,7,2020,"6",2913314,503,0,595,-92,503,0,-3.15791569326204,-0.154621848739496
"United States","Kansas","KS",2020-02-09,2020-02-15,7,2020,"7",2913314,575,0,584,-9,575,0,-0.308926535210417,-0.0154109589041096
"United States","Kansas","KS",2020-02-16,2020-02-22,7,2020,"8",2913314,559,0,581,-22,559,0,-0.755153752736574,-0.0378657487091222
"United States","Kansas","KS",2020-02-23,2020-02-29,7,2020,"9",2913314,548,0,577,-29,548,0,-0.995429946789121,-0.050259965337955
"United States","Kansas","KS",2020-03-01,2020-03-07,7,2020,"10",2913314,575,0,565,10,575,0,0.343251705789352,0.0176991150442478
"United States","Kansas","KS",2020-03-08,2020-03-14,7,2020,"11",2913314,522,1,558,-36,521,0.0343251705789352,-1.23570614084167,-0.0645161290322581
"United States","Kansas","KS",2020-03-15,2020-03-21,7,2020,"12",2913314,515,1,548,-33,514,0.0343251705789352,-1.13273062910486,-0.0602189781021898
"United States","Kansas","KS",2020-03-22,2020-03-28,7,2020,"13",2913314,523,3,542,-19,520,0.102975511736806,-0.652178240999769,-0.0350553505535055
"United States","Kansas","KS",2020-03-29,2020-04-04,7,2020,"14",2913314,550,16,528,22,534,0.549202729262963,0.755153752736574,0.0416666666666667
"United States","Kansas","KS",2020-04-05,2020-04-11,7,2020,"15",2913314,525,34,515,10,491,1.1670557996838,0.343251705789352,0.0194174757281553
"United States","Kansas","KS",2020-04-12,2020-04-18,7,2020,"16",2913314,546,32,504,42,514,1.09840545852593,1.44165716431528,0.0833333333333333
"United States","Kansas","KS",2020-04-19,2020-04-25,7,2020,"17",2913314,541,33,496,45,508,1.13273062910486,1.54463267605208,0.090725806451613
"United States","Kansas","KS",2020-04-26,2020-05-02,7,2020,"18",2913314,526,22,494,32,504,0.755153752736574,1.09840545852593,0.0647773279352226
"United States","Kansas","KS",2020-05-03,2020-05-09,7,2020,"19",2913314,507,31,490,17,476,1.06408028794699,0.583527899841898,0.0346938775510204
"United States","Kansas","KS",2020-05-10,2020-05-16,7,2020,"20",2913314,530,21,489,41,509,0.720828582157639,1.40733199373634,0.0838445807770962
"United States","Kansas","KS",2020-05-17,2020-05-23,7,2020,"21",2913314,520,10,486,34,510,0.343251705789352,1.1670557996838,0.0699588477366255
"United States","Kansas","KS",2020-05-24,2020-05-30,7,2020,"22",2913314,506,9,485,21,497,0.308926535210417,0.720828582157639,0.043298969072165
"United States","Kansas","KS",2020-05-31,2020-06-06,7,2020,"23",2913314,499,19,480,19,480,0.652178240999769,0.652178240999769,0.0395833333333333
"United States","Kansas","KS",2020-06-07,2020-06-13,7,2020,"24",2913314,516,11,482,34,505,0.377576876368287,1.1670557996838,0.0705394190871369
"United States","Kansas","KS",2020-06-14,2020-06-20,7,2020,"25",2913314,508,19,478,30,489,0.652178240999769,1.02975511736806,0.0627615062761506
"United States","Kansas","KS",2020-06-21,2020-06-27,7,2020,"26",2913314,521,6,480,41,515,0.205951023473611,1.40733199373634,0.0854166666666667
"United States","Kansas","KS",2020-06-28,2020-07-04,7,2020,"27",2913314,562,7,481,81,555,0.240276194052546,2.78033881689375,0.168399168399168
"United States","Kansas","KS",2020-07-05,2020-07-11,7,2020,"28",2913314,504,13,483,21,491,0.446227217526157,0.720828582157639,0.0434782608695652
"United States","Kansas","KS",2020-07-12,2020-07-18,7,2020,"29",2913314,518,17,483,35,501,0.583527899841898,1.20138097026273,0.0724637681159421
"United States","Kansas","KS",2020-07-19,2020-07-25,7,2020,"30",2913314,540,19,478,62,521,0.652178240999769,2.12816057589398,0.129707112970711
"United States","Kansas","KS",2020-07-26,2020-08-01,7,2020,"31",2913314,543,34,475,68,509,1.1670557996838,2.33411159936759,0.143157894736842
"United States","Kansas","KS",2020-08-02,2020-08-08,7,2020,"32",2913314,601,22,477,124,579,0.755153752736574,4.25632115178796,0.259958071278826
"United States","Kansas","KS",2020-08-09,2020-08-15,7,2020,"33",2913314,577,27,470,107,550,0.92677960563125,3.67279325194607,0.227659574468085
"United States","Kansas","KS",2020-08-16,2020-08-22,7,2020,"34",2913314,514,23,472,42,491,0.78947892331551,1.44165716431528,0.0889830508474576
"United States","Kansas","KS",2020-08-23,2020-08-29,7,2020,"35",2913314,532,18,477,55,514,0.617853070420833,1.88788438184144,0.115303983228511
"United States","Kansas","KS",2020-08-30,2020-09-05,7,2020,"36",2913314,566,33,479,87,533,1.13273062910486,2.98628984036736,0.181628392484342
"United States","Kansas","KS",2020-09-06,2020-09-12,7,2020,"37",2913314,581,41,476,105,540,1.40733199373634,3.6041429107882,0.220588235294118
"United States","Kansas","KS",2020-09-13,2020-09-19,7,2020,"38",2913314,553,76,482,71,477,2.60871296399907,2.4370871111044,0.147302904564315
"United States","Kansas","KS",2020-09-20,2020-09-26,7,2020,"39",2913314,601,34,482,119,567,1.1670557996838,4.08469529889329,0.246887966804979
"United States","Kansas","KS",2020-09-27,2020-10-03,7,2020,"40",2913314,580,66,479,101,514,2.26546125820972,3.46684222847245,0.210855949895616
"United States","Kansas","KS",2020-10-04,2020-10-10,7,2020,"41",2913314,638,65,477,161,573,2.23113608763079,5.52635246320857,0.337526205450734
"United States","Kansas","KS",2020-10-11,2020-10-17,7,2020,"42",2913314,636,96,479,157,540,3.29521637557778,5.38905178089283,0.32776617954071
"United States","Kansas","KS",2020-10-18,2020-10-24,7,2020,"43",2913314,658,116,478,180,542,3.98171978715648,6.17853070420833,0.376569037656904
"United States","Kansas","KS",2020-10-25,2020-10-31,7,2020,"44",2913314,577,54,488,89,523,1.8535592112625,3.05494018152523,0.182377049180328
"United States","Kansas","KS",2020-11-01,2020-11-07,7,2020,"45",2913314,679,137,501,178,542,4.70254836931412,6.10988036305046,0.355289421157685
"United States","Kansas","KS",2020-11-08,2020-11-14,7,2020,"46",2913314,719,88,501,218,631,3.0206150109463,7.48288718620787,0.435129740518962
"United States","Kansas","KS",2020-11-15,2020-11-21,7,2020,"47",2913314,782,156,509,273,626,5.35472661031389,9.37077156804931,0.536345776031434
"United States","Kansas","KS",2020-11-22,2020-11-28,7,2020,"48",2913314,814,119,516,298,695,4.08469529889329,10.2289008325227,0.577519379844961
"United States","Kansas","KS",2020-11-29,2020-12-05,7,2020,"49",2913314,870,257,523,347,613,8.82156883878634,11.9108341908905,0.663479923518165
"United States","Kansas","KS",2020-12-06,2020-12-12,7,2020,"50",2913314,880,286,527,353,594,9.81699878557547,12.1167852143641,0.669829222011385
"United States","Kansas","KS",2020-12-13,2020-12-19,7,2020,"51",2913314,931,269,540,391,662,9.23347088573357,13.4211416963637,0.724074074074074
"United States","Kansas","KS",2020-12-20,2020-12-26,7,2020,"52",2913314,855,0,556,299,855,0,10.2632260031016,0.537769784172662
"United States","Kansas","KS",2020-12-27,2021-01-02,7,2020,"53",2913314,811,537,560,251,274,18.4326166008882,8.61561781531273,0.448214285714286
"United States","Kansas","KS",2021-01-03,2021-01-09,7,2021,"1",2913314,789,270,568,221,519,9.2677960563125,7.58586269794468,0.389084507042254
"United States","Kansas","KS",2021-01-10,2021-01-16,7,2021,"2",2913314,787,354,578,209,433,12.1511103849431,7.17396065099746,0.36159169550173
"United States","Kansas","KS",2021-01-17,2021-01-23,7,2021,"3",2913314,675,96,571,104,579,3.29521637557778,3.56981774020926,0.182136602451839
"United States","Kansas","KS",2021-01-24,2021-01-30,7,2021,"4",2913314,690,181,566,124,509,6.21285587478727,4.25632115178796,0.219081272084806
"United States","Kansas","KS",2021-01-31,2021-02-06,7,2021,"5",2913314,681,322,574,107,359,11.0527049264171,3.67279325194607,0.186411149825784
"United States","Kansas","KS",2021-02-07,2021-02-13,7,2021,"6",2913314,583,263,572,11,320,9.02751986225996,0.377576876368287,0.0192307692307692
"United States","Kansas","KS",2021-02-14,2021-02-20,7,2021,"7",2913314,588,266,569,19,322,9.13049537399676,0.652178240999769,0.0333919156414764
"United States","Kansas","KS",2021-02-21,2021-02-27,7,2021,"8",2913314,600,122,572,28,478,4.18767081063009,0.961104776210185,0.048951048951049
"United States","Kansas","KS",2021-02-28,2021-03-06,7,2021,"9",2913314,557,94,574,-17,463,3.22656603441991,-0.583527899841898,-0.0296167247386759
"United States","Kansas","KS",2021-03-07,2021-03-13,7,2021,"10",2913314,533,52,566,-33,481,1.78490887010463,-1.13273062910486,-0.058303886925795
"United States","Kansas","KS",2021-03-14,2021-03-20,7,2021,"11",2913314,510,15,558,-48,495,0.514877558684028,-1.64760818778889,-0.0860215053763441
"United States","Kansas","KS",2021-03-21,2021-03-27,7,2021,"12",2913314,526,-21,545,-19,547,-0.720828582157639,-0.652178240999769,-0.0348623853211009
"United States","Kansas","KS",2021-03-28,2021-04-03,7,2021,"13",2913314,526,41,537,-11,485,1.40733199373634,-0.377576876368287,-0.0204841713221602
"United States","Kansas","KS",2021-04-04,2021-04-10,7,2021,"14",2913314,512,5,525,-13,507,0.171625852894676,-0.446227217526157,-0.0247619047619048
"United States","Kansas","KS",2021-04-11,2021-04-17,7,2021,"15",2913314,500,18,519,-19,482,0.617853070420833,-0.652178240999769,-0.0366088631984586
"United States","Kansas","KS",2021-04-18,2021-04-24,7,2021,"16",2913314,533,12,509,24,521,0.411902046947222,0.823804093894445,0.0471512770137525
"United States","Kansas","KS",2021-04-25,2021-05-01,7,2021,"17",2913314,518,14,508,10,504,0.480552388105093,0.343251705789352,0.0196850393700787
"United States","Kansas","KS",2021-05-02,2021-05-08,7,2021,"18",2913314,519,34,501,18,485,1.1670557996838,0.617853070420833,0.0359281437125749
"United States","Kansas","KS",2021-05-09,2021-05-15,7,2021,"19",2913314,514,22,499,15,492,0.755153752736574,0.514877558684028,0.0300601202404809
"United States","Kansas","KS",2021-05-16,2021-05-22,7,2021,"20",2913314,560,19,499,61,541,0.652178240999769,2.09383540531505,0.122244488977956
"United States","Kansas","KS",2021-05-23,2021-05-29,7,2021,"21",2913314,488,19,497,-9,469,0.652178240999769,-0.308926535210417,-0.0181086519114688
"United States","Kansas","KS",2021-05-30,2021-06-05,7,2021,"22",2913314,521,8,497,24,513,0.274601364631482,0.823804093894445,0.0482897384305836
"United States","Kansas","KS",2021-06-06,2021-06-12,7,2021,"23",2913314,545,22,499,46,523,0.755153752736574,1.57895784663102,0.092184368737475
"United States","Kansas","KS",2021-06-13,2021-06-19,7,2021,"24",2913314,509,23,502,7,486,0.78947892331551,0.240276194052546,0.0139442231075697
"United States","Kansas","KS",2021-06-20,2021-06-26,7,2021,"25",2913314,515,18,498,17,497,0.617853070420833,0.583527899841898,0.0341365461847389
"United States","Kansas","KS",2021-06-27,2021-07-03,7,2021,"26",2913314,531,12,496,35,519,0.411902046947222,1.20138097026273,0.0705645161290323
"United States","Kansas","KS",2021-07-04,2021-07-10,7,2021,"27",2913314,543,17,499,44,526,0.583527899841898,1.51030750547315,0.0881763527054109
"United States","Kansas","KS",2021-07-11,2021-07-17,7,2021,"28",2913314,545,21,495,50,524,0.720828582157639,1.71625852894676,0.101010101010101
"United States","Kansas","KS",2021-07-18,2021-07-24,7,2021,"29",2913314,521,42,484,37,479,1.44165716431528,1.2700313114206,0.0764462809917354
"United States","Kansas","KS",2021-07-25,2021-07-31,7,2021,"30",2913314,514,16,480,34,498,0.549202729262963,1.1670557996838,0.0708333333333333
"United States","Kansas","KS",2021-08-01,2021-08-07,7,2021,"31",2913314,501,44,483,18,457,1.51030750547315,0.617853070420833,0.0372670807453417
"United States","Kentucky","KY",2019-12-29,2020-01-04,7,2020,"1",4467673,1093,0,1058,35,1093,0,0.7834055894422,0.0330812854442344
"United States","Kentucky","KY",2020-01-05,2020-01-11,7,2020,"2",4467673,1058,0,1060,-2,1058,0,-0.0447660336824114,-0.00188679245283019
"United States","Kentucky","KY",2020-01-12,2020-01-18,7,2020,"3",4467673,1041,0,1043,-2,1041,0,-0.0447660336824114,-0.00191754554170664
"United States","Kentucky","KY",2020-01-19,2020-01-25,7,2020,"4",4467673,944,0,1029,-85,944,0,-1.90255643150248,-0.0826044703595724
"United States","Kentucky","KY",2020-01-26,2020-02-01,7,2020,"5",4467673,978,0,1013,-35,978,0,-0.7834055894422,-0.0345508390918066
"United States","Kentucky","KY",2020-02-02,2020-02-08,7,2020,"6",4467673,956,0,995,-39,956,0,-0.872937656807022,-0.0391959798994975
"United States","Kentucky","KY",2020-02-09,2020-02-15,7,2020,"7",4467673,955,0,998,-43,955,0,-0.962469724171845,-0.0430861723446894
"United States","Kentucky","KY",2020-02-16,2020-02-22,7,2020,"8",4467673,992,0,988,4,992,0,0.0895320673648228,0.00404858299595134
"United States","Kentucky","KY",2020-02-23,2020-02-29,7,2020,"9",4467673,1022,0,973,49,1022,0,1.09676782521908,0.0503597122302157
"United States","Kentucky","KY",2020-03-01,2020-03-07,7,2020,"10",4467673,1006,0,970,36,1006,0,0.805788606283405,0.0371134020618558
"United States","Kentucky","KY",2020-03-08,2020-03-14,7,2020,"11",4467673,1021,0,969,52,1021,0,1.1639168757427,0.0536635706914346
"United States","Kentucky","KY",2020-03-15,2020-03-21,7,2020,"12",4467673,949,3,956,-7,946,0.0671490505236171,-0.15668111788844,-0.00732217573221761
"United States","Kentucky","KY",2020-03-22,2020-03-28,7,2020,"13",4467673,937,7,950,-13,930,0.15668111788844,-0.290979218935674,-0.0136842105263157
"United States","Kentucky","KY",2020-03-29,2020-04-04,7,2020,"14",4467673,1048,30,947,101,1018,0.671490505236171,2.26068470096178,0.106652587117212
"United States","Kentucky","KY",2020-04-05,2020-04-11,7,2020,"15",4467673,1026,54,945,81,972,1.20868290942511,1.81302436413766,0.0857142857142856
"United States","Kentucky","KY",2020-04-12,2020-04-18,7,2020,"16",4467673,960,50,935,25,910,1.11915084206029,0.559575421030143,0.0267379679144386
"United States","Kentucky","KY",2020-04-19,2020-04-25,7,2020,"17",4467673,975,61,924,51,914,1.36536402731355,1.14153385890149,0.0551948051948052
"United States","Kentucky","KY",2020-04-26,2020-05-02,7,2020,"18",4467673,998,43,910,88,955,0.962469724171845,1.9697054820261,0.0967032967032968
"United States","Kentucky","KY",2020-05-03,2020-05-09,7,2020,"19",4467673,1006,56,896,110,950,1.25344894310752,2.46213185253263,0.122767857142857
"United States","Kentucky","KY",2020-05-10,2020-05-16,7,2020,"20",4467673,995,30,884,111,965,0.671490505236171,2.48451486937383,0.125565610859729
"United States","Kentucky","KY",2020-05-17,2020-05-23,7,2020,"21",4467673,998,57,871,127,941,1.27583195994872,2.84264313883312,0.145809414466131
"United States","Kentucky","KY",2020-05-24,2020-05-30,7,2020,"22",4467673,987,40,878,109,947,0.895320673648228,2.43974883569142,0.124145785876993
"United States","Kentucky","KY",2020-05-31,2020-06-06,7,2020,"23",4467673,918,38,869,49,880,0.850554639965817,1.09676782521908,0.0563866513233602
"United States","Kentucky","KY",2020-06-07,2020-06-13,7,2020,"24",4467673,1002,29,868,134,973,0.649107488394965,2.99932425672156,0.154377880184332
"United States","Kentucky","KY",2020-06-14,2020-06-20,7,2020,"25",4467673,966,26,874,92,940,0.581958437871348,2.05923754939092,0.105263157894737
"United States","Kentucky","KY",2020-06-21,2020-06-27,7,2020,"26",4467673,937,30,877,60,907,0.671490505236171,1.34298101047234,0.0684150513112884
"United States","Kentucky","KY",2020-06-28,2020-07-04,7,2020,"27",4467673,993,31,875,118,962,0.693873522077377,2.64119598726227,0.134857142857143
"United States","Kentucky","KY",2020-07-05,2020-07-11,7,2020,"28",4467673,1047,37,868,179,1010,0.828171623124611,4.00656001457582,0.206221198156682
"United States","Kentucky","KY",2020-07-12,2020-07-18,7,2020,"29",4467673,936,45,874,62,891,1.00723575785426,1.38774704415475,0.0709382151029749
"United States","Kentucky","KY",2020-07-19,2020-07-25,7,2020,"30",4467673,968,29,872,96,939,0.649107488394965,2.14876961675575,0.110091743119266
"United States","Kentucky","KY",2020-07-26,2020-08-01,7,2020,"31",4467673,1031,44,868,163,987,0.984852741013051,3.64843174511653,0.18778801843318
"United States","Kentucky","KY",2020-08-02,2020-08-08,7,2020,"32",4467673,1007,32,866,141,975,0.716256538918582,3.15600537461,0.162817551963049
"United States","Kentucky","KY",2020-08-09,2020-08-15,7,2020,"33",4467673,1015,38,867,148,977,0.850554639965817,3.31268649249844,0.170703575547866
"United States","Kentucky","KY",2020-08-16,2020-08-22,7,2020,"34",4467673,1078,62,865,213,1016,1.38774704415475,4.76758258717681,0.246242774566474
"United States","Kentucky","KY",2020-08-23,2020-08-29,7,2020,"35",4467673,1007,49,861,146,958,1.09676782521908,3.26792045881603,0.169570267131243
"United States","Kentucky","KY",2020-08-30,2020-09-05,7,2020,"36",4467673,1055,72,869,186,983,1.61157721256681,4.16324113246426,0.214039125431531
"United States","Kentucky","KY",2020-09-06,2020-09-12,7,2020,"37",4467673,1020,64,868,152,956,1.43251307783716,3.40221855986327,0.175115207373272
"United States","Kentucky","KY",2020-09-13,2020-09-19,7,2020,"38",4467673,1017,51,873,144,966,1.14153385890149,3.22315442513362,0.164948453608248
"United States","Kentucky","KY",2020-09-20,2020-09-26,7,2020,"39",4467673,1069,46,869,200,1023,1.02961877469546,4.47660336824114,0.230149597238205
"United States","Kentucky","KY",2020-09-27,2020-10-03,7,2020,"40",4467673,1008,51,878,130,957,1.14153385890149,2.90979218935674,0.148063781321184
"United States","Kentucky","KY",2020-10-04,2020-10-10,7,2020,"41",4467673,1068,44,875,193,1024,0.984852741013051,4.3199222503527,0.220571428571429
"United States","Kentucky","KY",2020-10-11,2020-10-17,7,2020,"42",4467673,1127,63,883,244,1064,1.41013006099596,5.46145610925419,0.276330690826727
"United States","Kentucky","KY",2020-10-18,2020-10-24,7,2020,"43",4467673,1183,92,892,291,1091,2.05923754939092,6.51345790079086,0.326233183856502
"United States","Kentucky","KY",2020-10-25,2020-10-31,7,2020,"44",4467673,1125,79,905,220,1046,1.76825833045525,4.92426370506525,0.243093922651934
"United States","Kentucky","KY",2020-11-01,2020-11-07,7,2020,"45",4467673,1181,76,917,264,1105,1.70110927993163,5.9091164460783,0.287895310796074
"United States","Kentucky","KY",2020-11-08,2020-11-14,7,2020,"46",4467673,1187,98,919,268,1089,2.19353565043816,5.99864851344313,0.291621327529924
"United States","Kentucky","KY",2020-11-15,2020-11-21,7,2020,"47",4467673,1289,125,926,363,1164,2.79787710515071,8.12503511335767,0.392008639308855
"United States","Kentucky","KY",2020-11-22,2020-11-28,7,2020,"48",4467673,1332,102,940,392,1230,2.28306771780298,8.77414260175263,0.417021276595745
"United States","Kentucky","KY",2020-11-29,2020-12-05,7,2020,"49",4467673,1357,178,955,402,1179,3.98417699773462,8.99797277016469,0.420942408376963
"United States","Kentucky","KY",2020-12-06,2020-12-12,7,2020,"50",4467673,1410,130,960,450,1280,2.90979218935674,10.0723575785426,0.46875
"United States","Kentucky","KY",2020-12-13,2020-12-19,7,2020,"51",4467673,1382,179,983,399,1203,4.00656001457582,8.93082371964108,0.405900305188199
"United States","Kentucky","KY",2020-12-20,2020-12-26,7,2020,"52",4467673,1485,163,1009,476,1322,3.64843174511653,10.6543160164139,0.471754212091179
"United States","Kentucky","KY",2020-12-27,2021-01-02,7,2020,"53",4467673,1409,164,1020,389,1245,3.67081476195774,8.70699355122902,0.381372549019608
"United States","Kentucky","KY",2021-01-03,2021-01-09,7,2021,"1",4467673,1292,178,1030,262,1114,3.98417699773462,5.86435041239589,0.254368932038835
"United States","Kentucky","KY",2021-01-10,2021-01-16,7,2021,"2",4467673,1398,216,1032,366,1182,4.83473163770043,8.19218416388129,0.354651162790698
"United States","Kentucky","KY",2021-01-17,2021-01-23,7,2021,"3",4467673,1320,294,1026,294,1026,6.58060695131448,6.58060695131448,0.286549707602339
"United States","Kentucky","KY",2021-01-24,2021-01-30,7,2021,"4",4467673,1257,328,1014,243,929,7.34162952391547,5.43907309241299,0.239644970414201
"United States","Kentucky","KY",2021-01-31,2021-02-06,7,2021,"5",4467673,1168,306,1016,152,862,6.84920315340894,3.40221855986327,0.149606299212598
"United States","Kentucky","KY",2021-02-07,2021-02-13,7,2021,"6",4467673,1164,252,1013,151,912,5.64052024398384,3.37983554302206,0.149062191510365
"United States","Kentucky","KY",2021-02-14,2021-02-20,7,2021,"7",4467673,1138,154,1015,123,984,3.44698459354568,2.7531110714683,0.121182266009852
"United States","Kentucky","KY",2021-02-21,2021-02-27,7,2021,"8",4467673,1118,199,1007,111,919,4.45422035139994,2.48451486937383,0.110228401191658
"United States","Kentucky","KY",2021-02-28,2021-03-06,7,2021,"9",4467673,1077,181,1004,73,896,4.05132604825823,1.63396022940802,0.0727091633466135
"United States","Kentucky","KY",2021-03-07,2021-03-13,7,2021,"10",4467673,1138,160,998,140,978,3.58128269459291,3.1336223577688,0.140280561122244
"United States","Kentucky","KY",2021-03-14,2021-03-20,7,2021,"11",4467673,1029,754,988,41,275,16.8767946982691,0.917703690489434,0.0414979757085021
"United States","Kentucky","KY",2021-03-21,2021-03-27,7,2021,"12",4467673,1035,290,974,61,745,6.49107488394965,1.36536402731355,0.0626283367556468
"United States","Kentucky","KY",2021-03-28,2021-04-03,7,2021,"13",4467673,990,139,976,14,851,3.11123934092759,0.31336223577688,0.014344262295082
"United States","Kentucky","KY",2021-04-04,2021-04-10,7,2021,"14",4467673,1066,92,963,103,974,2.05923754939092,2.30545073464419,0.106957424714434
"United States","Kentucky","KY",2021-04-11,2021-04-17,7,2021,"15",4467673,1042,89,959,83,953,1.99208849886731,1.85779039782007,0.086548488008342
"United States","Kentucky","KY",2021-04-18,2021-04-24,7,2021,"16",4467673,1037,106,952,85,931,2.3725997851678,1.90255643150248,0.0892857142857142
"United States","Kentucky","KY",2021-04-25,2021-05-01,7,2021,"17",4467673,1011,77,946,65,934,1.72349229677284,1.45489609467837,0.0687103594080338
"United States","Kentucky","KY",2021-05-02,2021-05-08,7,2021,"18",4467673,974,65,936,38,909,1.45489609467837,0.850554639965817,0.0405982905982907
"United States","Kentucky","KY",2021-05-09,2021-05-15,7,2021,"19",4467673,949,70,927,22,879,1.5668111788844,0.492426370506525,0.0237324703344122
"United States","Kentucky","KY",2021-05-16,2021-05-22,7,2021,"20",4467673,1046,57,914,132,989,1.27583195994872,2.95455822303915,0.144420131291028
"United States","Kentucky","KY",2021-05-23,2021-05-29,7,2021,"21",4467673,1035,77,912,123,958,1.72349229677284,2.7531110714683,0.134868421052632
"United States","Kentucky","KY",2021-05-30,2021-06-05,7,2021,"22",4467673,949,309,915,34,640,6.91635220393256,0.761022572600994,0.0371584699453551
"United States","Kentucky","KY",2021-06-06,2021-06-12,7,2021,"23",4467673,963,64,916,47,899,1.43251307783716,1.05200179153667,0.0513100436681222
"United States","Kentucky","KY",2021-06-13,2021-06-19,7,2021,"24",4467673,991,25,916,75,966,0.559575421030143,1.67872626309043,0.081877729257642
"United States","Kentucky","KY",2021-06-20,2021-06-26,7,2021,"25",4467673,940,24,920,20,916,0.537192404188937,0.447660336824114,0.0217391304347827
"United States","Kentucky","KY",2021-06-27,2021-07-03,7,2021,"26",4467673,926,25,907,19,901,0.559575421030143,0.425277319982908,0.0209481808158765
"United States","Kentucky","KY",2021-07-04,2021-07-10,7,2021,"27",4467673,925,26,898,27,899,0.581958437871348,0.604341454712554,0.0300668151447661
"United States","Kentucky","KY",2021-07-11,2021-07-17,7,2021,"28",4467673,917,29,901,16,888,0.649107488394965,0.358128269459291,0.0177580466148723
"United States","Kentucky","KY",2021-07-18,2021-07-24,7,2021,"29",4467673,884,28,896,-12,856,0.62672447155376,-0.268596202094468,-0.0133928571428571
"United States","Kentucky","KY",2021-07-25,2021-07-31,7,2021,"30",4467673,789,22,890,-101,767,0.492426370506525,-2.26068470096178,-0.113483146067416
"United States","Kentucky","KY",2021-08-01,2021-08-07,7,2021,"31",4467673,455,38,892,-437,417,0.850554639965817,-9.78137835960689,-0.489910313901345
"United States","Louisiana","LA",2019-12-29,2020-01-04,7,2020,"1",4648794,927,0,997,-70,927,0,-1.50576687201025,-0.0702106318956871
"United States","Louisiana","LA",2020-01-05,2020-01-11,7,2020,"2",4648794,967,0,993,-26,967,0,-0.559284838175234,-0.026183282980866
"United States","Louisiana","LA",2020-01-12,2020-01-18,7,2020,"3",4648794,960,0,993,-33,960,0,-0.709861525376259,-0.0332326283987915
"United States","Louisiana","LA",2020-01-19,2020-01-25,7,2020,"4",4648794,970,0,1001,-31,970,0,-0.666839614747395,-0.0309690309690309
"United States","Louisiana","LA",2020-01-26,2020-02-01,7,2020,"5",4648794,977,0,997,-20,977,0,-0.430219106288642,-0.0200601805416248
"United States","Louisiana","LA",2020-02-02,2020-02-08,7,2020,"6",4648794,956,0,999,-43,956,0,-0.92497107852058,-0.0430430430430431
"United States","Louisiana","LA",2020-02-09,2020-02-15,7,2020,"7",4648794,951,0,979,-28,951,0,-0.602306748804098,-0.0286006128702758
"United States","Louisiana","LA",2020-02-16,2020-02-22,7,2020,"8",4648794,950,0,958,-8,950,0,-0.172087642515457,-0.00835073068893533
"United States","Louisiana","LA",2020-02-23,2020-02-29,7,2020,"9",4648794,993,0,946,47,993,0,1.01101489977831,0.0496828752642706
"United States","Louisiana","LA",2020-03-01,2020-03-07,7,2020,"10",4648794,964,0,935,29,964,0,0.623817704118531,0.0310160427807487
"United States","Louisiana","LA",2020-03-08,2020-03-14,7,2020,"11",4648794,994,1,940,54,993,0.0215109553144321,1.16159158697933,0.0574468085106383
"United States","Louisiana","LA",2020-03-15,2020-03-21,7,2020,"12",4648794,955,19,946,9,936,0.40870815097421,0.193598597829889,0.0095137420718816
"United States","Louisiana","LA",2020-03-22,2020-03-28,7,2020,"13",4648794,1233,117,942,291,1116,2.51678177178855,6.25968799649974,0.308917197452229
"United States","Louisiana","LA",2020-03-29,2020-04-04,7,2020,"14",4648794,1390,271,933,457,1119,5.8294688902111,9.83050657869546,0.489817792068596
"United States","Louisiana","LA",2020-04-05,2020-04-11,7,2020,"15",4648794,1529,395,928,601,1134,8.49682734920067,12.9280841439737,0.647629310344828
"United States","Louisiana","LA",2020-04-12,2020-04-18,7,2020,"16",4648794,1360,465,933,427,895,10.0025942212109,9.1851779192625,0.457663451232583
"United States","Louisiana","LA",2020-04-19,2020-04-25,7,2020,"17",4648794,1248,375,919,329,873,8.06660824291203,7.07710429844816,0.357997823721436
"United States","Louisiana","LA",2020-04-26,2020-05-02,7,2020,"18",4648794,1171,302,910,261,869,6.49630850495849,5.61435933706677,0.286813186813187
"United States","Louisiana","LA",2020-05-03,2020-05-09,7,2020,"19",4648794,1129,241,911,218,888,5.18414023077813,4.6893882585462,0.239297475301866
"United States","Louisiana","LA",2020-05-10,2020-05-16,7,2020,"20",4648794,1105,225,905,200,880,4.83996494574722,4.30219106288642,0.220994475138122
"United States","Louisiana","LA",2020-05-17,2020-05-23,7,2020,"21",4648794,1052,149,904,148,903,3.20513234185038,3.18362138653595,0.163716814159292
"United States","Louisiana","LA",2020-05-24,2020-05-30,7,2020,"22",4648794,1054,118,896,158,936,2.53829272710299,3.39873093968027,0.176339285714286
"United States","Louisiana","LA",2020-05-31,2020-06-06,7,2020,"23",4648794,1016,134,874,142,882,2.8824680121339,3.05455565464936,0.162471395881007
"United States","Louisiana","LA",2020-06-07,2020-06-13,7,2020,"24",4648794,951,78,860,91,873,1.6778545145257,1.95749693361332,0.105813953488372
"United States","Louisiana","LA",2020-06-14,2020-06-20,7,2020,"25",4648794,1004,99,857,147,905,2.12958457612878,3.16211043122152,0.171528588098016
"United States","Louisiana","LA",2020-06-21,2020-06-27,7,2020,"26",4648794,998,88,854,144,910,1.89296406767002,3.09757756527822,0.168618266978923
"United States","Louisiana","LA",2020-06-28,2020-07-04,7,2020,"27",4648794,985,92,849,136,893,1.97900788892775,2.92548992276276,0.160188457008245
"United States","Louisiana","LA",2020-07-05,2020-07-11,7,2020,"28",4648794,1061,126,850,211,935,2.71038036961844,4.53881157134517,0.248235294117647
"United States","Louisiana","LA",2020-07-12,2020-07-18,7,2020,"29",4648794,1152,104,847,305,1048,2.23713935270094,6.56084137090179,0.360094451003542
"United States","Louisiana","LA",2020-07-19,2020-07-25,7,2020,"30",4648794,1213,204,852,361,1009,4.38823488414415,7.76545486850998,0.423708920187793
"United States","Louisiana","LA",2020-07-26,2020-08-01,7,2020,"31",4648794,1205,232,861,344,973,4.99054163294824,7.39976862816464,0.399535423925668
"United States","Louisiana","LA",2020-08-02,2020-08-08,7,2020,"32",4648794,1243,254,875,368,989,5.46378264986575,7.91603155571101,0.420571428571429
"United States","Louisiana","LA",2020-08-09,2020-08-15,7,2020,"33",4648794,1181,218,865,316,963,4.6893882585462,6.79746187936054,0.365317919075145
"United States","Louisiana","LA",2020-08-16,2020-08-22,7,2020,"34",4648794,1132,239,854,278,893,5.14111832014927,5.98004557741212,0.325526932084309
"United States","Louisiana","LA",2020-08-23,2020-08-29,7,2020,"35",4648794,1098,195,852,246,903,4.19463628631426,5.29169500735029,0.288732394366197
"United States","Louisiana","LA",2020-08-30,2020-09-05,7,2020,"36",4648794,1110,131,863,247,979,2.8179351461906,5.31320596266473,0.286210892236385
"United States","Louisiana","LA",2020-09-06,2020-09-12,7,2020,"37",4648794,1027,160,859,168,867,3.44175285030913,3.61384049282459,0.19557625145518
"United States","Louisiana","LA",2020-09-13,2020-09-19,7,2020,"38",4648794,1040,140,857,183,900,3.01153374402049,3.93650482254107,0.213535589264878
"United States","Louisiana","LA",2020-09-20,2020-09-26,7,2020,"39",4648794,991,90,865,126,901,1.93598597829889,2.71038036961844,0.145664739884393
"United States","Louisiana","LA",2020-09-27,2020-10-03,7,2020,"40",4648794,1036,125,865,171,911,2.68886941430401,3.67837335876789,0.197687861271676
"United States","Louisiana","LA",2020-10-04,2020-10-10,7,2020,"41",4648794,1044,55,860,184,989,1.18310254229376,3.9580157778555,0.213953488372093
"United States","Louisiana","LA",2020-10-11,2020-10-17,7,2020,"42",4648794,991,85,867,124,906,1.82843120172673,2.66735845898958,0.143021914648212
"United States","Louisiana","LA",2020-10-18,2020-10-24,7,2020,"43",4648794,1008,87,881,127,921,1.87145311235559,2.73189132493288,0.144154370034052
"United States","Louisiana","LA",2020-10-25,2020-10-31,7,2020,"44",4648794,951,91,889,62,860,1.95749693361332,1.33367922949479,0.0697412823397074
"United States","Louisiana","LA",2020-11-01,2020-11-07,7,2020,"45",4648794,1052,82,901,151,970,1.76389833578343,3.24815425247925,0.167591564927858
"United States","Louisiana","LA",2020-11-08,2020-11-14,7,2020,"46",4648794,1056,98,907,149,958,2.10807362081434,3.20513234185038,0.164277839029769
"United States","Louisiana","LA",2020-11-15,2020-11-21,7,2020,"47",4648794,1068,348,928,140,720,7.48581244942237,3.01153374402049,0.150862068965517
"United States","Louisiana","LA",2020-11-22,2020-11-28,7,2020,"48",4648794,1084,174,934,150,910,3.74290622471118,3.22664329716481,0.160599571734475
"United States","Louisiana","LA",2020-11-29,2020-12-05,7,2020,"49",4648794,1103,139,938,165,964,2.99002278870606,3.54930762688129,0.17590618336887
"United States","Louisiana","LA",2020-12-06,2020-12-12,7,2020,"50",4648794,1238,220,945,293,1018,4.73241016917506,6.3027099071286,0.31005291005291
"United States","Louisiana","LA",2020-12-13,2020-12-19,7,2020,"51",4648794,1207,228,946,261,979,4.90449781169052,5.61435933706677,0.275898520084567
"United States","Louisiana","LA",2020-12-20,2020-12-26,7,2020,"52",4648794,1240,278,938,302,962,5.98004557741212,6.49630850495849,0.321961620469083
"United States","Louisiana","LA",2020-12-27,2021-01-02,7,2020,"53",4648794,1251,214,950,301,1037,4.60334443728847,6.47479754964406,0.316842105263158
"United States","Louisiana","LA",2021-01-03,2021-01-09,7,2021,"1",4648794,1397,347,947,450,1050,7.46430149410793,9.67992989149444,0.475184794086589
"United States","Louisiana","LA",2021-01-10,2021-01-16,7,2021,"2",4648794,1404,247,944,460,1157,5.31320596266473,9.89503944463876,0.48728813559322
"United States","Louisiana","LA",2021-01-17,2021-01-23,7,2021,"3",4648794,1362,403,947,415,959,8.66891499171613,8.92704645548932,0.438225976768743
"United States","Louisiana","LA",2021-01-24,2021-01-30,7,2021,"4",4648794,1248,318,954,294,930,6.8404837899894,6.32422086244303,0.308176100628931
"United States","Louisiana","LA",2021-01-31,2021-02-06,7,2021,"5",4648794,1195,275,947,248,920,5.91551271146882,5.33471691797916,0.261879619852165
"United States","Louisiana","LA",2021-02-07,2021-02-13,7,2021,"6",4648794,1161,200,934,227,961,4.30219106288642,4.88298685637608,0.243040685224839
"United States","Louisiana","LA",2021-02-14,2021-02-20,7,2021,"7",4648794,1158,165,911,247,993,3.54930762688129,5.31320596266473,0.271130625686059
"United States","Louisiana","LA",2021-02-21,2021-02-27,7,2021,"8",4648794,1112,148,892,220,964,3.18362138653595,4.73241016917506,0.246636771300448
"United States","Louisiana","LA",2021-02-28,2021-03-06,7,2021,"9",4648794,1082,127,887,195,955,2.73189132493288,4.19463628631426,0.219842164599775
"United States","Louisiana","LA",2021-03-07,2021-03-13,7,2021,"10",4648794,1052,145,881,171,907,3.11908852059265,3.67837335876789,0.194097616345063
"United States","Louisiana","LA",2021-03-14,2021-03-20,7,2021,"11",4648794,1012,127,870,142,885,2.73189132493288,3.05455565464936,0.163218390804598
"United States","Louisiana","LA",2021-03-21,2021-03-27,7,2021,"12",4648794,1026,100,877,149,926,2.15109553144321,3.20513234185038,0.169897377423033
"United States","Louisiana","LA",2021-03-28,2021-04-03,7,2021,"13",4648794,992,75,875,117,917,1.61332164858241,2.51678177178855,0.133714285714286
"United States","Louisiana","LA",2021-04-04,2021-04-10,7,2021,"14",4648794,970,53,864,106,917,1.1400806316649,2.2801612633298,0.122685185185185
"United States","Louisiana","LA",2021-04-11,2021-04-17,7,2021,"15",4648794,980,66,866,114,914,1.41972305075252,2.45224890584526,0.131639722863741
"United States","Louisiana","LA",2021-04-18,2021-04-24,7,2021,"16",4648794,1001,54,862,139,947,1.16159158697933,2.99002278870606,0.161252900232019
"United States","Louisiana","LA",2021-04-25,2021-05-01,7,2021,"17",4648794,983,46,855,128,937,0.989503944463876,2.75340228024731,0.149707602339181
"United States","Louisiana","LA",2021-05-02,2021-05-08,7,2021,"18",4648794,928,51,865,63,877,1.09705872103604,1.35519018480922,0.0728323699421964
"United States","Louisiana","LA",2021-05-09,2021-05-15,7,2021,"19",4648794,928,45,858,70,883,0.967992989149444,1.50576687201025,0.0815850815850816
"United States","Louisiana","LA",2021-05-16,2021-05-22,7,2021,"20",4648794,929,44,861,68,885,0.946482033835012,1.46274496138138,0.0789779326364692
"United States","Louisiana","LA",2021-05-23,2021-05-29,7,2021,"21",4648794,919,54,855,64,865,1.16159158697933,1.37670114012365,0.0748538011695907
"United States","Louisiana","LA",2021-05-30,2021-06-05,7,2021,"22",4648794,954,39,848,106,915,0.838927257262851,2.2801612633298,0.125
"United States","Louisiana","LA",2021-06-06,2021-06-12,7,2021,"23",4648794,938,33,852,86,905,0.709861525376259,1.84994215704116,0.10093896713615
"United States","Louisiana","LA",2021-06-13,2021-06-19,7,2021,"24",4648794,920,40,841,79,880,0.860438212577283,1.69936546984013,0.0939357907253271
"United States","Louisiana","LA",2021-06-20,2021-06-26,7,2021,"25",4648794,921,35,835,86,886,0.752883436005123,1.84994215704116,0.102994011976048
"United States","Louisiana","LA",2021-06-27,2021-07-03,7,2021,"26",4648794,865,34,825,40,831,0.731372480690691,0.860438212577283,0.0484848484848486
"United States","Louisiana","LA",2021-07-04,2021-07-10,7,2021,"27",4648794,897,24,825,72,873,0.51626292754637,1.54878878263911,0.0872727272727272
"United States","Louisiana","LA",2021-07-11,2021-07-17,7,2021,"28",4648794,950,47,831,119,903,1.01101489977831,2.55980368241742,0.143200962695547
"United States","Louisiana","LA",2021-07-18,2021-07-24,7,2021,"29",4648794,953,72,825,128,881,1.54878878263911,2.75340228024731,0.155151515151515
"United States","Louisiana","LA",2021-07-25,2021-07-31,7,2021,"30",4648794,883,99,826,57,784,2.12958457612878,1.22612445292263,0.0690072639225181
"United States","Louisiana","LA",2021-08-01,2021-08-07,7,2021,"31",4648794,708,211,824,-116,497,4.53881157134517,-2.49527081647412,-0.140776699029126
"United States","Maine","ME",2019-12-29,2020-01-04,7,2020,"1",1344212,320,0,302,18,320,0,1.33907449122609,0.0596026490066226
"United States","Maine","ME",2020-01-05,2020-01-11,7,2020,"2",1344212,318,0,301,17,318,0,1.26468146393575,0.0564784053156147
"United States","Maine","ME",2020-01-12,2020-01-18,7,2020,"3",1344212,295,0,305,-10,295,0,-0.743930272903381,-0.0327868852459017
"United States","Maine","ME",2020-01-19,2020-01-25,7,2020,"4",1344212,308,0,303,5,308,0,0.371965136451691,0.0165016501650166
"United States","Maine","ME",2020-01-26,2020-02-01,7,2020,"5",1344212,288,0,298,-10,288,0,-0.743930272903381,-0.0335570469798657
"United States","Maine","ME",2020-02-02,2020-02-08,7,2020,"6",1344212,316,0,295,21,316,0,1.5622535730971,0.0711864406779661
"United States","Maine","ME",2020-02-09,2020-02-15,7,2020,"7",1344212,329,0,288,41,329,0,3.05011411890386,0.142361111111111
"United States","Maine","ME",2020-02-16,2020-02-22,7,2020,"8",1344212,299,0,292,7,299,0,0.520751191032367,0.023972602739726
"United States","Maine","ME",2020-02-23,2020-02-29,7,2020,"9",1344212,292,0,295,-3,292,0,-0.223179081871014,-0.0101694915254237
"United States","Maine","ME",2020-03-01,2020-03-07,7,2020,"10",1344212,313,0,291,22,313,0,1.63664660038744,0.0756013745704467
"United States","Maine","ME",2020-03-08,2020-03-14,7,2020,"11",1344212,301,0,291,10,301,0,0.743930272903381,0.034364261168385
"United States","Maine","ME",2020-03-15,2020-03-21,7,2020,"12",1344212,277,0,292,-15,277,0,-1.11589540935507,-0.0513698630136986
"United States","Maine","ME",2020-03-22,2020-03-28,7,2020,"13",1344212,279,1,300,-21,278,0.0743930272903381,-1.5622535730971,-0.07
"United States","Maine","ME",2020-03-29,2020-04-04,7,2020,"14",1344212,300,9,295,5,291,0.669537245613043,0.371965136451691,0.0169491525423728
"United States","Maine","ME",2020-04-05,2020-04-11,7,2020,"15",1344212,304,9,291,13,295,0.669537245613043,0.967109354774396,0.0446735395189004
"United States","Maine","ME",2020-04-12,2020-04-18,7,2020,"16",1344212,310,13,288,22,297,0.967109354774396,1.63664660038744,0.0763888888888888
"United States","Maine","ME",2020-04-19,2020-04-25,7,2020,"17",1344212,285,18,282,3,267,1.33907449122609,0.223179081871014,0.0106382978723405
"United States","Maine","ME",2020-04-26,2020-05-02,7,2020,"18",1344212,277,6,271,6,271,0.446358163742029,0.446358163742029,0.0221402214022139
"United States","Maine","ME",2020-05-03,2020-05-09,7,2020,"19",1344212,293,8,272,21,285,0.595144218322705,1.5622535730971,0.0772058823529411
"United States","Maine","ME",2020-05-10,2020-05-16,7,2020,"20",1344212,256,6,271,-15,250,0.446358163742029,-1.11589540935507,-0.0553505535055351
"United States","Maine","ME",2020-05-17,2020-05-23,7,2020,"21",1344212,267,7,267,0,260,0.520751191032367,0,0
"United States","Maine","ME",2020-05-24,2020-05-30,7,2020,"22",1344212,302,12,267,35,290,0.892716327484057,2.60375595516183,0.131086142322097
"United States","Maine","ME",2020-05-31,2020-06-06,7,2020,"23",1344212,255,9,268,-13,246,0.669537245613043,-0.967109354774396,-0.0485074626865671
"United States","Maine","ME",2020-06-07,2020-06-13,7,2020,"24",1344212,254,2,270,-16,252,0.148786054580676,-1.19028843664541,-0.0592592592592592
"United States","Maine","ME",2020-06-14,2020-06-20,7,2020,"25",1344212,275,2,269,6,273,0.148786054580676,0.446358163742029,0.0223048327137547
"United States","Maine","ME",2020-06-21,2020-06-27,7,2020,"26",1344212,299,2,271,28,297,0.148786054580676,2.08300476412947,0.103321033210332
"United States","Maine","ME",2020-06-28,2020-07-04,7,2020,"27",1344212,280,5,273,7,275,0.371965136451691,0.520751191032367,0.0256410256410255
"United States","Maine","ME",2020-07-05,2020-07-11,7,2020,"28",1344212,289,5,274,15,284,0.371965136451691,1.11589540935507,0.0547445255474452
"United States","Maine","ME",2020-07-12,2020-07-18,7,2020,"29",1344212,294,3,267,27,291,0.223179081871014,2.00861173683913,0.101123595505618
"United States","Maine","ME",2020-07-19,2020-07-25,7,2020,"30",1344212,282,2,268,14,280,0.148786054580676,1.04150238206473,0.0522388059701493
"United States","Maine","ME",2020-07-26,2020-08-01,7,2020,"31",1344212,283,4,274,9,279,0.297572109161353,0.669537245613043,0.0328467153284671
"United States","Maine","ME",2020-08-02,2020-08-08,7,2020,"32",1344212,276,2,272,4,274,0.148786054580676,0.297572109161353,0.0147058823529411
"United States","Maine","ME",2020-08-09,2020-08-15,7,2020,"33",1344212,280,2,270,10,278,0.148786054580676,0.743930272903381,0.037037037037037
"United States","Maine","ME",2020-08-16,2020-08-22,7,2020,"34",1344212,312,3,273,39,309,0.223179081871014,2.90132806432319,0.142857142857143
"United States","Maine","ME",2020-08-23,2020-08-29,7,2020,"35",1344212,285,2,271,14,283,0.148786054580676,1.04150238206473,0.051660516605166
"United States","Maine","ME",2020-08-30,2020-09-05,7,2020,"36",1344212,289,2,271,18,287,0.148786054580676,1.33907449122609,0.0664206642066421
"United States","Maine","ME",2020-09-06,2020-09-12,7,2020,"37",1344212,319,0,274,45,319,0,3.34768622806522,0.164233576642336
"United States","Maine","ME",2020-09-13,2020-09-19,7,2020,"38",1344212,299,5,280,19,294,0.371965136451691,1.41346751851642,0.0678571428571428
"United States","Maine","ME",2020-09-20,2020-09-26,7,2020,"39",1344212,309,1,282,27,308,0.0743930272903381,2.00861173683913,0.0957446808510638
"United States","Maine","ME",2020-09-27,2020-10-03,7,2020,"40",1344212,289,2,288,1,287,0.148786054580676,0.0743930272903381,0.00347222222222232
"United States","Maine","ME",2020-10-04,2020-10-10,7,2020,"41",1344212,302,1,285,17,301,0.0743930272903381,1.26468146393575,0.0596491228070175
"United States","Maine","ME",2020-10-11,2020-10-17,7,2020,"42",1344212,275,3,283,-8,272,0.223179081871014,-0.595144218322705,-0.0282685512367491
"United States","Maine","ME",2020-10-18,2020-10-24,7,2020,"43",1344212,275,0,286,-11,275,0,-0.818323300193719,-0.0384615384615384
"United States","Maine","ME",2020-10-25,2020-10-31,7,2020,"44",1344212,275,1,287,-12,274,0.0743930272903381,-0.892716327484057,-0.0418118466898955
"United States","Maine","ME",2020-11-01,2020-11-07,7,2020,"45",1344212,334,5,287,47,329,0.371965136451691,3.49647228264589,0.163763066202091
"United States","Maine","ME",2020-11-08,2020-11-14,7,2020,"46",1344212,323,11,289,34,312,0.818323300193719,2.5293629278715,0.117647058823529
"United States","Maine","ME",2020-11-15,2020-11-21,7,2020,"47",1344212,307,13,300,7,294,0.967109354774396,0.520751191032367,0.0233333333333334
"United States","Maine","ME",2020-11-22,2020-11-28,7,2020,"48",1344212,349,15,300,49,334,1.11589540935507,3.64525833722657,0.163333333333333
"United States","Maine","ME",2020-11-29,2020-12-05,7,2020,"49",1344212,342,35,304,38,307,2.60375595516183,2.82693503703285,0.125
"United States","Maine","ME",2020-12-06,2020-12-12,7,2020,"50",1344212,353,31,304,49,322,2.30618384600048,3.64525833722657,0.161184210526316
"United States","Maine","ME",2020-12-13,2020-12-19,7,2020,"51",1344212,324,35,303,21,289,2.60375595516183,1.5622535730971,0.0693069306930694
"United States","Maine","ME",2020-12-20,2020-12-26,7,2020,"52",1344212,347,27,303,44,320,2.00861173683913,3.27329320077488,0.145214521452145
"United States","Maine","ME",2020-12-27,2021-01-02,7,2020,"53",1344212,355,116,307,48,239,8.62959116567922,3.57086530993623,0.156351791530945
"United States","Maine","ME",2021-01-03,2021-01-09,7,2021,"1",1344212,345,42,307,38,303,3.1245071461942,2.82693503703285,0.123778501628665
"United States","Maine","ME",2021-01-10,2021-01-16,7,2021,"2",1344212,362,62,306,56,300,4.61236769200096,4.16600952825894,0.183006535947712
"United States","Maine","ME",2021-01-17,2021-01-23,7,2021,"3",1344212,335,52,306,29,283,3.86843741909758,2.15739779141981,0.0947712418300655
"United States","Maine","ME",2021-01-24,2021-01-30,7,2021,"4",1344212,356,36,304,52,320,2.67814898245217,3.86843741909758,0.171052631578947
"United States","Maine","ME",2021-01-31,2021-02-06,7,2021,"5",1344212,302,8,305,-3,294,0.595144218322705,-0.223179081871014,-0.00983606557377048
"United States","Maine","ME",2021-02-07,2021-02-13,7,2021,"6",1344212,327,13,300,27,314,0.967109354774396,2.00861173683913,0.0900000000000001
"United States","Maine","ME",2021-02-14,2021-02-20,7,2021,"7",1344212,289,11,302,-13,278,0.818323300193719,-0.967109354774396,-0.043046357615894
"United States","Maine","ME",2021-02-21,2021-02-27,7,2021,"8",1344212,283,44,303,-20,239,3.27329320077488,-1.48786054580676,-0.066006600660066
"United States","Maine","ME",2021-02-28,2021-03-06,7,2021,"9",1344212,331,4,307,24,327,0.297572109161353,1.78543265496811,0.0781758957654723
"United States","Maine","ME",2021-03-07,2021-03-13,7,2021,"10",1344212,287,17,307,-20,270,1.26468146393575,-1.48786054580676,-0.0651465798045603
"United States","Maine","ME",2021-03-14,2021-03-20,7,2021,"11",1344212,249,4,311,-62,245,0.297572109161353,-4.61236769200096,-0.19935691318328
"United States","Maine","ME",2021-03-21,2021-03-27,7,2021,"12",1344212,269,8,309,-40,261,0.595144218322705,-2.97572109161353,-0.129449838187702
"United States","Maine","ME",2021-03-28,2021-04-03,7,2021,"13",1344212,312,9,311,1,303,0.669537245613043,0.0743930272903381,0.00321543408360125
"United States","Maine","ME",2021-04-04,2021-04-10,7,2021,"14",1344212,289,5,306,-17,284,0.371965136451691,-1.26468146393575,-0.0555555555555556
"United States","Maine","ME",2021-04-11,2021-04-17,7,2021,"15",1344212,311,14,305,6,297,1.04150238206473,0.446358163742029,0.019672131147541
"United States","Maine","ME",2021-04-18,2021-04-24,7,2021,"16",1344212,293,8,301,-8,285,0.595144218322705,-0.595144218322705,-0.0265780730897009
"United States","Maine","ME",2021-04-25,2021-05-01,7,2021,"17",1344212,306,17,291,15,289,1.26468146393575,1.11589540935507,0.0515463917525774
"United States","Maine","ME",2021-05-02,2021-05-08,7,2021,"18",1344212,298,6,285,13,292,0.446358163742029,0.967109354774396,0.0456140350877192
"United States","Maine","ME",2021-05-09,2021-05-15,7,2021,"19",1344212,297,6,283,14,291,0.446358163742029,1.04150238206473,0.0494699646643109
"United States","Maine","ME",2021-05-16,2021-05-22,7,2021,"20",1344212,340,18,277,63,322,1.33907449122609,4.6867607192913,0.227436823104693
"United States","Maine","ME",2021-05-23,2021-05-29,7,2021,"21",1344212,316,6,272,44,310,0.446358163742029,3.27329320077488,0.161764705882353
"United States","Maine","ME",2021-05-30,2021-06-05,7,2021,"22",1344212,298,14,275,23,284,1.04150238206473,1.71103962767778,0.0836363636363637
"United States","Maine","ME",2021-06-06,2021-06-12,7,2021,"23",1344212,327,6,275,52,321,0.446358163742029,3.86843741909758,0.189090909090909
"United States","Maine","ME",2021-06-13,2021-06-19,7,2021,"24",1344212,297,9,280,17,288,0.669537245613043,1.26468146393575,0.0607142857142857
"United States","Maine","ME",2021-06-20,2021-06-26,7,2021,"25",1344212,319,4,279,40,315,0.297572109161353,2.97572109161353,0.14336917562724
"United States","Maine","ME",2021-06-27,2021-07-03,7,2021,"26",1344212,319,2,281,38,317,0.148786054580676,2.82693503703285,0.135231316725979
"United States","Maine","ME",2021-07-04,2021-07-10,7,2021,"27",1344212,323,2,285,38,321,0.148786054580676,2.82693503703285,0.133333333333333
"United States","Maine","ME",2021-07-11,2021-07-17,7,2021,"28",1344212,309,20,283,26,289,1.48786054580676,1.93421870954879,0.0918727915194346
"United States","Maine","ME",2021-07-18,2021-07-24,7,2021,"29",1344212,290,15,277,13,275,1.11589540935507,0.967109354774396,0.0469314079422383
"United States","Maine","ME",2021-07-25,2021-07-31,7,2021,"30",1344212,286,3,282,4,283,0.223179081871014,0.297572109161353,0.0141843971631206
"United States","Maine","ME",2021-08-01,2021-08-07,7,2021,"31",1344212,269,1,282,-13,268,0.0743930272903381,-0.967109354774396,-0.0460992907801419
"United States","Maryland","MD",2019-12-29,2020-01-04,7,2020,"1",6045680,1049,0,1101,-52,1049,0,-0.860118299347633,-0.0472297910990009
"United States","Maryland","MD",2020-01-05,2020-01-11,7,2020,"2",6045680,1035,0,1088,-53,1035,0,-0.876659035873549,-0.0487132352941176
"United States","Maryland","MD",2020-01-12,2020-01-18,7,2020,"3",6045680,988,0,1089,-101,988,0,-1.67061438911752,-0.0927456382001837
"United States","Maryland","MD",2020-01-19,2020-01-25,7,2020,"4",6045680,1003,0,1080,-77,1003,0,-1.27363671249553,-0.0712962962962963
"United States","Maryland","MD",2020-01-26,2020-02-01,7,2020,"5",6045680,1034,0,1081,-47,1034,0,-0.777414616718053,-0.0434782608695652
"United States","Maryland","MD",2020-02-02,2020-02-08,7,2020,"6",6045680,1004,0,1069,-65,1004,0,-1.07514787418454,-0.0608044901777361
"United States","Maryland","MD",2020-02-09,2020-02-15,7,2020,"7",6045680,1019,0,1056,-37,1019,0,-0.612007251458893,-0.0350378787878788
"United States","Maryland","MD",2020-02-16,2020-02-22,7,2020,"8",6045680,973,0,1050,-77,973,0,-1.27363671249553,-0.0733333333333334
"United States","Maryland","MD",2020-02-23,2020-02-29,7,2020,"9",6045680,1082,0,1041,41,1082,0,0.678170197562557,0.0393852065321807
"United States","Maryland","MD",2020-03-01,2020-03-07,7,2020,"10",6045680,1049,0,1023,26,1049,0,0.430059149673817,0.0254154447702835
"United States","Maryland","MD",2020-03-08,2020-03-14,7,2020,"11",6045680,1005,0,1003,2,1005,0,0.0330814730518321,0.0019940179461615
"United States","Maryland","MD",2020-03-15,2020-03-21,7,2020,"12",6045680,1064,3,995,69,1061,0.0496222095777481,1.14131082028821,0.0693467336683418
"United States","Maryland","MD",2020-03-22,2020-03-28,7,2020,"13",6045680,1092,7,997,95,1085,0.115785155681412,1.57136996996202,0.0952858575727182
"United States","Maryland","MD",2020-03-29,2020-04-04,7,2020,"14",6045680,1191,43,986,205,1148,0.711251670614389,3.39085098781279,0.207910750507099
"United States","Maryland","MD",2020-04-05,2020-04-11,7,2020,"15",6045680,1353,149,984,369,1204,2.46456974236149,6.10353177806301,0.375
"United States","Maryland","MD",2020-04-12,2020-04-18,7,2020,"16",6045680,1357,172,967,390,1185,2.84500668245756,6.45088724510725,0.403309203722854
"United States","Maryland","MD",2020-04-19,2020-04-25,7,2020,"17",6045680,1538,321,956,582,1217,5.30957642481904,9.62670865808313,0.608786610878661
"United States","Maryland","MD",2020-04-26,2020-05-02,7,2020,"18",6045680,1523,397,930,593,1126,6.56667240078866,9.8086567598682,0.637634408602151
"United States","Maryland","MD",2020-05-03,2020-05-09,7,2020,"19",6045680,1445,337,918,527,1108,5.5742282092337,8.71696814915775,0.574074074074074
"United States","Maryland","MD",2020-05-10,2020-05-16,7,2020,"20",6045680,1431,343,916,515,1088,5.6734726283892,8.51847931084675,0.562227074235808
"United States","Maryland","MD",2020-05-17,2020-05-23,7,2020,"21",6045680,1336,315,916,420,1021,5.21033200566355,6.94710934088473,0.458515283842795
"United States","Maryland","MD",2020-05-24,2020-05-30,7,2020,"22",6045680,1265,320,911,354,945,5.29303568829313,5.85542073017427,0.388583973655324
"United States","Maryland","MD",2020-05-31,2020-06-06,7,2020,"23",6045680,1167,361,918,249,806,5.97120588585569,4.11864339495309,0.271241830065359
"United States","Maryland","MD",2020-06-07,2020-06-13,7,2020,"24",6045680,1158,184,919,239,974,3.04349552076855,3.95323602969393,0.26006528835691
"United States","Maryland","MD",2020-06-14,2020-06-20,7,2020,"25",6045680,1070,141,923,147,929,2.33224385015416,2.43148826930966,0.159263271939328
"United States","Maryland","MD",2020-06-21,2020-06-27,7,2020,"26",6045680,1031,108,924,107,923,1.78639954479893,1.76985880827301,0.115800865800866
"United States","Maryland","MD",2020-06-28,2020-07-04,7,2020,"27",6045680,1051,79,927,124,972,1.30671818554737,2.05105132921359,0.133764832793959
"United States","Maryland","MD",2020-07-05,2020-07-11,7,2020,"28",6045680,1031,79,921,110,952,1.30671818554737,1.81948101785076,0.119435396308361
"United States","Maryland","MD",2020-07-12,2020-07-18,7,2020,"29",6045680,1026,69,916,110,957,1.14131082028821,1.81948101785076,0.120087336244541
"United States","Maryland","MD",2020-07-19,2020-07-25,7,2020,"30",6045680,1002,63,908,94,939,1.04206640113271,1.55482923343611,0.10352422907489
"United States","Maryland","MD",2020-07-26,2020-08-01,7,2020,"31",6045680,1067,66,911,156,1001,1.09168861071046,2.5803548980429,0.171240395170143
"United States","Maryland","MD",2020-08-02,2020-08-08,7,2020,"32",6045680,1007,69,909,98,938,1.14131082028821,1.62099217953977,0.107810781078108
"United States","Maryland","MD",2020-08-09,2020-08-15,7,2020,"33",6045680,1064,65,924,140,999,1.07514787418454,2.31570311362824,0.151515151515152
"United States","Maryland","MD",2020-08-16,2020-08-22,7,2020,"34",6045680,1002,48,916,86,954,0.793955353243969,1.42250334122878,0.0938864628820961
"United States","Maryland","MD",2020-08-23,2020-08-29,7,2020,"35",6045680,1040,62,924,116,978,1.02552566460679,1.91872543700626,0.125541125541126
"United States","Maryland","MD",2020-08-30,2020-09-05,7,2020,"36",6045680,1046,53,931,115,993,0.876659035873549,1.90218470048034,0.123523093447905
"United States","Maryland","MD",2020-09-06,2020-09-12,7,2020,"37",6045680,996,38,913,83,958,0.628547987984809,1.37288113165103,0.0909090909090908
"United States","Maryland","MD",2020-09-13,2020-09-19,7,2020,"38",6045680,991,40,915,76,951,0.661629461036641,1.25709597596962,0.0830601092896175
"United States","Maryland","MD",2020-09-20,2020-09-26,7,2020,"39",6045680,1071,49,930,141,1022,0.810496089769885,2.33224385015416,0.151612903225806
"United States","Maryland","MD",2020-09-27,2020-10-03,7,2020,"40",6045680,1074,31,937,137,1043,0.512762832303397,2.2660809040505,0.146211312700107
"United States","Maryland","MD",2020-10-04,2020-10-10,7,2020,"41",6045680,1086,34,938,148,1052,0.562385041881145,2.44802900583557,0.157782515991471
"United States","Maryland","MD",2020-10-11,2020-10-17,7,2020,"42",6045680,1052,49,953,99,1003,0.810496089769885,1.63753291606569,0.103882476390346
"United States","Maryland","MD",2020-10-18,2020-10-24,7,2020,"43",6045680,1101,45,948,153,1056,0.744333143666221,2.53073268846515,0.161392405063291
"United States","Maryland","MD",2020-10-25,2020-10-31,7,2020,"44",6045680,1071,58,960,111,1013,0.959362718503129,1.83602175437668,0.115625
"United States","Maryland","MD",2020-11-01,2020-11-07,7,2020,"45",6045680,1088,56,972,116,1032,0.926281245451298,1.91872543700626,0.119341563786008
"United States","Maryland","MD",2020-11-08,2020-11-14,7,2020,"46",6045680,1106,80,978,128,1026,1.32325892207328,2.11721427531725,0.130879345603272
"United States","Maryland","MD",2020-11-15,2020-11-21,7,2020,"47",6045680,1224,130,985,239,1094,2.15029574836908,3.95323602969393,0.242639593908629
"United States","Maryland","MD",2020-11-22,2020-11-28,7,2020,"48",6045680,1185,161,998,187,1024,2.66305858067248,3.0931177303463,0.187374749498998
"United States","Maryland","MD",2020-11-29,2020-12-05,7,2020,"49",6045680,1258,221,995,263,1037,3.65550277222744,4.35021370631591,0.264321608040201
"United States","Maryland","MD",2020-12-06,2020-12-12,7,2020,"50",6045680,1378,276,1023,355,1102,4.56524328115282,5.87196146670019,0.347018572825024
"United States","Maryland","MD",2020-12-13,2020-12-19,7,2020,"51",6045680,1432,305,1034,398,1127,5.04492464040439,6.58321313731458,0.384912959381045
"United States","Maryland","MD",2020-12-20,2020-12-26,7,2020,"52",6045680,1337,280,1047,290,1057,4.63140622725649,4.79681359251565,0.276981852913085
"United States","Maryland","MD",2020-12-27,2021-01-02,7,2020,"53",6045680,1477,275,1057,420,1202,4.54870254462691,6.94710934088473,0.397350993377483
"United States","Maryland","MD",2021-01-03,2021-01-09,7,2021,"1",6045680,1364,287,1061,303,1077,4.7471913829379,5.01184316735256,0.285579641847314
"United States","Maryland","MD",2021-01-10,2021-01-16,7,2021,"2",6045680,1426,271,1075,351,1155,4.48253959852324,5.80579852059653,0.326511627906977
"United States","Maryland","MD",2021-01-17,2021-01-23,7,2021,"3",6045680,1366,309,1072,294,1057,5.11108758650805,4.86297653861931,0.274253731343284
"United States","Maryland","MD",2021-01-24,2021-01-30,7,2021,"4",6045680,1321,286,1063,258,1035,4.73065064641198,4.26751002368633,0.242709313264346
"United States","Maryland","MD",2021-01-31,2021-02-06,7,2021,"5",6045680,1273,147,1067,206,1126,2.43148826930966,3.4073917243387,0.193064667291471
"United States","Maryland","MD",2021-02-07,2021-02-13,7,2021,"6",6045680,1295,202,1073,222,1093,3.34122877823504,3.67204350875336,0.206896551724138
"United States","Maryland","MD",2021-02-14,2021-02-20,7,2021,"7",6045680,1170,159,1054,116,1011,2.62997710762065,1.91872543700626,0.110056925996205
"United States","Maryland","MD",2021-02-21,2021-02-27,7,2021,"8",6045680,1184,164,1048,136,1020,2.71268079025023,2.24954016752458,0.129770992366412
"United States","Maryland","MD",2021-02-28,2021-03-06,7,2021,"9",6045680,1152,86,1045,107,1066,1.42250334122878,1.76985880827301,0.102392344497608
"United States","Maryland","MD",2021-03-07,2021-03-13,7,2021,"10",6045680,1102,102,1047,55,1000,1.68715512564343,0.909740508925381,0.0525310410697231
"United States","Maryland","MD",2021-03-14,2021-03-20,7,2021,"11",6045680,1150,122,1031,119,1028,2.01796985616176,1.96834764658401,0.115421920465567
"United States","Maryland","MD",2021-03-21,2021-03-27,7,2021,"12",6045680,1120,81,1027,93,1039,1.3397996585992,1.53828849691019,0.0905550146056475
"United States","Maryland","MD",2021-03-28,2021-04-03,7,2021,"13",6045680,1069,81,1026,43,988,1.3397996585992,0.711251670614389,0.0419103313840157
"United States","Maryland","MD",2021-04-04,2021-04-10,7,2021,"14",6045680,1165,103,1008,157,1062,1.70369586216935,2.59689563456882,0.155753968253968
"United States","Maryland","MD",2021-04-11,2021-04-17,7,2021,"15",6045680,1042,101,1003,39,941,1.67061438911752,0.645088724510725,0.0388833499501495
"United States","Maryland","MD",2021-04-18,2021-04-24,7,2021,"16",6045680,1110,109,981,129,1001,1.80294028132485,2.13375501184317,0.131498470948012
"United States","Maryland","MD",2021-04-25,2021-05-01,7,2021,"17",6045680,1086,97,974,112,989,1.60445144301385,1.8525624909026,0.114989733059548
"United States","Maryland","MD",2021-05-02,2021-05-08,7,2021,"18",6045680,1024,110,952,72,914,1.81948101785076,1.19093302986595,0.0756302521008403
"United States","Maryland","MD",2021-05-09,2021-05-15,7,2021,"19",6045680,1059,71,946,113,988,1.17439229334004,1.86910322742851,0.119450317124736
"United States","Maryland","MD",2021-05-16,2021-05-22,7,2021,"20",6045680,1017,80,925,92,937,1.32325892207328,1.52174776038427,0.0994594594594596
"United States","Maryland","MD",2021-05-23,2021-05-29,7,2021,"21",6045680,1038,612,933,105,426,10.1229307538606,1.73677733522118,0.112540192926045
"United States","Maryland","MD",2021-05-30,2021-06-05,7,2021,"22",6045680,1027,41,931,96,986,0.678170197562557,1.58791070648794,0.103114930182599
"United States","Maryland","MD",2021-06-06,2021-06-12,7,2021,"23",6045680,907,48,935,-28,859,0.793955353243969,-0.463140622725649,-0.0299465240641711
"United States","Maryland","MD",2021-06-13,2021-06-19,7,2021,"24",6045680,957,33,940,17,924,0.545844305355229,0.281192520940572,0.0180851063829788
"United States","Maryland","MD",2021-06-20,2021-06-26,7,2021,"25",6045680,923,30,946,-23,893,0.496222095777481,-0.380436940096069,-0.0243128964059197
"United States","Maryland","MD",2021-06-27,2021-07-03,7,2021,"26",6045680,990,17,937,53,973,0.281192520940572,0.876659035873549,0.056563500533618
"United States","Maryland","MD",2021-07-04,2021-07-10,7,2021,"27",6045680,887,15,942,-55,872,0.24811104788874,-0.909740508925381,-0.0583864118895966
"United States","Maryland","MD",2021-07-11,2021-07-17,7,2021,"28",6045680,936,18,942,-6,918,0.297733257466488,-0.0992444191554961,-0.00636942675159236
"United States","Maryland","MD",2021-07-18,2021-07-24,7,2021,"29",6045680,945,23,940,5,922,0.380436940096069,0.0827036826295801,0.00531914893617014
"United States","Maryland","MD",2021-07-25,2021-07-31,7,2021,"30",6045680,946,15,932,14,931,0.24811104788874,0.231570311362824,0.0150214592274678
"United States","Maryland","MD",2021-08-01,2021-08-07,7,2021,"31",6045680,835,27,926,-91,808,0.446599886199733,-1.50520702385836,-0.0982721382289417
"United States","Massachusetts","MA",2019-12-29,2020-01-04,7,2020,"1",6949503,1242,0,1369,-127,1242,0,-1.82746881323744,-0.0927684441197955
"United States","Massachusetts","MA",2020-01-05,2020-01-11,7,2020,"2",6949503,1267,0,1372,-105,1267,0,-1.51089941251914,-0.076530612244898
"United States","Massachusetts","MA",2020-01-12,2020-01-18,7,2020,"3",6949503,1189,0,1377,-188,1189,0,-2.70522942431998,-0.136528685548293
"United States","Massachusetts","MA",2020-01-19,2020-01-25,7,2020,"4",6949503,1302,0,1358,-56,1302,0,-0.805813020010208,-0.0412371134020618
"United States","Massachusetts","MA",2020-01-26,2020-02-01,7,2020,"5",6949503,1204,0,1330,-126,1204,0,-1.81307929502297,-0.0947368421052631
"United States","Massachusetts","MA",2020-02-02,2020-02-08,7,2020,"6",6949503,1233,0,1305,-72,1233,0,-1.0360453114417,-0.0551724137931034
"United States","Massachusetts","MA",2020-02-09,2020-02-15,7,2020,"7",6949503,1251,0,1289,-38,1251,0,-0.546801692149784,-0.0294802172226533
"United States","Massachusetts","MA",2020-02-16,2020-02-22,7,2020,"8",6949503,1166,0,1274,-108,1166,0,-1.55406796716254,-0.0847723704866562
"United States","Massachusetts","MA",2020-02-23,2020-02-29,7,2020,"9",6949503,1278,0,1252,26,1278,0,0.374127473576168,0.0207667731629393
"United States","Massachusetts","MA",2020-03-01,2020-03-07,7,2020,"10",6949503,1216,0,1251,-35,1216,0,-0.50363313750638,-0.0279776179056754
"United States","Massachusetts","MA",2020-03-08,2020-03-14,7,2020,"11",6949503,1311,0,1241,70,1311,0,1.00726627501276,0.056406124093473
"United States","Massachusetts","MA",2020-03-15,2020-03-21,7,2020,"12",6949503,1170,2,1233,-63,1168,0.028779036428936,-0.906539647511484,-0.051094890510949
"United States","Massachusetts","MA",2020-03-22,2020-03-28,7,2020,"13",6949503,1290,42,1227,63,1248,0.604359765007656,0.906539647511484,0.0513447432762837
"United States","Massachusetts","MA",2020-03-29,2020-04-04,7,2020,"14",6949503,1549,172,1217,332,1377,2.4749971328885,4.77732004720337,0.272801972062449
"United States","Massachusetts","MA",2020-04-05,2020-04-11,7,2020,"15",6949503,2038,470,1197,841,1568,6.76307356079996,12.1015848183676,0.702589807852966
"United States","Massachusetts","MA",2020-04-12,2020-04-18,7,2020,"16",6949503,2494,874,1191,1303,1620,12.576438919445,18.7495422334518,1.09403862300588
"United States","Massachusetts","MA",2020-04-19,2020-04-25,7,2020,"17",6949503,2535,1170,1176,1359,1365,16.8357363109276,19.555355253462,1.15561224489796
"United States","Massachusetts","MA",2020-04-26,2020-05-02,7,2020,"18",6949503,2310,1116,1157,1153,1194,16.0587023273463,16.5911145012816,0.996542783059637
"United States","Massachusetts","MA",2020-05-03,2020-05-09,7,2020,"19",6949503,2071,994,1139,932,1077,14.3031811051812,13.4110309758842,0.818261633011413
"United States","Massachusetts","MA",2020-05-10,2020-05-16,7,2020,"20",6949503,1886,865,1142,744,1021,12.4469332555148,10.7058015515642,0.651488616462347
"United States","Massachusetts","MA",2020-05-17,2020-05-23,7,2020,"21",6949503,1578,599,1128,450,979,8.61932141046633,6.4752831965106,0.398936170212766
"United States","Massachusetts","MA",2020-05-24,2020-05-30,7,2020,"22",6949503,1360,464,1116,244,896,6.67673645151315,3.51104244433019,0.218637992831541
"United States","Massachusetts","MA",2020-05-31,2020-06-06,7,2020,"23",6949503,1236,521,1114,122,715,7.49693898973783,1.7555212221651,0.10951526032316
"United States","Massachusetts","MA",2020-06-07,2020-06-13,7,2020,"24",6949503,1140,287,1112,28,853,4.12979172755232,0.402906510005104,0.025179856115108
"United States","Massachusetts","MA",2020-06-14,2020-06-20,7,2020,"25",6949503,1129,251,1109,20,878,3.61176907183147,0.28779036428936,0.0180342651036971
"United States","Massachusetts","MA",2020-06-21,2020-06-27,7,2020,"26",6949503,1084,214,1106,-22,870,3.07935689789615,-0.316569400718296,-0.0198915009041591
"United States","Massachusetts","MA",2020-06-28,2020-07-04,7,2020,"27",6949503,1048,130,1099,-51,918,1.87063736788084,-0.733865428937868,-0.0464058234758872
"United States","Massachusetts","MA",2020-07-05,2020-07-11,7,2020,"28",6949503,1047,139,1090,-43,908,2.00014303181105,-0.618749283222124,-0.0394495412844037
"United States","Massachusetts","MA",2020-07-12,2020-07-18,7,2020,"29",6949503,1060,109,1086,-26,951,1.56845748537701,-0.374127473576168,-0.0239410681399632
"United States","Massachusetts","MA",2020-07-19,2020-07-25,7,2020,"30",6949503,1089,91,1080,9,998,1.30944615751659,0.129505663930212,0.0083333333333333
"United States","Massachusetts","MA",2020-07-26,2020-08-01,7,2020,"31",6949503,1022,116,1080,-58,906,1.66918411287829,-0.834592056439144,-0.0537037037037037
"United States","Massachusetts","MA",2020-08-02,2020-08-08,7,2020,"32",6949503,996,95,1081,-85,901,1.36700423037446,-1.22310904822978,-0.0786308973172988
"United States","Massachusetts","MA",2020-08-09,2020-08-15,7,2020,"33",6949503,1049,99,1084,-35,950,1.42456230323233,-0.50363313750638,-0.0322878228782287
"United States","Massachusetts","MA",2020-08-16,2020-08-22,7,2020,"34",6949503,1037,101,1081,-44,936,1.45334133966127,-0.633138801436592,-0.0407030527289547
"United States","Massachusetts","MA",2020-08-23,2020-08-29,7,2020,"35",6949503,1059,115,1079,-20,944,1.65479459466382,-0.28779036428936,-0.0185356811862836
"United States","Massachusetts","MA",2020-08-30,2020-09-05,7,2020,"36",6949503,1014,80,1078,-64,934,1.15116145715744,-0.920929165725952,-0.0593692022263451
"United States","Massachusetts","MA",2020-09-06,2020-09-12,7,2020,"37",6949503,1012,80,1070,-58,932,1.15116145715744,-0.834592056439144,-0.0542056074766355
"United States","Massachusetts","MA",2020-09-13,2020-09-19,7,2020,"38",6949503,1094,99,1078,16,995,1.42456230323233,0.230232291431488,0.0148423005565863
"United States","Massachusetts","MA",2020-09-20,2020-09-26,7,2020,"39",6949503,1125,96,1089,36,1029,1.38139374858893,0.518022655720848,0.0330578512396693
"United States","Massachusetts","MA",2020-09-27,2020-10-03,7,2020,"40",6949503,1105,116,1096,9,989,1.66918411287829,0.129505663930212,0.00821167883211671
"United States","Massachusetts","MA",2020-10-04,2020-10-10,7,2020,"41",6949503,1101,80,1102,-1,1021,1.15116145715744,-0.014389518214468,-0.000907441016333888
"United States","Massachusetts","MA",2020-10-11,2020-10-17,7,2020,"42",6949503,1131,136,1111,20,995,1.95697447716765,0.28779036428936,0.018001800180018
"United States","Massachusetts","MA",2020-10-18,2020-10-24,7,2020,"43",6949503,1196,116,1128,68,1080,1.66918411287829,0.978487238583824,0.0602836879432624
"United States","Massachusetts","MA",2020-10-25,2020-10-31,7,2020,"44",6949503,1089,152,1138,-49,937,2.18720676859914,-0.705086392508932,-0.0430579964850615
"United States","Massachusetts","MA",2020-11-01,2020-11-07,7,2020,"45",6949503,1218,134,1149,69,1084,1.92819544073871,0.992876756798292,0.0600522193211488
"United States","Massachusetts","MA",2020-11-08,2020-11-14,7,2020,"46",6949503,1234,168,1140,94,1066,2.41743906003062,1.35261471215999,0.0824561403508772
"United States","Massachusetts","MA",2020-11-15,2020-11-21,7,2020,"47",6949503,1214,195,1157,57,1019,2.80595605182126,0.820202538224676,0.0492653414001729
"United States","Massachusetts","MA",2020-11-22,2020-11-28,7,2020,"48",6949503,1261,188,1156,105,1073,2.70522942431998,1.51089941251914,0.0908304498269896
"United States","Massachusetts","MA",2020-11-29,2020-12-05,7,2020,"49",6949503,1331,277,1171,160,1054,3.98589654540764,2.30232291431488,0.13663535439795
"United States","Massachusetts","MA",2020-12-06,2020-12-12,7,2020,"50",6949503,1351,354,1187,164,997,5.09388944792167,2.35988098717275,0.138163437236731
"United States","Massachusetts","MA",2020-12-13,2020-12-19,7,2020,"51",6949503,1426,350,1204,222,1076,5.0363313750638,3.1944730436119,0.184385382059801
"United States","Massachusetts","MA",2020-12-20,2020-12-26,7,2020,"52",6949503,1552,60,1198,354,1492,0.86337109286808,5.09388944792167,0.295492487479132
"United States","Massachusetts","MA",2020-12-27,2021-01-02,7,2020,"53",6949503,1524,785,1236,288,739,11.2957717983574,4.14418124576678,0.233009708737864
"United States","Massachusetts","MA",2021-01-03,2021-01-09,7,2021,"1",6949503,1556,572,1250,306,984,8.2308044186757,4.40319257362721,0.2448
"United States","Massachusetts","MA",2021-01-10,2021-01-16,7,2021,"2",6949503,1558,509,1252,306,1049,7.32426477116421,4.40319257362721,0.244408945686901
"United States","Massachusetts","MA",2021-01-17,2021-01-23,7,2021,"3",6949503,1523,481,1267,256,1042,6.92135826115911,3.68371666290381,0.202052091554854
"United States","Massachusetts","MA",2021-01-24,2021-01-30,7,2021,"4",6949503,1568,467,1262,306,1101,6.71990500615656,4.40319257362721,0.242472266244057
"United States","Massachusetts","MA",2021-01-31,2021-02-06,7,2021,"5",6949503,1501,390,1247,254,1111,5.61191210364252,3.65493762647487,0.203688853247795
"United States","Massachusetts","MA",2021-02-07,2021-02-13,7,2021,"6",6949503,1362,503,1244,118,859,7.2379276618774,1.69796314930722,0.094855305466238
"United States","Massachusetts","MA",2021-02-14,2021-02-20,7,2021,"7",6949503,1341,355,1233,108,986,5.10827896613614,1.55406796716254,0.0875912408759123
"United States","Massachusetts","MA",2021-02-21,2021-02-27,7,2021,"8",6949503,1275,288,1227,48,987,4.14418124576678,0.690696874294464,0.039119804400978
"United States","Massachusetts","MA",2021-02-28,2021-03-06,7,2021,"9",6949503,1226,307,1199,27,919,4.41758209184168,0.388516991790636,0.0225187656380317
"United States","Massachusetts","MA",2021-03-07,2021-03-13,7,2021,"10",6949503,1218,206,1184,34,1012,2.96424075218041,0.489243619291912,0.0287162162162162
"United States","Massachusetts","MA",2021-03-14,2021-03-20,7,2021,"11",6949503,1207,252,1182,25,955,3.62615859004594,0.3597379553617,0.021150592216582
"United States","Massachusetts","MA",2021-03-21,2021-03-27,7,2021,"12",6949503,1152,219,1175,-23,933,3.15130448896849,-0.330958918932764,-0.0195744680851064
"United States","Massachusetts","MA",2021-03-28,2021-04-03,7,2021,"13",6949503,1124,230,1178,-54,894,3.30958918932764,-0.777033983581272,-0.0458404074702886
"United States","Massachusetts","MA",2021-04-04,2021-04-10,7,2021,"14",6949503,1121,98,1171,-50,1023,1.41017278501786,-0.7194759107234,-0.0426985482493595
"United States","Massachusetts","MA",2021-04-11,2021-04-17,7,2021,"15",6949503,1144,76,1151,-7,1068,1.09360338429957,-0.100726627501276,-0.00608166811468291
"United States","Massachusetts","MA",2021-04-18,2021-04-24,7,2021,"16",6949503,1107,89,1141,-34,1018,1.28066712108765,-0.489243619291912,-0.0297984224364592
"United States","Massachusetts","MA",2021-04-25,2021-05-01,7,2021,"17",6949503,1122,73,1118,4,1049,1.05043482965616,0.057558072857872,0.00357781753130593
"United States","Massachusetts","MA",2021-05-02,2021-05-08,7,2021,"18",6949503,1145,59,1099,46,1086,0.848981574653612,0.661917837865528,0.0418562329390355
"United States","Massachusetts","MA",2021-05-09,2021-05-15,7,2021,"19",6949503,1110,66,1096,14,1044,0.949708202154888,0.201453255002552,0.0127737226277371
"United States","Massachusetts","MA",2021-05-16,2021-05-22,7,2021,"20",6949503,1169,76,1096,73,1093,1.09360338429957,1.05043482965616,0.0666058394160585
"United States","Massachusetts","MA",2021-05-23,2021-05-29,7,2021,"21",6949503,1077,50,1087,-10,1027,0.7194759107234,-0.14389518214468,-0.00919963201471941
"United States","Massachusetts","MA",2021-05-30,2021-06-05,7,2021,"22",6949503,1084,39,1085,-1,1045,0.561191210364252,-0.014389518214468,-0.000921658986175133
"United States","Massachusetts","MA",2021-06-06,2021-06-12,7,2021,"23",6949503,1088,30,1081,7,1058,0.43168554643404,0.100726627501276,0.00647548566142464
"United States","Massachusetts","MA",2021-06-13,2021-06-19,7,2021,"24",6949503,1025,23,1082,-57,1002,0.330958918932764,-0.820202538224676,-0.0526802218114603
"United States","Massachusetts","MA",2021-06-20,2021-06-26,7,2021,"25",6949503,1072,25,1075,-3,1047,0.3597379553617,-0.043168554643404,-0.00279069767441864
"United States","Massachusetts","MA",2021-06-27,2021-07-03,7,2021,"26",6949503,1061,12,1079,-18,1049,0.172674218573616,-0.259011327860424,-0.0166821130676552
"United States","Massachusetts","MA",2021-07-04,2021-07-10,7,2021,"27",6949503,1136,15,1071,65,1121,0.21584277321702,0.93531868394042,0.0606909430438842
"United States","Massachusetts","MA",2021-07-11,2021-07-17,7,2021,"28",6949503,1013,8,1070,-57,1005,0.115116145715744,-0.820202538224676,-0.0532710280373832
"United States","Massachusetts","MA",2021-07-18,2021-07-24,7,2021,"29",6949503,1095,26,1078,17,1069,0.374127473576168,0.244621809645956,0.015769944341373
"United States","Massachusetts","MA",2021-07-25,2021-07-31,7,2021,"30",6949503,1081,36,1073,8,1045,0.518022655720848,0.115116145715744,0.00745573159366253
"United States","Massachusetts","MA",2021-08-01,2021-08-07,7,2021,"31",6949503,1033,13,1072,-39,1020,0.187063736788084,-0.561191210364252,-0.0363805970149254
"United States","Michigan","MI",2019-12-29,2020-01-04,7,2020,"1",9986857,2015,0,2122,-107,2015,0,-1.07140815173382,-0.0504241281809613
"United States","Michigan","MI",2020-01-05,2020-01-11,7,2020,"2",9986857,2065,0,2134,-69,2065,0,-0.690908060463868,-0.0323336457357076
"United States","Michigan","MI",2020-01-12,2020-01-18,7,2020,"3",9986857,1936,0,2119,-183,1936,0,-1.83240833427374,-0.0863614912694667
"United States","Michigan","MI",2020-01-19,2020-01-25,7,2020,"4",9986857,2012,0,2101,-89,2012,0,-0.891171266395424,-0.0423607805806758
"United States","Michigan","MI",2020-01-26,2020-02-01,7,2020,"5",9986857,2004,0,2077,-73,2004,0,-0.730960701650179,-0.0351468464130958
"United States","Michigan","MI",2020-02-02,2020-02-08,7,2020,"6",9986857,1940,0,2065,-125,1940,0,-1.25164503707222,-0.0605326876513317
"United States","Michigan","MI",2020-02-09,2020-02-15,7,2020,"7",9986857,2014,0,2053,-39,2014,0,-0.390513251566534,-0.0189965903555772
"United States","Michigan","MI",2020-02-16,2020-02-22,7,2020,"8",9986857,2056,0,2053,3,2056,0,0.0300394808897334,0.00146127618119829
"United States","Michigan","MI",2020-02-23,2020-02-29,7,2020,"9",9986857,1973,0,2037,-64,1973,0,-0.640842258980979,-0.0314187530682376
"United States","Michigan","MI",2020-03-01,2020-03-07,7,2020,"10",9986857,1988,0,2019,-31,1988,0,-0.310407969193912,-0.0153541357107478
"United States","Michigan","MI",2020-03-08,2020-03-14,7,2020,"11",9986857,1955,0,2020,-65,1955,0,-0.650855419277557,-0.0321782178217822
"United States","Michigan","MI",2020-03-15,2020-03-21,7,2020,"12",9986857,2036,5,2004,32,2031,0.050065801482889,0.320421129490489,0.0159680638722555
"United States","Michigan","MI",2020-03-22,2020-03-28,7,2020,"13",9986857,2432,99,2013,419,2333,0.991302869361201,4.1955141642661,0.208147044212618
"United States","Michigan","MI",2020-03-29,2020-04-04,7,2020,"14",9986857,3117,436,1990,1127,2681,4.36573788930792,11.2848316542432,0.566331658291457
"United States","Michigan","MI",2020-04-05,2020-04-11,7,2020,"15",9986857,3385,851,1971,1414,2534,8.5211994123877,14.158608659361,0.71740233384069
"United States","Michigan","MI",2020-04-12,2020-04-18,7,2020,"16",9986857,3159,918,1946,1213,2241,9.19208115225841,12.1459634397489,0.623329907502569
"United States","Michigan","MI",2020-04-19,2020-04-25,7,2020,"17",9986857,2806,966,1919,887,1840,9.67271284649415,8.8816731830645,0.462219906201147
"United States","Michigan","MI",2020-04-26,2020-05-02,7,2020,"18",9986857,2588,745,1888,700,1843,7.45980442095046,7.00921220760446,0.370762711864407
"United States","Michigan","MI",2020-05-03,2020-05-09,7,2020,"19",9986857,2241,505,1846,395,1736,5.05664594977179,3.95519831714823,0.21397616468039
"United States","Michigan","MI",2020-05-10,2020-05-16,7,2020,"20",9986857,2160,354,1831,329,1806,3.54465874498854,3.29432973757409,0.179683233205898
"United States","Michigan","MI",2020-05-17,2020-05-23,7,2020,"21",9986857,2012,340,1810,202,1672,3.40447450083645,2.02265837990871,0.111602209944751
"United States","Michigan","MI",2020-05-24,2020-05-30,7,2020,"22",9986857,1962,244,1808,154,1718,2.44321111236498,1.54202668567298,0.0851769911504425
"United States","Michigan","MI",2020-05-31,2020-06-06,7,2020,"23",9986857,2000,426,1804,196,1574,4.26560628634214,1.96257941812925,0.108647450110865
"United States","Michigan","MI",2020-06-07,2020-06-13,7,2020,"24",9986857,1860,122,1791,69,1738,1.22160555618249,0.690908060463868,0.0385259631490786
"United States","Michigan","MI",2020-06-14,2020-06-20,7,2020,"25",9986857,1885,75,1794,91,1810,0.750987022243334,0.911197586988579,0.0507246376811594
"United States","Michigan","MI",2020-06-21,2020-06-27,7,2020,"26",9986857,1918,67,1796,122,1851,0.670881739870712,1.22160555618249,0.0679287305122493
"United States","Michigan","MI",2020-06-28,2020-07-04,7,2020,"27",9986857,1984,65,1786,198,1919,0.650855419277557,1.9826057387224,0.110862262038074
"United States","Michigan","MI",2020-07-05,2020-07-11,7,2020,"28",9986857,1890,95,1771,119,1795,0.95125022817489,1.19156607529276,0.0671936758893281
"United States","Michigan","MI",2020-07-12,2020-07-18,7,2020,"29",9986857,1879,51,1768,111,1828,0.510671175125467,1.11146079292013,0.0627828054298643
"United States","Michigan","MI",2020-07-19,2020-07-25,7,2020,"30",9986857,1891,36,1766,125,1855,0.360473770676801,1.25164503707222,0.0707814269535674
"United States","Michigan","MI",2020-07-26,2020-08-01,7,2020,"31",9986857,1969,57,1771,198,1912,0.570750136904934,1.9826057387224,0.111801242236025
"United States","Michigan","MI",2020-08-02,2020-08-08,7,2020,"32",9986857,1868,63,1772,96,1805,0.630829098684401,0.961263388471468,0.0541760722347631
"United States","Michigan","MI",2020-08-09,2020-08-15,7,2020,"33",9986857,2025,66,1760,265,1959,0.660868579574134,2.65348747859312,0.150568181818182
"United States","Michigan","MI",2020-08-16,2020-08-22,7,2020,"34",9986857,1926,69,1753,173,1857,0.690908060463868,1.73227673130796,0.0986879634911579
"United States","Michigan","MI",2020-08-23,2020-08-29,7,2020,"35",9986857,1936,57,1742,194,1879,0.570750136904934,1.94255309753609,0.111366245694604
"United States","Michigan","MI",2020-08-30,2020-09-05,7,2020,"36",9986857,1959,94,1743,216,1865,0.941237067878313,2.1628426240608,0.123924268502582
"United States","Michigan","MI",2020-09-06,2020-09-12,7,2020,"37",9986857,1942,105,1746,196,1837,1.05138183114067,1.96257941812925,0.112256586483391
"United States","Michigan","MI",2020-09-13,2020-09-19,7,2020,"38",9986857,1905,58,1764,141,1847,0.580763297201512,1.41185560181747,0.0799319727891157
"United States","Michigan","MI",2020-09-20,2020-09-26,7,2020,"39",9986857,2006,75,1773,233,1931,0.750987022243334,2.33306634910263,0.13141567963903
"United States","Michigan","MI",2020-09-27,2020-10-03,7,2020,"40",9986857,2033,80,1785,248,1953,0.801052823726223,2.48326375355129,0.138935574229692
"United States","Michigan","MI",2020-10-04,2020-10-10,7,2020,"41",9986857,2146,95,1794,352,2051,0.95125022817489,3.52463242439538,0.196209587513935
"United States","Michigan","MI",2020-10-11,2020-10-17,7,2020,"42",9986857,2029,121,1805,224,1908,1.21159239588591,2.24294790643343,0.12409972299169
"United States","Michigan","MI",2020-10-18,2020-10-24,7,2020,"43",9986857,2207,182,1829,378,2025,1.82239517397716,3.78497459210641,0.206670311645708
"United States","Michigan","MI",2020-10-25,2020-10-31,7,2020,"44",9986857,2176,174,1831,345,2002,1.74228989160454,3.45454030231934,0.188421627525942
"United States","Michigan","MI",2020-11-01,2020-11-07,7,2020,"45",9986857,2347,181,1845,502,2166,1.81238201368058,5.02660646888205,0.272086720867209
"United States","Michigan","MI",2020-11-08,2020-11-14,7,2020,"46",9986857,2427,494,1839,588,1933,4.94650118650943,5.88773825438774,0.31973898858075
"United States","Michigan","MI",2020-11-15,2020-11-21,7,2020,"47",9986857,2623,503,1846,777,2120,5.03661962917863,7.78022555044094,0.420910075839653
"United States","Michigan","MI",2020-11-22,2020-11-28,7,2020,"48",9986857,2661,588,1844,817,2073,5.88773825438774,8.18075196230406,0.443058568329718
"United States","Michigan","MI",2020-11-29,2020-12-05,7,2020,"49",9986857,2805,855,1858,947,1950,8.56125205357401,9.48246280085917,0.509687836383208
"United States","Michigan","MI",2020-12-06,2020-12-12,7,2020,"50",9986857,2958,878,1862,1096,2080,8.7915547403953,10.9744236850493,0.588614393125671
"United States","Michigan","MI",2020-12-13,2020-12-19,7,2020,"51",9986857,2766,878,1883,883,1888,8.7915547403953,8.84162054187819,0.468932554434413
"United States","Michigan","MI",2020-12-20,2020-12-26,7,2020,"52",9986857,2633,616,1907,726,2017,6.16810674269192,7.26955437531548,0.38070267435763
"United States","Michigan","MI",2020-12-27,2021-01-02,7,2020,"53",9986857,2553,615,1941,612,1938,6.15809358239534,6.12805410150561,0.315301391035549
"United States","Michigan","MI",2021-01-03,2021-01-09,7,2021,"1",9986857,2354,841,1973,381,1513,8.42106780942192,3.81501407299614,0.193106943740497
"United States","Michigan","MI",2021-01-10,2021-01-16,7,2021,"2",9986857,2391,509,2001,390,1882,5.0966985909581,3.90513251566534,0.194902548725637
"United States","Michigan","MI",2021-01-17,2021-01-23,7,2021,"3",9986857,2342,524,2003,339,1818,5.24689599540676,3.39446134053987,0.169246130803794
"United States","Michigan","MI",2021-01-24,2021-01-30,7,2021,"4",9986857,2188,347,2006,182,1841,3.47456662291249,1.82239517397716,0.0907278165503489
"United States","Michigan","MI",2021-01-31,2021-02-06,7,2021,"5",9986857,2286,331,1979,307,1955,3.31435605816725,3.07404021104938,0.155128852956038
"United States","Michigan","MI",2021-02-07,2021-02-13,7,2021,"6",9986857,2080,265,1985,95,1815,2.65348747859312,0.95125022817489,0.0478589420654911
"United States","Michigan","MI",2021-02-14,2021-02-20,7,2021,"7",9986857,2099,222,1975,124,1877,2.22292158584027,1.24163187677565,0.0627848101265822
"United States","Michigan","MI",2021-02-21,2021-02-27,7,2021,"8",9986857,2083,166,1978,105,1917,1.66218460923191,1.05138183114067,0.0530839231547018
"United States","Michigan","MI",2021-02-28,2021-03-06,7,2021,"9",9986857,2039,151,1979,60,1888,1.51198720478325,0.600789617794668,0.0303183425972713
"United States","Michigan","MI",2021-03-07,2021-03-13,7,2021,"10",9986857,1880,115,1969,-89,1765,1.15151343410645,-0.891171266395424,-0.0452006094464195
"United States","Michigan","MI",2021-03-14,2021-03-20,7,2021,"11",9986857,2033,134,1952,81,1899,1.34176347974142,0.811065984022801,0.0414959016393444
"United States","Michigan","MI",2021-03-21,2021-03-27,7,2021,"12",9986857,2118,141,1952,166,1977,1.41185560181747,1.66218460923191,0.0850409836065573
"United States","Michigan","MI",2021-03-28,2021-04-03,7,2021,"13",9986857,2077,210,1947,130,1867,2.10276366228134,1.30171083855511,0.0667693888032872
"United States","Michigan","MI",2021-04-04,2021-04-10,7,2021,"14",9986857,2362,303,1937,425,2059,3.03398756986307,4.25559312604556,0.219411461022199
"United States","Michigan","MI",2021-04-11,2021-04-17,7,2021,"15",9986857,2312,371,1935,377,1941,3.71488247003036,3.77496143180983,0.194832041343669
"United States","Michigan","MI",2021-04-18,2021-04-24,7,2021,"16",9986857,2448,475,1904,544,1973,4.75625114087445,5.44715920133832,0.285714285714286
"United States","Michigan","MI",2021-04-25,2021-05-01,7,2021,"17",9986857,2373,484,1887,486,1889,4.84636958354365,4.86639590413681,0.257551669316375
"United States","Michigan","MI",2021-05-02,2021-05-08,7,2021,"18",9986857,2301,484,1869,432,1817,4.84636958354365,4.32568524812161,0.231139646869984
"United States","Michigan","MI",2021-05-09,2021-05-15,7,2021,"19",9986857,2225,413,1842,383,1812,4.13543520248663,3.83504039358929,0.207926167209555
"United States","Michigan","MI",2021-05-16,2021-05-22,7,2021,"20",9986857,2272,350,1836,436,1922,3.50460610380223,4.36573788930792,0.237472766884532
"United States","Michigan","MI",2021-05-23,2021-05-29,7,2021,"21",9986857,2074,236,1824,250,1838,2.36310582999236,2.50329007414445,0.137061403508772
"United States","Michigan","MI",2021-05-30,2021-06-05,7,2021,"22",9986857,2044,212,1815,229,1832,2.12278998287449,2.29301370791631,0.126170798898072
"United States","Michigan","MI",2021-06-06,2021-06-12,7,2021,"23",9986857,2077,190,1815,262,1887,1.90250045634978,2.62344799770338,0.14435261707989
"United States","Michigan","MI",2021-06-13,2021-06-19,7,2021,"24",9986857,2001,84,1822,179,1917,0.841105464912534,1.79235569308742,0.0982436882546651
"United States","Michigan","MI",2021-06-20,2021-06-26,7,2021,"25",9986857,2061,97,1830,231,1964,0.971276548768046,2.31304002850947,0.126229508196721
"United States","Michigan","MI",2021-06-27,2021-07-03,7,2021,"26",9986857,2019,50,1832,187,1969,0.50065801482889,1.87246097546005,0.10207423580786
"United States","Michigan","MI",2021-07-04,2021-07-10,7,2021,"27",9986857,2077,50,1824,253,2027,0.50065801482889,2.53332955503418,0.138706140350877
"United States","Michigan","MI",2021-07-11,2021-07-17,7,2021,"28",9986857,2039,50,1809,230,1989,0.50065801482889,2.30302686821289,0.127142067440575
"United States","Michigan","MI",2021-07-18,2021-07-24,7,2021,"29",9986857,2060,37,1812,248,2023,0.370486930973378,2.48326375355129,0.136865342163355
"United States","Michigan","MI",2021-07-25,2021-07-31,7,2021,"30",9986857,1943,42,1802,141,1901,0.420552732456267,1.41185560181747,0.0782463928967814
"United States","Michigan","MI",2021-08-01,2021-08-07,7,2021,"31",9986857,1718,33,1802,-84,1685,0.330434289787067,-0.841105464912534,-0.0466148723640399
"United States","Minnesota","MN",2019-12-29,2020-01-04,7,2020,"1",5639632,1009,0,1001,8,1009,0,0.141853227302774,0.00799200799200794
"United States","Minnesota","MN",2020-01-05,2020-01-11,7,2020,"2",5639632,950,0,990,-40,950,0,-0.709266136513872,-0.0404040404040404
"United States","Minnesota","MN",2020-01-12,2020-01-18,7,2020,"3",5639632,946,0,973,-27,946,0,-0.478754642146863,-0.0277492291880781
"United States","Minnesota","MN",2020-01-19,2020-01-25,7,2020,"4",5639632,955,0,954,1,955,0,0.0177316534128468,0.00104821802935007
"United States","Minnesota","MN",2020-01-26,2020-02-01,7,2020,"5",5639632,942,0,953,-11,942,0,-0.195048187541315,-0.0115424973767051
"United States","Minnesota","MN",2020-02-02,2020-02-08,7,2020,"6",5639632,919,0,951,-32,919,0,-0.567412909211097,-0.0336487907465826
"United States","Minnesota","MN",2020-02-09,2020-02-15,7,2020,"7",5639632,941,0,941,0,941,0,0,0
"United States","Minnesota","MN",2020-02-16,2020-02-22,7,2020,"8",5639632,913,0,932,-19,913,0,-0.336901414844089,-0.0203862660944206
"United States","Minnesota","MN",2020-02-23,2020-02-29,7,2020,"9",5639632,933,0,925,8,933,0,0.141853227302774,0.00864864864864856
"United States","Minnesota","MN",2020-03-01,2020-03-07,7,2020,"10",5639632,944,0,922,22,944,0,0.390096375082629,0.0238611713665944
"United States","Minnesota","MN",2020-03-08,2020-03-14,7,2020,"11",5639632,882,0,907,-25,882,0,-0.44329133532117,-0.0275633958103638
"United States","Minnesota","MN",2020-03-15,2020-03-21,7,2020,"12",5639632,894,1,901,-7,893,0.0177316534128468,-0.124121573889928,-0.00776914539400664
"United States","Minnesota","MN",2020-03-22,2020-03-28,7,2020,"13",5639632,909,4,907,2,905,0.0709266136513872,0.0354633068256936,0.00220507166482919
"United States","Minnesota","MN",2020-03-29,2020-04-04,7,2020,"14",5639632,928,19,918,10,909,0.336901414844089,0.177316534128468,0.0108932461873639
"United States","Minnesota","MN",2020-04-05,2020-04-11,7,2020,"15",5639632,943,40,911,32,903,0.709266136513872,0.567412909211097,0.0351262349066959
"United States","Minnesota","MN",2020-04-12,2020-04-18,7,2020,"16",5639632,955,57,896,59,898,1.01070424453227,1.04616755135796,0.0658482142857142
"United States","Minnesota","MN",2020-04-19,2020-04-25,7,2020,"17",5639632,1016,122,887,129,894,2.16326171636731,2.28738329025724,0.14543404735062
"United States","Minnesota","MN",2020-04-26,2020-05-02,7,2020,"18",5639632,1042,150,867,175,892,2.65974801192702,3.10303934724819,0.201845444059977
"United States","Minnesota","MN",2020-05-03,2020-05-09,7,2020,"19",5639632,1057,164,860,197,893,2.90799115970687,3.49313572233082,0.22906976744186
"United States","Minnesota","MN",2020-05-10,2020-05-16,7,2020,"20",5639632,1000,141,849,151,859,2.5001631312114,2.67747966533987,0.177856301531213
"United States","Minnesota","MN",2020-05-17,2020-05-23,7,2020,"21",5639632,1005,150,848,157,855,2.65974801192702,2.78386958581695,0.185141509433962
"United States","Minnesota","MN",2020-05-24,2020-05-30,7,2020,"22",5639632,1017,176,838,179,841,3.12077100066104,3.17396596089958,0.213603818615752
"United States","Minnesota","MN",2020-05-31,2020-06-06,7,2020,"23",5639632,1038,143,828,210,895,2.53562643803709,3.72364721669783,0.253623188405797
"United States","Minnesota","MN",2020-06-07,2020-06-13,7,2020,"24",5639632,973,114,815,158,859,2.02140848906453,2.80160123922979,0.193865030674847
"United States","Minnesota","MN",2020-06-14,2020-06-20,7,2020,"25",5639632,941,91,822,119,850,1.61358046056906,2.11006675612877,0.144768856447689
"United States","Minnesota","MN",2020-06-21,2020-06-27,7,2020,"26",5639632,840,45,823,17,795,0.797924403578106,0.301438108018395,0.0206561360874848
"United States","Minnesota","MN",2020-06-28,2020-07-04,7,2020,"27",5639632,876,49,823,53,827,0.868851017229493,0.93977763088088,0.0643985419198057
"United States","Minnesota","MN",2020-07-05,2020-07-11,7,2020,"28",5639632,865,33,835,30,832,0.585144562623944,0.531949602385404,0.0359281437125749
"United States","Minnesota","MN",2020-07-12,2020-07-18,7,2020,"29",5639632,869,39,838,31,830,0.691534483101025,0.549681255798251,0.0369928400954653
"United States","Minnesota","MN",2020-07-19,2020-07-25,7,2020,"30",5639632,878,7,840,38,871,0.124121573889928,0.673802829688178,0.0452380952380953
"United States","Minnesota","MN",2020-07-26,2020-08-01,7,2020,"31",5639632,818,61,841,-23,757,1.08163085818365,-0.407828028495476,-0.0273483947681332
"United States","Minnesota","MN",2020-08-02,2020-08-08,7,2020,"32",5639632,897,42,845,52,855,0.744729443339565,0.922045977468033,0.0615384615384615
"United States","Minnesota","MN",2020-08-09,2020-08-15,7,2020,"33",5639632,888,51,839,49,837,0.904314324055187,0.868851017229493,0.0584028605482718
"United States","Minnesota","MN",2020-08-16,2020-08-22,7,2020,"34",5639632,907,62,830,77,845,1.0993625115965,1.3653373127892,0.0927710843373495
"United States","Minnesota","MN",2020-08-23,2020-08-29,7,2020,"35",5639632,919,53,835,84,866,0.93977763088088,1.48945888667913,0.10059880239521
"United States","Minnesota","MN",2020-08-30,2020-09-05,7,2020,"36",5639632,895,37,839,56,858,0.656071176275331,0.99297259111942,0.066746126340882
"United States","Minnesota","MN",2020-09-06,2020-09-12,7,2020,"37",5639632,893,55,849,44,838,0.975240937706574,0.780192750165259,0.0518256772673733
"United States","Minnesota","MN",2020-09-13,2020-09-19,7,2020,"38",5639632,957,57,860,97,900,1.01070424453227,1.71997038104614,0.112790697674419
"United States","Minnesota","MN",2020-09-20,2020-09-26,7,2020,"39",5639632,969,41,870,99,928,0.726997789926719,1.75543368787183,0.113793103448276
"United States","Minnesota","MN",2020-09-27,2020-10-03,7,2020,"40",5639632,886,69,881,5,817,1.22348408548643,0.088658267064234,0.00567536889897835
"United States","Minnesota","MN",2020-10-04,2020-10-10,7,2020,"41",5639632,1013,58,885,128,955,1.02843589794511,2.26965163684439,0.144632768361582
"United States","Minnesota","MN",2020-10-11,2020-10-17,7,2020,"42",5639632,953,20,891,62,933,0.354633068256936,1.0993625115965,0.0695847362514028
"United States","Minnesota","MN",2020-10-18,2020-10-24,7,2020,"43",5639632,1030,95,895,135,935,1.68450707422045,2.39377321073432,0.150837988826816
"United States","Minnesota","MN",2020-10-25,2020-10-31,7,2020,"44",5639632,1075,229,899,176,846,4.06054863154192,3.12077100066104,0.195773081201335
"United States","Minnesota","MN",2020-11-01,2020-11-07,7,2020,"45",5639632,1145,149,899,246,996,2.64201635851417,4.36198673956031,0.273637374860957
"United States","Minnesota","MN",2020-11-08,2020-11-14,7,2020,"46",5639632,1196,281,894,302,915,4.98259460900995,5.35495933067973,0.337807606263982
"United States","Minnesota","MN",2020-11-15,2020-11-21,7,2020,"47",5639632,1326,336,890,436,990,5.95783554671652,7.7310008880012,0.489887640449438
"United States","Minnesota","MN",2020-11-22,2020-11-28,7,2020,"48",5639632,1397,280,878,519,1117,4.9648629555971,9.20272812126749,0.591116173120729
"United States","Minnesota","MN",2020-11-29,2020-12-05,7,2020,"49",5639632,1334,398,870,464,936,7.05719805831303,8.22748718356091,0.533333333333333
"United States","Minnesota","MN",2020-12-06,2020-12-12,7,2020,"50",5639632,1382,440,884,498,942,7.80192750165259,8.8303633995977,0.563348416289593
"United States","Minnesota","MN",2020-12-13,2020-12-19,7,2020,"51",5639632,1269,421,896,373,848,7.4650260868085,6.61390672299185,0.416294642857143
"United States","Minnesota","MN",2020-12-20,2020-12-26,7,2020,"52",5639632,1203,327,911,292,876,5.7982506660009,5.17764279655126,0.320526893523601
"United States","Minnesota","MN",2020-12-27,2021-01-02,7,2020,"53",5639632,1194,270,936,258,924,4.78754642146863,4.57476658051447,0.275641025641026
"United States","Minnesota","MN",2021-01-03,2021-01-09,7,2021,"1",5639632,1140,286,946,194,854,5.07125287607418,3.43994076209228,0.20507399577167
"United States","Minnesota","MN",2021-01-10,2021-01-16,7,2021,"2",5639632,1078,224,955,123,854,3.97189036447768,2.18099336978016,0.128795811518325
"United States","Minnesota","MN",2021-01-17,2021-01-23,7,2021,"3",5639632,948,176,956,-8,772,3.12077100066104,-0.141853227302774,-0.00836820083682011
"United States","Minnesota","MN",2021-01-24,2021-01-30,7,2021,"4",5639632,924,124,937,-13,800,2.198725023193,-0.230511494367008,-0.0138740661686233
"United States","Minnesota","MN",2021-01-31,2021-02-06,7,2021,"5",5639632,983,103,931,52,880,1.82636030152322,0.922045977468033,0.0558539205155746
"United States","Minnesota","MN",2021-02-07,2021-02-13,7,2021,"6",5639632,910,80,923,-13,830,1.41853227302774,-0.230511494367008,-0.0140845070422535
"United States","Minnesota","MN",2021-02-14,2021-02-20,7,2021,"7",5639632,904,54,915,-11,850,0.957509284293727,-0.195048187541315,-0.0120218579234973
"United States","Minnesota","MN",2021-02-21,2021-02-27,7,2021,"8",5639632,973,53,896,77,920,0.93977763088088,1.3653373127892,0.0859375
"United States","Minnesota","MN",2021-02-28,2021-03-06,7,2021,"9",5639632,937,69,888,49,868,1.22348408548643,0.868851017229493,0.0551801801801801
"United States","Minnesota","MN",2021-03-07,2021-03-13,7,2021,"10",5639632,868,195,885,-17,673,3.45767241550513,-0.301438108018395,-0.0192090395480226
"United States","Minnesota","MN",2021-03-14,2021-03-20,7,2021,"11",5639632,870,37,879,-9,833,0.656071176275331,-0.159584880715621,-0.0102389078498294
"United States","Minnesota","MN",2021-03-21,2021-03-27,7,2021,"12",5639632,868,47,876,-8,821,0.833387710403799,-0.141853227302774,-0.0091324200913242
"United States","Minnesota","MN",2021-03-28,2021-04-03,7,2021,"13",5639632,875,50,889,-14,825,0.88658267064234,-0.248243147779855,-0.015748031496063
"United States","Minnesota","MN",2021-04-04,2021-04-10,7,2021,"14",5639632,877,69,893,-16,808,1.22348408548643,-0.283706454605549,-0.0179171332586786
"United States","Minnesota","MN",2021-04-11,2021-04-17,7,2021,"15",5639632,896,61,891,5,835,1.08163085818365,0.088658267064234,0.00561167227833903
"United States","Minnesota","MN",2021-04-18,2021-04-24,7,2021,"16",5639632,938,67,888,50,871,1.18802077866074,0.88658267064234,0.0563063063063063
"United States","Minnesota","MN",2021-04-25,2021-05-01,7,2021,"17",5639632,973,82,893,80,891,1.45399557985344,1.41853227302774,0.0895856662933932
"United States","Minnesota","MN",2021-05-02,2021-05-08,7,2021,"18",5639632,900,70,875,25,830,1.24121573889928,0.44329133532117,0.0285714285714285
"United States","Minnesota","MN",2021-05-09,2021-05-15,7,2021,"19",5639632,942,62,886,56,880,1.0993625115965,0.99297259111942,0.0632054176072234
"United States","Minnesota","MN",2021-05-16,2021-05-22,7,2021,"20",5639632,890,77,881,9,813,1.3653373127892,0.159584880715621,0.0102156640181612
"United States","Minnesota","MN",2021-05-23,2021-05-29,7,2021,"21",5639632,876,55,858,18,821,0.975240937706574,0.319169761431242,0.020979020979021
"United States","Minnesota","MN",2021-05-30,2021-06-05,7,2021,"22",5639632,853,43,845,8,810,0.762461096752412,0.141853227302774,0.00946745562130169
"United States","Minnesota","MN",2021-06-06,2021-06-12,7,2021,"23",5639632,914,42,837,77,872,0.744729443339565,1.3653373127892,0.091995221027479
"United States","Minnesota","MN",2021-06-13,2021-06-19,7,2021,"24",5639632,844,33,830,14,811,0.585144562623944,0.248243147779855,0.0168674698795181
"United States","Minnesota","MN",2021-06-20,2021-06-26,7,2021,"25",5639632,873,42,834,39,831,0.744729443339565,0.691534483101025,0.0467625899280575
"United States","Minnesota","MN",2021-06-27,2021-07-03,7,2021,"26",5639632,838,32,827,11,806,0.567412909211097,0.195048187541315,0.0133010882708586
"United States","Minnesota","MN",2021-07-04,2021-07-10,7,2021,"27",5639632,835,12,831,4,823,0.212779840954162,0.0709266136513872,0.00481347773766538
"United States","Minnesota","MN",2021-07-11,2021-07-17,7,2021,"28",5639632,819,13,840,-21,806,0.230511494367008,-0.372364721669783,-0.025
"United States","Minnesota","MN",2021-07-18,2021-07-24,7,2021,"29",5639632,779,15,846,-67,764,0.265974801192702,-1.18802077866074,-0.0791962174940898
"United States","Minnesota","MN",2021-07-25,2021-07-31,7,2021,"30",5639632,814,18,859,-45,796,0.319169761431242,-0.797924403578106,-0.0523864959254947
"United States","Minnesota","MN",2021-08-01,2021-08-07,7,2021,"31",5639632,777,26,850,-73,751,0.461022988734017,-1.29441069913782,-0.0858823529411765
"United States","Mississippi","MS",2019-12-29,2020-01-04,7,2020,"1",2976149,673,0,714,-41,673,0,-1.37761919850115,-0.0574229691876751
"United States","Mississippi","MS",2020-01-05,2020-01-11,7,2020,"2",2976149,648,0,712,-64,648,0,-2.15042996839204,-0.0898876404494382
"United States","Mississippi","MS",2020-01-12,2020-01-18,7,2020,"3",2976149,624,0,705,-81,624,0,-2.72163792874617,-0.114893617021277
"United States","Mississippi","MS",2020-01-19,2020-01-25,7,2020,"4",2976149,612,0,673,-61,612,0,-2.04962856362366,-0.0906389301634473
"United States","Mississippi","MS",2020-01-26,2020-02-01,7,2020,"5",2976149,608,0,673,-65,608,0,-2.18403043664817,-0.0965824665676077
"United States","Mississippi","MS",2020-02-02,2020-02-08,7,2020,"6",2976149,703,0,680,23,703,0,0.772810769890889,0.0338235294117648
"United States","Mississippi","MS",2020-02-09,2020-02-15,7,2020,"7",2976149,648,0,670,-22,648,0,-0.739210301634764,-0.0328358208955224
"United States","Mississippi","MS",2020-02-16,2020-02-22,7,2020,"8",2976149,625,0,659,-34,625,0,-1.14241592070827,-0.0515933232169955
"United States","Mississippi","MS",2020-02-23,2020-02-29,7,2020,"9",2976149,665,0,647,18,665,0,0.604808428610261,0.027820710973725
"United States","Mississippi","MS",2020-03-01,2020-03-07,7,2020,"10",2976149,663,0,649,14,663,0,0.470406555585759,0.0215716486902928
"United States","Mississippi","MS",2020-03-08,2020-03-14,7,2020,"11",2976149,623,0,646,-23,623,0,-0.772810769890889,-0.0356037151702786
"United States","Mississippi","MS",2020-03-15,2020-03-21,7,2020,"12",2976149,625,1,642,-17,624,0.0336004682561256,-0.571207960354135,-0.0264797507788161
"United States","Mississippi","MS",2020-03-22,2020-03-28,7,2020,"13",2976149,698,5,633,65,693,0.168002341280628,2.18403043664817,0.102685624012638
"United States","Mississippi","MS",2020-03-29,2020-04-04,7,2020,"14",2976149,707,29,630,77,678,0.974413579427643,2.58723605572167,0.122222222222222
"United States","Mississippi","MS",2020-04-05,2020-04-11,7,2020,"15",2976149,699,57,622,77,642,1.91522669059916,2.58723605572167,0.12379421221865
"United States","Mississippi","MS",2020-04-12,2020-04-18,7,2020,"16",2976149,732,59,614,118,673,1.98242762711141,3.96485525422282,0.192182410423453
"United States","Mississippi","MS",2020-04-19,2020-04-25,7,2020,"17",2976149,750,69,609,141,681,2.31843230967267,4.73766602411371,0.231527093596059
"United States","Mississippi","MS",2020-04-26,2020-05-02,7,2020,"18",2976149,751,71,600,151,680,2.38563324618492,5.07367070667497,0.251666666666667
"United States","Mississippi","MS",2020-05-03,2020-05-09,7,2020,"19",2976149,748,128,594,154,620,4.30085993678408,5.17447211144334,0.259259259259259
"United States","Mississippi","MS",2020-05-10,2020-05-16,7,2020,"20",2976149,775,91,589,186,684,3.05764261130743,6.24968709563937,0.315789473684211
"United States","Mississippi","MS",2020-05-17,2020-05-23,7,2020,"21",2976149,725,106,596,129,619,3.56164963514932,4.3344604050402,0.216442953020134
"United States","Mississippi","MS",2020-05-24,2020-05-30,7,2020,"22",2976149,750,107,601,149,643,3.59525010340544,5.00646977016272,0.247920133111481
"United States","Mississippi","MS",2020-05-31,2020-06-06,7,2020,"23",2976149,728,88,598,130,640,2.95684120653905,4.36806087329633,0.217391304347826
"United States","Mississippi","MS",2020-06-07,2020-06-13,7,2020,"24",2976149,702,78,591,111,624,2.6208365239778,3.72965197642994,0.187817258883249
"United States","Mississippi","MS",2020-06-14,2020-06-20,7,2020,"25",2976149,743,49,595,148,694,1.64642294455016,4.97286930190659,0.248739495798319
"United States","Mississippi","MS",2020-06-21,2020-06-27,7,2020,"26",2976149,721,97,596,125,624,3.25924542084418,4.2000585320157,0.209731543624161
"United States","Mississippi","MS",2020-06-28,2020-07-04,7,2020,"27",2976149,711,72,591,120,639,2.41923371444104,4.03205619073507,0.203045685279188
"United States","Mississippi","MS",2020-07-05,2020-07-11,7,2020,"28",2976149,797,123,590,207,674,4.13285759550345,6.955296929018,0.350847457627119
"United States","Mississippi","MS",2020-07-12,2020-07-18,7,2020,"29",2976149,784,116,580,204,668,3.89765431771057,6.85449552424963,0.351724137931035
"United States","Mississippi","MS",2020-07-19,2020-07-25,7,2020,"30",2976149,885,134,589,296,751,4.50246274632083,9.94573860381318,0.502546689303905
"United States","Mississippi","MS",2020-07-26,2020-08-01,7,2020,"31",2976149,872,212,585,287,660,7.12329927029863,9.64333438950805,0.490598290598291
"United States","Mississippi","MS",2020-08-02,2020-08-08,7,2020,"32",2976149,915,165,582,333,750,5.54407726226073,11.1889559292898,0.572164948453608
"United States","Mississippi","MS",2020-08-09,2020-08-15,7,2020,"33",2976149,860,223,576,284,637,7.49290442111601,9.54253298473968,0.493055555555556
"United States","Mississippi","MS",2020-08-16,2020-08-22,7,2020,"34",2976149,813,155,580,233,658,5.20807257969947,7.82890910367727,0.401724137931035
"United States","Mississippi","MS",2020-08-23,2020-08-29,7,2020,"35",2976149,813,190,575,238,623,6.38408896866387,7.9969114449579,0.413913043478261
"United States","Mississippi","MS",2020-08-30,2020-09-05,7,2020,"36",2976149,736,144,580,156,592,4.83846742888209,5.2416730479556,0.268965517241379
"United States","Mississippi","MS",2020-09-06,2020-09-12,7,2020,"37",2976149,745,112,581,164,633,3.76325244468607,5.5104767940046,0.282271944922547
"United States","Mississippi","MS",2020-09-13,2020-09-19,7,2020,"38",2976149,738,128,582,156,610,4.30085993678408,5.2416730479556,0.268041237113402
"United States","Mississippi","MS",2020-09-20,2020-09-26,7,2020,"39",2976149,723,102,585,138,621,3.42724776212481,4.63686461934534,0.235897435897436
"United States","Mississippi","MS",2020-09-27,2020-10-03,7,2020,"40",2976149,728,104,590,138,624,3.49444869863706,4.63686461934534,0.233898305084746
"United States","Mississippi","MS",2020-10-04,2020-10-10,7,2020,"41",2976149,761,81,595,166,680,2.72163792874617,5.57767773051685,0.278991596638655
"United States","Mississippi","MS",2020-10-11,2020-10-17,7,2020,"42",2976149,680,75,597,83,605,2.52003511920942,2.78883886525843,0.139028475711893
"United States","Mississippi","MS",2020-10-18,2020-10-24,7,2020,"43",2976149,727,84,598,129,643,2.82243933351455,4.3344604050402,0.21571906354515
"United States","Mississippi","MS",2020-10-25,2020-10-31,7,2020,"44",2976149,716,93,607,109,623,3.12484354781968,3.66245103991769,0.179571663920923
"United States","Mississippi","MS",2020-11-01,2020-11-07,7,2020,"45",2976149,750,94,613,137,656,3.15844401607581,4.60326415108921,0.223491027732463
"United States","Mississippi","MS",2020-11-08,2020-11-14,7,2020,"46",2976149,785,98,618,167,687,3.29284588910031,5.61127819877298,0.270226537216828
"United States","Mississippi","MS",2020-11-15,2020-11-21,7,2020,"47",2976149,793,117,628,165,676,3.9312547859667,5.54407726226073,0.262738853503185
"United States","Mississippi","MS",2020-11-22,2020-11-28,7,2020,"48",2976149,820,122,639,181,698,4.09925712724733,6.08168475435874,0.283255086071988
"United States","Mississippi","MS",2020-11-29,2020-12-05,7,2020,"49",2976149,850,170,643,207,680,5.71207960354136,6.955296929018,0.321928460342146
"United States","Mississippi","MS",2020-12-06,2020-12-12,7,2020,"50",2976149,959,231,646,313,728,7.76170816716502,10.5169465641673,0.484520123839009
"United States","Mississippi","MS",2020-12-13,2020-12-19,7,2020,"51",2976149,923,210,649,274,713,7.05609833378638,9.20652830217842,0.422187981510015
"United States","Mississippi","MS",2020-12-20,2020-12-26,7,2020,"52",2976149,995,175,658,337,820,5.88008194482198,11.3233578023143,0.512158054711246
"United States","Mississippi","MS",2020-12-27,2021-01-02,7,2020,"53",2976149,1068,275,669,399,793,9.24012877043454,13.4065868341941,0.596412556053812
"United States","Mississippi","MS",2021-01-03,2021-01-09,7,2021,"1",2976149,1046,-262,664,382,1308,-8.80332268310491,12.83537887384,0.575301204819277
"United States","Mississippi","MS",2021-01-10,2021-01-16,7,2021,"2",2976149,1057,903,687,370,154,30.3412228352814,12.4321732547665,0.538573508005822
"United States","Mississippi","MS",2021-01-17,2021-01-23,7,2021,"3",2976149,1020,271,687,333,749,9.10572689741004,11.1889559292898,0.48471615720524
"United States","Mississippi","MS",2021-01-24,2021-01-30,7,2021,"4",2976149,918,267,686,232,651,8.97132502438554,7.79530863542114,0.338192419825073
"United States","Mississippi","MS",2021-01-31,2021-02-06,7,2021,"5",2976149,866,247,679,187,619,8.29931565926303,6.28328756389549,0.27540500736377
"United States","Mississippi","MS",2021-02-07,2021-02-13,7,2021,"6",2976149,790,196,675,115,594,6.58569177820062,3.86405384945445,0.17037037037037
"United States","Mississippi","MS",2021-02-14,2021-02-20,7,2021,"7",2976149,806,92,661,145,714,3.09124307956356,4.87206789713821,0.219364599092284
"United States","Mississippi","MS",2021-02-21,2021-02-27,7,2021,"8",2976149,846,116,652,194,730,3.89765431771057,6.51849084168837,0.297546012269939
"United States","Mississippi","MS",2021-02-28,2021-03-06,7,2021,"9",2976149,720,136,646,74,584,4.56966368283308,2.4864346509533,0.114551083591331
"United States","Mississippi","MS",2021-03-07,2021-03-13,7,2021,"10",2976149,752,91,637,115,661,3.05764261130743,3.86405384945445,0.180533751962323
"United States","Mississippi","MS",2021-03-14,2021-03-20,7,2021,"11",2976149,676,60,627,49,616,2.01602809536754,1.64642294455016,0.0781499202551834
"United States","Mississippi","MS",2021-03-21,2021-03-27,7,2021,"12",2976149,672,45,627,45,627,1.51202107152565,1.51202107152565,0.0717703349282297
"United States","Mississippi","MS",2021-03-28,2021-04-03,7,2021,"13",2976149,650,55,626,24,595,1.84802575408691,0.806411238147015,0.0383386581469649
"United States","Mississippi","MS",2021-04-04,2021-04-10,7,2021,"14",2976149,663,38,625,38,625,1.27681779373277,1.27681779373277,0.0608
"United States","Mississippi","MS",2021-04-11,2021-04-17,7,2021,"15",2976149,654,58,625,29,596,1.94882715885529,0.974413579427643,0.0464
"United States","Mississippi","MS",2021-04-18,2021-04-24,7,2021,"16",2976149,667,22,611,56,645,0.739210301634764,1.88162622234303,0.0916530278232406
"United States","Mississippi","MS",2021-04-25,2021-05-01,7,2021,"17",2976149,692,24,608,84,668,0.806411238147015,2.82243933351455,0.138157894736842
"United States","Mississippi","MS",2021-05-02,2021-05-08,7,2021,"18",2976149,636,29,615,21,607,0.974413579427643,0.705609833378638,0.0341463414634147
"United States","Mississippi","MS",2021-05-09,2021-05-15,7,2021,"19",2976149,629,26,610,19,603,0.873612174659266,0.638408896866387,0.0311475409836066
"United States","Mississippi","MS",2021-05-16,2021-05-22,7,2021,"20",2976149,678,25,603,75,653,0.84001170640314,2.52003511920942,0.124378109452736
"United States","Mississippi","MS",2021-05-23,2021-05-29,7,2021,"21",2976149,688,31,599,89,657,1.04161451593989,2.99044167479518,0.148580968280468
"United States","Mississippi","MS",2021-05-30,2021-06-05,7,2021,"22",2976149,627,15,595,32,612,0.504007023841884,1.07521498419602,0.053781512605042
"United States","Mississippi","MS",2021-06-06,2021-06-12,7,2021,"23",2976149,698,28,594,104,670,0.940813111171517,3.49444869863706,0.175084175084175
"United States","Mississippi","MS",2021-06-13,2021-06-19,7,2021,"24",2976149,643,18,590,53,625,0.604808428610261,1.78082481757466,0.0898305084745763
"United States","Mississippi","MS",2021-06-20,2021-06-26,7,2021,"25",2976149,649,24,589,60,625,0.806411238147015,2.01602809536754,0.101867572156197
"United States","Mississippi","MS",2021-06-27,2021-07-03,7,2021,"26",2976149,618,24,585,33,594,0.806411238147015,1.10881545245215,0.0564102564102564
"United States","Mississippi","MS",2021-07-04,2021-07-10,7,2021,"27",2976149,658,20,578,80,638,0.672009365122512,2.68803746049005,0.13840830449827
"United States","Mississippi","MS",2021-07-11,2021-07-17,7,2021,"28",2976149,684,26,582,102,658,0.873612174659266,3.42724776212481,0.175257731958763
"United States","Mississippi","MS",2021-07-18,2021-07-24,7,2021,"29",2976149,717,37,584,133,680,1.24321732547665,4.46886227806471,0.227739726027397
"United States","Mississippi","MS",2021-07-25,2021-07-31,7,2021,"30",2976149,681,41,579,102,640,1.37761919850115,3.42724776212481,0.176165803108808
"United States","Mississippi","MS",2021-08-01,2021-08-07,7,2021,"31",2976149,650,78,579,71,572,2.6208365239778,2.38563324618492,0.122625215889465
"United States","Missouri","MO",2019-12-29,2020-01-04,7,2020,"1",6137428,1327,0,1550,-223,1327,0,-3.6334438465103,-0.143870967741936
"United States","Missouri","MO",2020-01-05,2020-01-11,7,2020,"2",6137428,1333,0,1563,-230,1333,0,-3.74749813765636,-0.147152911068458
"United States","Missouri","MO",2020-01-12,2020-01-18,7,2020,"3",6137428,1334,0,1568,-234,1334,0,-3.81267201831125,-0.149234693877551
"United States","Missouri","MO",2020-01-19,2020-01-25,7,2020,"4",6137428,1352,0,1520,-168,1352,0,-2.73730298750552,-0.110526315789474
"United States","Missouri","MO",2020-01-26,2020-02-01,7,2020,"5",6137428,1364,0,1495,-131,1364,0,-2.13444459144775,-0.0876254180602006
"United States","Missouri","MO",2020-02-02,2020-02-08,7,2020,"6",6137428,1334,0,1484,-150,1334,0,-2.4440205245585,-0.101078167115903
"United States","Missouri","MO",2020-02-09,2020-02-15,7,2020,"7",6137428,1348,0,1448,-100,1348,0,-1.62934701637233,-0.069060773480663
"United States","Missouri","MO",2020-02-16,2020-02-22,7,2020,"8",6137428,1361,0,1424,-63,1361,0,-1.02648862031457,-0.0442415730337079
"United States","Missouri","MO",2020-02-23,2020-02-29,7,2020,"9",6137428,1370,0,1398,-28,1370,0,-0.456217164584253,-0.0200286123032904
"United States","Missouri","MO",2020-03-01,2020-03-07,7,2020,"10",6137428,1394,0,1377,17,1394,0,0.276988992783296,0.0123456790123457
"United States","Missouri","MO",2020-03-08,2020-03-14,7,2020,"11",6137428,1301,0,1373,-72,1301,0,-1.17312985178808,-0.0524399126001457
"United States","Missouri","MO",2020-03-15,2020-03-21,7,2020,"12",6137428,1272,3,1357,-85,1269,0.0488804104911699,-1.38494496391648,-0.0626381724392041
"United States","Missouri","MO",2020-03-22,2020-03-28,7,2020,"13",6137428,1343,7,1339,4,1336,0.114054291146063,0.0651738806548932,0.00298730395817781
"United States","Missouri","MO",2020-03-29,2020-04-04,7,2020,"14",6137428,1301,13,1319,-18,1288,0.211815112128403,-0.29328246294702,-0.0136467020470054
"United States","Missouri","MO",2020-04-05,2020-04-11,7,2020,"15",6137428,1466,87,1303,163,1379,1.41753190424393,2.6558356366869,0.125095932463546
"United States","Missouri","MO",2020-04-12,2020-04-18,7,2020,"16",6137428,1358,67,1292,66,1291,1.09166250096946,1.07536903080574,0.0510835913312693
"United States","Missouri","MO",2020-04-19,2020-04-25,7,2020,"17",6137428,1448,98,1285,163,1350,1.59676007604488,2.6558356366869,0.126848249027237
"United States","Missouri","MO",2020-04-26,2020-05-02,7,2020,"18",6137428,1393,78,1267,126,1315,1.27089067277042,2.05297724062914,0.0994475138121547
"United States","Missouri","MO",2020-05-03,2020-05-09,7,2020,"19",6137428,1427,121,1248,179,1306,1.97150988981052,2.91653115930647,0.143429487179487
"United States","Missouri","MO",2020-05-10,2020-05-16,7,2020,"20",6137428,1343,116,1235,108,1227,1.8900425389919,1.75969477768212,0.0874493927125506
"United States","Missouri","MO",2020-05-17,2020-05-23,7,2020,"21",6137428,1304,86,1237,67,1218,1.4012384340802,1.09166250096946,0.0541632983023443
"United States","Missouri","MO",2020-05-24,2020-05-30,7,2020,"22",6137428,1244,94,1233,11,1150,1.53158619538999,0.179228171800956,0.00892133008921325
"United States","Missouri","MO",2020-05-31,2020-06-06,7,2020,"23",6137428,1293,37,1221,72,1256,0.602858396057762,1.17312985178808,0.058968058968059
"United States","Missouri","MO",2020-06-07,2020-06-13,7,2020,"24",6137428,1263,70,1211,52,1193,1.14054291146063,0.847260448513612,0.0429397192402974
"United States","Missouri","MO",2020-06-14,2020-06-20,7,2020,"25",6137428,1228,78,1219,9,1150,1.27089067277042,0.14664123147351,0.00738310090237904
"United States","Missouri","MO",2020-06-21,2020-06-27,7,2020,"26",6137428,1284,41,1218,66,1243,0.668032276712656,1.07536903080574,0.0541871921182266
"United States","Missouri","MO",2020-06-28,2020-07-04,7,2020,"27",6137428,1284,26,1224,60,1258,0.423630224256806,0.977608209823398,0.0490196078431373
"United States","Missouri","MO",2020-07-05,2020-07-11,7,2020,"28",6137428,1295,47,1228,67,1248,0.765793097694995,1.09166250096946,0.0545602605863191
"United States","Missouri","MO",2020-07-12,2020-07-18,7,2020,"29",6137428,1367,61,1216,151,1306,0.993901679987122,2.46031399472222,0.124177631578947
"United States","Missouri","MO",2020-07-19,2020-07-25,7,2020,"30",6137428,1355,52,1210,145,1303,0.847260448513612,2.36255317373988,0.119834710743802
"United States","Missouri","MO",2020-07-26,2020-08-01,7,2020,"31",6137428,1366,71,1232,134,1295,1.15683638162435,2.18332500193892,0.108766233766234
"United States","Missouri","MO",2020-08-02,2020-08-08,7,2020,"32",6137428,1355,48,1225,130,1307,0.782086567858719,2.11815112128403,0.106122448979592
"United States","Missouri","MO",2020-08-09,2020-08-15,7,2020,"33",6137428,1380,45,1222,158,1335,0.733206157367549,2.57436828586828,0.129296235679214
"United States","Missouri","MO",2020-08-16,2020-08-22,7,2020,"34",6137428,1402,79,1209,193,1323,1.28718414293414,3.1446397415986,0.159636062861869
"United States","Missouri","MO",2020-08-23,2020-08-29,7,2020,"35",6137428,1382,71,1198,184,1311,1.15683638162435,2.99799851012509,0.153589315525877
"United States","Missouri","MO",2020-08-30,2020-09-05,7,2020,"36",6137428,1410,143,1191,219,1267,2.32996623341243,3.5682699658554,0.183879093198992
"United States","Missouri","MO",2020-09-06,2020-09-12,7,2020,"37",6137428,1369,65,1186,183,1304,1.05907556064201,2.98170503996137,0.154300168634064
"United States","Missouri","MO",2020-09-13,2020-09-19,7,2020,"38",6137428,1445,89,1179,266,1356,1.45011884457137,4.3340630635504,0.225614927905004
"United States","Missouri","MO",2020-09-20,2020-09-26,7,2020,"39",6137428,1465,270,1173,292,1195,4.39923694420529,4.75769328780721,0.248934356351236
"United States","Missouri","MO",2020-09-27,2020-10-03,7,2020,"40",6137428,1522,107,1170,352,1415,1.74340130751839,5.7353014976306,0.300854700854701
"United States","Missouri","MO",2020-10-04,2020-10-10,7,2020,"41",6137428,1531,253,1180,351,1278,4.122247951422,5.71900802746688,0.297457627118644
"United States","Missouri","MO",2020-10-11,2020-10-17,7,2020,"42",6137428,1519,162,1190,329,1357,2.63954216652318,5.36055168386497,0.276470588235294
"United States","Missouri","MO",2020-10-18,2020-10-24,7,2020,"43",6137428,1577,253,1194,383,1324,4.122247951422,6.24039907270603,0.320770519262982
"United States","Missouri","MO",2020-10-25,2020-10-31,7,2020,"44",6137428,1611,221,1202,409,1390,3.60085690618285,6.66402929696283,0.34026622296173
"United States","Missouri","MO",2020-11-01,2020-11-07,7,2020,"45",6137428,1790,94,1214,576,1696,1.53158619538999,9.38503881430463,0.474464579901153
"United States","Missouri","MO",2020-11-08,2020-11-14,7,2020,"46",6137428,1839,219,1205,634,1620,3.5682699658554,10.3300600838006,0.526141078838174
"United States","Missouri","MO",2020-11-15,2020-11-21,7,2020,"47",6137428,1858,180,1206,652,1678,2.9328246294702,10.6233425467476,0.540630182421227
"United States","Missouri","MO",2020-11-22,2020-11-28,7,2020,"48",6137428,1908,269,1210,698,1639,4.38294347404157,11.3728421742789,0.576859504132231
"United States","Missouri","MO",2020-11-29,2020-12-05,7,2020,"49",6137428,1962,360,1222,740,1602,5.86564925894039,12.0571679211552,0.60556464811784
"United States","Missouri","MO",2020-12-06,2020-12-12,7,2020,"50",6137428,2017,329,1238,779,1688,5.36055168386497,12.6926132575405,0.62924071082391
"United States","Missouri","MO",2020-12-13,2020-12-19,7,2020,"51",6137428,1890,427,1268,622,1463,6.95731175990985,10.1345384418359,0.490536277602524
"United States","Missouri","MO",2020-12-20,2020-12-26,7,2020,"52",6137428,1830,357,1294,536,1473,5.81676884844922,8.73330000775569,0.414219474497682
"United States","Missouri","MO",2020-12-27,2021-01-02,7,2020,"53",6137428,1837,249,1308,529,1588,4.0570740707671,8.61924571660963,0.404434250764526
"United States","Missouri","MO",2021-01-03,2021-01-09,7,2021,"1",6137428,1751,401,1328,423,1350,6.53368153565305,6.89213787925496,0.318524096385542
"United States","Missouri","MO",2021-01-10,2021-01-16,7,2021,"2",6137428,1786,306,1371,415,1480,4.98580187009933,6.76179011794517,0.302698760029176
"United States","Missouri","MO",2021-01-17,2021-01-23,7,2021,"3",6137428,1723,291,1388,335,1432,4.74139981764348,5.45831250484731,0.24135446685879
"United States","Missouri","MO",2021-01-24,2021-01-30,7,2021,"4",6137428,1617,207,1367,250,1410,3.37274832389072,4.07336754093083,0.182882223847842
"United States","Missouri","MO",2021-01-31,2021-02-06,7,2021,"5",6137428,1520,394,1377,143,1126,6.41962724450698,2.32996623341243,0.103848946986202
"United States","Missouri","MO",2021-02-07,2021-02-13,7,2021,"6",6137428,1423,311,1375,48,1112,5.06726922091795,0.782086567858719,0.034909090909091
"United States","Missouri","MO",2021-02-14,2021-02-20,7,2021,"7",6137428,1511,268,1351,160,1243,4.36665000387785,2.60695522619573,0.118430792005922
"United States","Missouri","MO",2021-02-21,2021-02-27,7,2021,"8",6137428,1408,199,1345,63,1209,3.24240056258094,1.02648862031457,0.0468401486988848
"United States","Missouri","MO",2021-02-28,2021-03-06,7,2021,"9",6137428,1376,248,1337,39,1128,4.04078060060338,0.635445336385209,0.0291697830964848
"United States","Missouri","MO",2021-03-07,2021-03-13,7,2021,"10",6137428,1322,149,1338,-16,1173,2.42772705439477,-0.260695522619573,-0.0119581464872944
"United States","Missouri","MO",2021-03-14,2021-03-20,7,2021,"11",6137428,1259,63,1327,-68,1196,1.02648862031457,-1.10795597113318,-0.051243406179352
"United States","Missouri","MO",2021-03-21,2021-03-27,7,2021,"12",6137428,1405,74,1300,105,1331,1.20571679211552,1.71081436719095,0.0807692307692307
"United States","Missouri","MO",2021-03-28,2021-04-03,7,2021,"13",6137428,1297,61,1271,26,1236,0.993901679987122,0.423630224256806,0.0204563335955941
"United States","Missouri","MO",2021-04-04,2021-04-10,7,2021,"14",6137428,1402,0,1267,135,1402,0,2.19961847210265,0.10655090765588
"United States","Missouri","MO",2021-04-11,2021-04-17,7,2021,"15",6137428,1312,120,1258,54,1192,1.9552164196468,0.879847388841059,0.0429252782193958
"United States","Missouri","MO",2021-04-18,2021-04-24,7,2021,"16",6137428,1305,60,1255,50,1245,0.977608209823398,0.814673508186165,0.0398406374501992
"United States","Missouri","MO",2021-04-25,2021-05-01,7,2021,"17",6137428,1307,50,1252,55,1257,0.814673508186165,0.896140859004782,0.0439297124600639
"United States","Missouri","MO",2021-05-02,2021-05-08,7,2021,"18",6137428,1235,78,1232,3,1157,1.27089067277042,0.0488804104911699,0.00243506493506485
"United States","Missouri","MO",2021-05-09,2021-05-15,7,2021,"19",6137428,1327,36,1219,108,1291,0.586564925894039,1.75969477768212,0.088597210828548
"United States","Missouri","MO",2021-05-16,2021-05-22,7,2021,"20",6137428,1277,147,1210,67,1130,2.39514011406733,1.09166250096946,0.0553719008264464
"United States","Missouri","MO",2021-05-23,2021-05-29,7,2021,"21",6137428,1248,74,1208,40,1174,1.20571679211552,0.651738806548932,0.0331125827814569
"United States","Missouri","MO",2021-05-30,2021-06-05,7,2021,"22",6137428,1311,60,1192,119,1251,0.977608209823398,1.93892294948307,0.0998322147651007
"United States","Missouri","MO",2021-06-06,2021-06-12,7,2021,"23",6137428,1328,56,1180,148,1272,0.912434329168505,2.41143358423105,0.125423728813559
"United States","Missouri","MO",2021-06-13,2021-06-19,7,2021,"24",6137428,1278,34,1189,89,1244,0.553977985566592,1.45011884457137,0.0748528174936922
"United States","Missouri","MO",2021-06-20,2021-06-26,7,2021,"25",6137428,1378,27,1201,177,1351,0.439923694420529,2.88394421897902,0.147377185678601
"United States","Missouri","MO",2021-06-27,2021-07-03,7,2021,"26",6137428,1275,82,1191,84,1193,1.33606455342531,1.36865149375276,0.070528967254408
"United States","Missouri","MO",2021-07-04,2021-07-10,7,2021,"27",6137428,1340,48,1198,142,1292,0.782086567858719,2.31367276324871,0.118530884808013
"United States","Missouri","MO",2021-07-11,2021-07-17,7,2021,"28",6137428,1401,87,1188,213,1314,1.41753190424393,3.47050914487306,0.179292929292929
"United States","Missouri","MO",2021-07-18,2021-07-24,7,2021,"29",6137428,1370,83,1183,187,1287,1.35235802358903,3.04687892061626,0.158072696534235
"United States","Missouri","MO",2021-07-25,2021-07-31,7,2021,"30",6137428,1312,110,1185,127,1202,1.79228171800956,2.06927071079286,0.107172995780591
"United States","Missouri","MO",2021-08-01,2021-08-07,7,2021,"31",6137428,1171,160,1187,-16,1011,2.60695522619573,-0.260695522619573,-0.0134793597304128
"United States","Montana","MT",2019-12-29,2020-01-04,7,2020,"1",1068778,231,0,208,23,231,0,2.15199040399409,0.110576923076923
"United States","Montana","MT",2020-01-05,2020-01-11,7,2020,"2",1068778,211,0,204,7,211,0,0.654953601215594,0.0343137254901962
"United States","Montana","MT",2020-01-12,2020-01-18,7,2020,"3",1068778,202,0,202,0,202,0,0,0
"United States","Montana","MT",2020-01-19,2020-01-25,7,2020,"4",1068778,197,0,201,-4,197,0,-0.374259200694625,-0.0199004975124378
"United States","Montana","MT",2020-01-26,2020-02-01,7,2020,"5",1068778,218,0,202,16,218,0,1.4970368027785,0.0792079207920793
"United States","Montana","MT",2020-02-02,2020-02-08,7,2020,"6",1068778,202,0,204,-2,202,0,-0.187129600347313,-0.00980392156862742
"United States","Montana","MT",2020-02-09,2020-02-15,7,2020,"7",1068778,198,0,203,-5,198,0,-0.467824000868281,-0.0246305418719212
"United States","Montana","MT",2020-02-16,2020-02-22,7,2020,"8",1068778,217,0,203,14,217,0,1.30990720243119,0.0689655172413792
"United States","Montana","MT",2020-02-23,2020-02-29,7,2020,"9",1068778,236,0,201,35,236,0,3.27476800607797,0.174129353233831
"United States","Montana","MT",2020-03-01,2020-03-07,7,2020,"10",1068778,221,0,194,27,221,0,2.52624960468872,0.139175257731959
"United States","Montana","MT",2020-03-08,2020-03-14,7,2020,"11",1068778,218,0,190,28,218,0,2.61981440486238,0.147368421052632
"United States","Montana","MT",2020-03-15,2020-03-21,7,2020,"12",1068778,229,0,191,38,229,0,3.55546240659894,0.198952879581152
"United States","Montana","MT",2020-03-22,2020-03-28,7,2020,"13",1068778,205,1,189,16,204,0.0935648001736563,1.4970368027785,0.0846560846560847
"United States","Montana","MT",2020-03-29,2020-04-04,7,2020,"14",1068778,177,4,188,-11,173,0.374259200694625,-1.02921280191022,-0.0585106382978723
"United States","Montana","MT",2020-04-05,2020-04-11,7,2020,"15",1068778,216,1,187,29,215,0.0935648001736563,2.71337920503603,0.155080213903743
"United States","Montana","MT",2020-04-12,2020-04-18,7,2020,"16",1068778,191,6,186,5,185,0.561388801041938,0.467824000868281,0.0268817204301075
"United States","Montana","MT",2020-04-19,2020-04-25,7,2020,"17",1068778,187,4,182,5,183,0.374259200694625,0.467824000868281,0.0274725274725274
"United States","Montana","MT",2020-04-26,2020-05-02,7,2020,"18",1068778,204,2,182,22,202,0.187129600347313,2.05842560382044,0.120879120879121
"United States","Montana","MT",2020-05-03,2020-05-09,7,2020,"19",1068778,177,0,178,-1,177,0,-0.0935648001736563,-0.0056179775280899
"United States","Montana","MT",2020-05-10,2020-05-16,7,2020,"20",1068778,205,0,177,28,205,0,2.61981440486238,0.15819209039548
"United States","Montana","MT",2020-05-17,2020-05-23,7,2020,"21",1068778,181,0,176,5,181,0,0.467824000868281,0.0284090909090908
"United States","Montana","MT",2020-05-24,2020-05-30,7,2020,"22",1068778,180,1,180,0,179,0.0935648001736563,0,0
"United States","Montana","MT",2020-05-31,2020-06-06,7,2020,"23",1068778,178,1,179,-1,177,0.0935648001736563,-0.0935648001736563,-0.005586592178771
"United States","Montana","MT",2020-06-07,2020-06-13,7,2020,"24",1068778,223,0,179,44,223,0,4.11685120764088,0.245810055865922
"United States","Montana","MT",2020-06-14,2020-06-20,7,2020,"25",1068778,198,2,177,21,196,0.187129600347313,1.96486080364678,0.11864406779661
"United States","Montana","MT",2020-06-21,2020-06-27,7,2020,"26",1068778,199,2,179,20,197,0.187129600347313,1.87129600347313,0.111731843575419
"United States","Montana","MT",2020-06-28,2020-07-04,7,2020,"27",1068778,175,1,179,-4,174,0.0935648001736563,-0.374259200694625,-0.0223463687150838
"United States","Montana","MT",2020-07-05,2020-07-11,7,2020,"28",1068778,190,6,185,5,184,0.561388801041938,0.467824000868281,0.027027027027027
"United States","Montana","MT",2020-07-12,2020-07-18,7,2020,"29",1068778,203,8,189,14,195,0.74851840138925,1.30990720243119,0.0740740740740742
"United States","Montana","MT",2020-07-19,2020-07-25,7,2020,"30",1068778,224,9,194,30,215,0.842083201562906,2.80694400520969,0.154639175257732
"United States","Montana","MT",2020-07-26,2020-08-01,7,2020,"31",1068778,216,15,190,26,201,1.40347200260484,2.43268480451506,0.136842105263158
"United States","Montana","MT",2020-08-02,2020-08-08,7,2020,"32",1068778,216,14,190,26,202,1.30990720243119,2.43268480451506,0.136842105263158
"United States","Montana","MT",2020-08-09,2020-08-15,7,2020,"33",1068778,204,7,187,17,197,0.654953601215594,1.59060160295216,0.0909090909090908
"United States","Montana","MT",2020-08-16,2020-08-22,7,2020,"34",1068778,240,8,182,58,232,0.74851840138925,5.42675841007206,0.318681318681319
"United States","Montana","MT",2020-08-23,2020-08-29,7,2020,"35",1068778,195,14,180,15,181,1.30990720243119,1.40347200260484,0.0833333333333333
"United States","Montana","MT",2020-08-30,2020-09-05,7,2020,"36",1068778,233,12,179,54,221,1.12277760208388,5.05249920937744,0.301675977653631
"United States","Montana","MT",2020-09-06,2020-09-12,7,2020,"37",1068778,221,17,175,46,204,1.59060160295216,4.30398080798819,0.262857142857143
"United States","Montana","MT",2020-09-13,2020-09-19,7,2020,"38",1068778,235,23,177,58,212,2.15199040399409,5.42675841007206,0.327683615819209
"United States","Montana","MT",2020-09-20,2020-09-26,7,2020,"39",1068778,236,15,181,55,221,1.40347200260484,5.14606400955109,0.303867403314917
"United States","Montana","MT",2020-09-27,2020-10-03,7,2020,"40",1068778,240,15,182,58,225,1.40347200260484,5.42675841007206,0.318681318681319
"United States","Montana","MT",2020-10-04,2020-10-10,7,2020,"41",1068778,282,23,185,97,259,2.15199040399409,9.07578561684466,0.524324324324324
"United States","Montana","MT",2020-10-11,2020-10-17,7,2020,"42",1068778,267,31,189,78,236,2.90050880538334,7.29805441354519,0.412698412698413
"United States","Montana","MT",2020-10-18,2020-10-24,7,2020,"43",1068778,295,54,190,105,241,5.05249920937744,9.82430401823391,0.552631578947368
"United States","Montana","MT",2020-10-25,2020-10-31,7,2020,"44",1068778,317,81,189,128,236,7.57874881406616,11.976294422228,0.677248677248677
"United States","Montana","MT",2020-11-01,2020-11-07,7,2020,"45",1068778,299,70,191,108,229,6.54953601215594,10.1049984187549,0.56544502617801
"United States","Montana","MT",2020-11-08,2020-11-14,7,2020,"46",1068778,323,66,191,132,257,6.17527681146131,12.3505536229226,0.691099476439791
"United States","Montana","MT",2020-11-15,2020-11-21,7,2020,"47",1068778,332,87,191,141,245,8.1401376151081,13.1926368244855,0.738219895287958
"United States","Montana","MT",2020-11-22,2020-11-28,7,2020,"48",1068778,307,71,188,119,236,6.6431008123296,11.1342112206651,0.632978723404255
"United States","Montana","MT",2020-11-29,2020-12-05,7,2020,"49",1068778,270,64,189,81,206,5.988147211114,7.57874881406616,0.428571428571429
"United States","Montana","MT",2020-12-06,2020-12-12,7,2020,"50",1068778,303,83,191,112,220,7.76587841441347,10.4792576194495,0.586387434554974
"United States","Montana","MT",2020-12-13,2020-12-19,7,2020,"51",1068778,271,48,194,77,223,4.4911104083355,7.20448961337153,0.396907216494845
"United States","Montana","MT",2020-12-20,2020-12-26,7,2020,"52",1068778,308,55,198,110,253,5.14606400955109,10.2921280191022,0.555555555555556
"United States","Montana","MT",2020-12-27,2021-01-02,7,2020,"53",1068778,274,52,205,69,222,4.86536960903013,6.45597121198228,0.336585365853659
"United States","Montana","MT",2021-01-03,2021-01-09,7,2021,"1",1068778,248,82,207,41,166,7.67231361423981,3.83615680711991,0.198067632850242
"United States","Montana","MT",2021-01-10,2021-01-16,7,2021,"2",1068778,253,35,211,42,218,3.27476800607797,3.92972160729356,0.199052132701422
"United States","Montana","MT",2021-01-17,2021-01-23,7,2021,"3",1068778,247,53,211,36,194,4.95893440920378,3.36833280625163,0.170616113744076
"United States","Montana","MT",2021-01-24,2021-01-30,7,2021,"4",1068778,199,91,214,-15,108,8.51439681580272,-1.40347200260484,-0.0700934579439252
"United States","Montana","MT",2021-01-31,2021-02-06,7,2021,"5",1068778,216,78,217,-1,138,7.29805441354519,-0.0935648001736563,-0.00460829493087556
"United States","Montana","MT",2021-02-07,2021-02-13,7,2021,"6",1068778,222,17,221,1,205,1.59060160295216,0.0935648001736563,0.00452488687782804
"United States","Montana","MT",2021-02-14,2021-02-20,7,2021,"7",1068778,211,12,223,-12,199,1.12277760208388,-1.12277760208388,-0.0538116591928252
"United States","Montana","MT",2021-02-21,2021-02-27,7,2021,"8",1068778,227,16,225,2,211,1.4970368027785,0.187129600347313,0.00888888888888895
"United States","Montana","MT",2021-02-28,2021-03-06,7,2021,"9",1068778,191,24,223,-32,167,2.24555520416775,-2.994073605557,-0.143497757847534
"United States","Montana","MT",2021-03-07,2021-03-13,7,2021,"10",1068778,202,12,217,-15,190,1.12277760208388,-1.40347200260484,-0.0691244239631337
"United States","Montana","MT",2021-03-14,2021-03-20,7,2021,"11",1068778,224,22,214,10,202,2.05842560382044,0.935648001736563,0.0467289719626167
"United States","Montana","MT",2021-03-21,2021-03-27,7,2021,"12",1068778,208,22,209,-1,186,2.05842560382044,-0.0935648001736563,-0.00478468899521534
"United States","Montana","MT",2021-03-28,2021-04-03,7,2021,"13",1068778,170,29,208,-38,141,2.71337920503603,-3.55546240659894,-0.182692307692308
"United States","Montana","MT",2021-04-04,2021-04-10,7,2021,"14",1068778,207,57,203,4,150,5.33319360989841,0.374259200694625,0.0197044334975369
"United States","Montana","MT",2021-04-11,2021-04-17,7,2021,"15",1068778,235,22,205,30,213,2.05842560382044,2.80694400520969,0.146341463414634
"United States","Montana","MT",2021-04-18,2021-04-24,7,2021,"16",1068778,208,18,206,2,190,1.68416640312581,0.187129600347313,0.00970873786407767
"United States","Montana","MT",2021-04-25,2021-05-01,7,2021,"17",1068778,225,11,204,21,214,1.02921280191022,1.96486080364678,0.102941176470588
"United States","Montana","MT",2021-05-02,2021-05-08,7,2021,"18",1068778,200,18,200,0,182,1.68416640312581,0,0
"United States","Montana","MT",2021-05-09,2021-05-15,7,2021,"19",1068778,199,6,199,0,193,0.561388801041938,0,0
"United States","Montana","MT",2021-05-16,2021-05-22,7,2021,"20",1068778,225,5,195,30,220,0.467824000868281,2.80694400520969,0.153846153846154
"United States","Montana","MT",2021-05-23,2021-05-29,7,2021,"21",1068778,214,10,198,16,204,0.935648001736563,1.4970368027785,0.0808080808080809
"United States","Montana","MT",2021-05-30,2021-06-05,7,2021,"22",1068778,206,19,198,8,187,1.77773120329947,0.74851840138925,0.0404040404040404
"United States","Montana","MT",2021-06-06,2021-06-12,7,2021,"23",1068778,234,9,201,33,225,0.842083201562906,3.08763840573066,0.164179104477612
"United States","Montana","MT",2021-06-13,2021-06-19,7,2021,"24",1068778,238,10,202,36,228,0.935648001736563,3.36833280625163,0.178217821782178
"United States","Montana","MT",2021-06-20,2021-06-26,7,2021,"25",1068778,216,11,203,13,205,1.02921280191022,1.21634240225753,0.0640394088669951
"United States","Montana","MT",2021-06-27,2021-07-03,7,2021,"26",1068778,230,4,203,27,226,0.374259200694625,2.52624960468872,0.133004926108374
"United States","Montana","MT",2021-07-04,2021-07-10,7,2021,"27",1068778,200,7,205,-5,193,0.654953601215594,-0.467824000868281,-0.024390243902439
"United States","Montana","MT",2021-07-11,2021-07-17,7,2021,"28",1068778,224,18,206,18,206,1.68416640312581,1.68416640312581,0.087378640776699
"United States","Montana","MT",2021-07-18,2021-07-24,7,2021,"29",1068778,210,4,211,-1,206,0.374259200694625,-0.0935648001736563,-0.00473933649289104
"United States","Montana","MT",2021-07-25,2021-07-31,7,2021,"30",1068778,256,9,215,41,247,0.842083201562906,3.83615680711991,0.190697674418605
"United States","Montana","MT",2021-08-01,2021-08-07,7,2021,"31",1068778,181,18,215,-34,163,1.68416640312581,-3.18120320590431,-0.158139534883721
"United States","Nebraska","NE",2019-12-29,2020-01-04,7,2020,"1",1934408,346,0,402,-56,346,0,-2.89494253539067,-0.139303482587065
"United States","Nebraska","NE",2020-01-05,2020-01-11,7,2020,"2",1934408,362,0,400,-38,362,0,-1.96442529187224,-0.095
"United States","Nebraska","NE",2020-01-12,2020-01-18,7,2020,"3",1934408,333,0,397,-64,333,0,-3.3085057547322,-0.161209068010076
"United States","Nebraska","NE",2020-01-19,2020-01-25,7,2020,"4",1934408,358,0,380,-22,358,0,-1.13729885318919,-0.0578947368421052
"United States","Nebraska","NE",2020-01-26,2020-02-01,7,2020,"5",1934408,373,0,374,-1,373,0,-0.0516954024176906,-0.00267379679144386
"United States","Nebraska","NE",2020-02-02,2020-02-08,7,2020,"6",1934408,345,0,368,-23,345,0,-1.18899425560688,-0.0625
"United States","Nebraska","NE",2020-02-09,2020-02-15,7,2020,"7",1934408,327,0,363,-36,327,0,-1.86103448703686,-0.0991735537190083
"United States","Nebraska","NE",2020-02-16,2020-02-22,7,2020,"8",1934408,318,0,359,-41,318,0,-2.11951149912531,-0.114206128133705
"United States","Nebraska","NE",2020-02-23,2020-02-29,7,2020,"9",1934408,341,0,362,-21,341,0,-1.0856034507715,-0.0580110497237569
"United States","Nebraska","NE",2020-03-01,2020-03-07,7,2020,"10",1934408,355,0,361,-6,355,0,-0.310172414506144,-0.0166204986149584
"United States","Nebraska","NE",2020-03-08,2020-03-14,7,2020,"11",1934408,343,0,356,-13,343,0,-0.672040231429978,-0.0365168539325843
"United States","Nebraska","NE",2020-03-15,2020-03-21,7,2020,"12",1934408,350,0,359,-9,350,0,-0.465258621759215,-0.0250696378830083
"United States","Nebraska","NE",2020-03-22,2020-03-28,7,2020,"13",1934408,331,2,359,-28,329,0.103390804835381,-1.44747126769534,-0.0779944289693594
"United States","Nebraska","NE",2020-03-29,2020-04-04,7,2020,"14",1934408,310,4,354,-44,306,0.206781609670762,-2.27459770637839,-0.124293785310734
"United States","Nebraska","NE",2020-04-05,2020-04-11,7,2020,"15",1934408,343,8,341,2,335,0.413563219341525,0.103390804835381,0.00586510263929618
"United States","Nebraska","NE",2020-04-12,2020-04-18,7,2020,"16",1934408,353,0,340,13,353,0,0.672040231429978,0.0382352941176471
"United States","Nebraska","NE",2020-04-19,2020-04-25,7,2020,"17",1934408,353,0,334,19,353,0,0.982212645936121,0.0568862275449102
"United States","Nebraska","NE",2020-04-26,2020-05-02,7,2020,"18",1934408,344,64,329,15,280,3.3085057547322,0.775431036265359,0.0455927051671732
"United States","Nebraska","NE",2020-05-03,2020-05-09,7,2020,"19",1934408,338,18,325,13,320,0.93051724351843,0.672040231429978,0.04
"United States","Nebraska","NE",2020-05-10,2020-05-16,7,2020,"20",1934408,352,26,327,25,326,1.34408046285996,1.29238506044226,0.0764525993883791
"United States","Nebraska","NE",2020-05-17,2020-05-23,7,2020,"21",1934408,347,23,325,22,324,1.18899425560688,1.13729885318919,0.0676923076923077
"United States","Nebraska","NE",2020-05-24,2020-05-30,7,2020,"22",1934408,375,21,326,49,354,1.0856034507715,2.53307471846684,0.150306748466258
"United States","Nebraska","NE",2020-05-31,2020-06-06,7,2020,"23",1934408,319,21,324,-5,298,1.0856034507715,-0.258477012088453,-0.0154320987654321
"United States","Nebraska","NE",2020-06-07,2020-06-13,7,2020,"24",1934408,319,29,333,-14,290,1.49916667011303,-0.723735633847668,-0.0420420420420421
"United States","Nebraska","NE",2020-06-14,2020-06-20,7,2020,"25",1934408,371,28,331,40,343,1.44747126769534,2.06781609670762,0.120845921450151
"United States","Nebraska","NE",2020-06-21,2020-06-27,7,2020,"26",1934408,320,23,330,-10,297,1.18899425560688,-0.516954024176906,-0.0303030303030303
"United States","Nebraska","NE",2020-06-28,2020-07-04,7,2020,"27",1934408,308,17,326,-18,291,0.87882184110074,-0.93051724351843,-0.0552147239263804
"United States","Nebraska","NE",2020-07-05,2020-07-11,7,2020,"28",1934408,317,1,323,-6,316,0.0516954024176906,-0.310172414506144,-0.0185758513931888
"United States","Nebraska","NE",2020-07-12,2020-07-18,7,2020,"29",1934408,325,15,313,12,310,0.775431036265359,0.620344829012287,0.0383386581469649
"United States","Nebraska","NE",2020-07-19,2020-07-25,7,2020,"30",1934408,361,17,308,53,344,0.87882184110074,2.7398563281376,0.172077922077922
"United States","Nebraska","NE",2020-07-26,2020-08-01,7,2020,"31",1934408,358,16,305,53,342,0.827126438683049,2.7398563281376,0.173770491803279
"United States","Nebraska","NE",2020-08-02,2020-08-08,7,2020,"32",1934408,381,13,308,73,368,0.672040231429978,3.77376437649141,0.237012987012987
"United States","Nebraska","NE",2020-08-09,2020-08-15,7,2020,"33",1934408,354,16,310,44,338,0.827126438683049,2.27459770637839,0.141935483870968
"United States","Nebraska","NE",2020-08-16,2020-08-22,7,2020,"34",1934408,363,15,310,53,348,0.775431036265359,2.7398563281376,0.170967741935484
"United States","Nebraska","NE",2020-08-23,2020-08-29,7,2020,"35",1934408,323,15,311,12,308,0.775431036265359,0.620344829012287,0.0385852090032155
"United States","Nebraska","NE",2020-08-30,2020-09-05,7,2020,"36",1934408,350,12,317,33,338,0.620344829012287,1.70594827978379,0.10410094637224
"United States","Nebraska","NE",2020-09-06,2020-09-12,7,2020,"37",1934408,339,31,315,24,308,1.60255747494841,1.24068965802457,0.0761904761904761
"United States","Nebraska","NE",2020-09-13,2020-09-19,7,2020,"38",1934408,328,8,315,13,320,0.413563219341525,0.672040231429978,0.0412698412698413
"United States","Nebraska","NE",2020-09-20,2020-09-26,7,2020,"39",1934408,378,27,316,62,351,1.39577586527765,3.20511494989682,0.19620253164557
"United States","Nebraska","NE",2020-09-27,2020-10-03,7,2020,"40",1934408,373,28,314,59,345,1.44747126769534,3.05002874264374,0.187898089171975
"United States","Nebraska","NE",2020-10-04,2020-10-10,7,2020,"41",1934408,406,21,318,88,385,1.0856034507715,4.54919541275677,0.276729559748428
"United States","Nebraska","NE",2020-10-11,2020-10-17,7,2020,"42",1934408,401,29,319,82,372,1.49916667011303,4.23902299825063,0.25705329153605
"United States","Nebraska","NE",2020-10-18,2020-10-24,7,2020,"43",1934408,425,48,325,100,377,2.48137931604915,5.16954024176906,0.307692307692308
"United States","Nebraska","NE",2020-10-25,2020-10-31,7,2020,"44",1934408,442,49,327,115,393,2.53307471846684,5.94497127803442,0.351681957186544
"United States","Nebraska","NE",2020-11-01,2020-11-07,7,2020,"45",1934408,498,56,320,178,442,2.89494253539067,9.20178163034892,0.55625
"United States","Nebraska","NE",2020-11-08,2020-11-14,7,2020,"46",1934408,551,77,319,232,474,3.98054598616217,11.9933333609042,0.727272727272727
"United States","Nebraska","NE",2020-11-15,2020-11-21,7,2020,"47",1934408,574,122,323,251,452,6.30683909495825,12.9755460068403,0.777089783281734
"United States","Nebraska","NE",2020-11-22,2020-11-28,7,2020,"48",1934408,565,81,325,240,484,4.18732759583294,12.4068965802457,0.738461538461539
"United States","Nebraska","NE",2020-11-29,2020-12-05,7,2020,"49",1934408,514,211,327,187,303,10.9077299101327,9.66704025210814,0.571865443425077
"United States","Nebraska","NE",2020-12-06,2020-12-12,7,2020,"50",1934408,501,171,337,164,330,8.83991381342509,8.47804599650125,0.486646884272997
"United States","Nebraska","NE",2020-12-13,2020-12-19,7,2020,"51",1934408,460,110,342,118,350,5.68649426594596,6.10005748528749,0.345029239766082
"United States","Nebraska","NE",2020-12-20,2020-12-26,7,2020,"52",1934408,426,81,360,66,345,4.18732759583294,3.41189655956758,0.183333333333333
"United States","Nebraska","NE",2020-12-27,2021-01-02,7,2020,"53",1934408,434,111,366,68,323,5.73818966836365,3.51528736440296,0.185792349726776
"United States","Nebraska","NE",2021-01-03,2021-01-09,7,2021,"1",1934408,447,71,377,70,376,3.67037357165603,3.61867816923834,0.185676392572944
"United States","Nebraska","NE",2021-01-10,2021-01-16,7,2021,"2",1934408,390,87,378,12,303,4.49750001033908,0.620344829012287,0.0317460317460319
"United States","Nebraska","NE",2021-01-17,2021-01-23,7,2021,"3",1934408,407,50,374,33,357,2.58477012088453,1.70594827978379,0.088235294117647
"United States","Nebraska","NE",2021-01-24,2021-01-30,7,2021,"4",1934408,378,40,362,16,338,2.06781609670762,0.827126438683049,0.0441988950276244
"United States","Nebraska","NE",2021-01-31,2021-02-06,7,2021,"5",1934408,364,46,361,3,318,2.37798851121377,0.155086207253072,0.00831024930747915
"United States","Nebraska","NE",2021-02-07,2021-02-13,7,2021,"6",1934408,341,43,356,-15,298,2.22290230396069,-0.775431036265359,-0.0421348314606742
"United States","Nebraska","NE",2021-02-14,2021-02-20,7,2021,"7",1934408,328,44,352,-24,284,2.27459770637839,-1.24068965802457,-0.0681818181818182
"United States","Nebraska","NE",2021-02-21,2021-02-27,7,2021,"8",1934408,322,31,349,-27,291,1.60255747494841,-1.39577586527765,-0.0773638968481375
"United States","Nebraska","NE",2021-02-28,2021-03-06,7,2021,"9",1934408,359,31,353,6,328,1.60255747494841,0.310172414506144,0.0169971671388103
"United States","Nebraska","NE",2021-03-07,2021-03-13,7,2021,"10",1934408,322,19,345,-23,303,0.982212645936121,-1.18899425560688,-0.0666666666666667
"United States","Nebraska","NE",2021-03-14,2021-03-20,7,2021,"11",1934408,332,9,346,-14,323,0.465258621759215,-0.723735633847668,-0.0404624277456648
"United States","Nebraska","NE",2021-03-21,2021-03-27,7,2021,"12",1934408,337,38,342,-5,299,1.96442529187224,-0.258477012088453,-0.0146198830409356
"United States","Nebraska","NE",2021-03-28,2021-04-03,7,2021,"13",1934408,333,12,343,-10,321,0.620344829012287,-0.516954024176906,-0.0291545189504373
"United States","Nebraska","NE",2021-04-04,2021-04-10,7,2021,"14",1934408,325,27,338,-13,298,1.39577586527765,-0.672040231429978,-0.0384615384615384
"United States","Nebraska","NE",2021-04-11,2021-04-17,7,2021,"15",1934408,365,-7,332,33,372,-0.361867816923834,1.70594827978379,0.0993975903614457
"United States","Nebraska","NE",2021-04-18,2021-04-24,7,2021,"16",1934408,331,29,325,6,302,1.49916667011303,0.310172414506144,0.0184615384615385
"United States","Nebraska","NE",2021-04-25,2021-05-01,7,2021,"17",1934408,373,3,322,51,370,0.155086207253072,2.63646552330222,0.158385093167702
"United States","Nebraska","NE",2021-05-02,2021-05-08,7,2021,"18",1934408,346,7,314,32,339,0.361867816923834,1.6542528773661,0.101910828025478
"United States","Nebraska","NE",2021-05-09,2021-05-15,7,2021,"19",1934408,374,33,311,63,341,1.70594827978379,3.25681035231451,0.202572347266881
"United States","Nebraska","NE",2021-05-16,2021-05-22,7,2021,"20",1934408,325,-36,312,13,361,-1.86103448703686,0.672040231429978,0.0416666666666667
"United States","Nebraska","NE",2021-05-23,2021-05-29,7,2021,"21",1934408,329,-12,311,18,341,-0.620344829012287,0.93051724351843,0.0578778135048232
"United States","Nebraska","NE",2021-05-30,2021-06-05,7,2021,"22",1934408,311,0,310,1,311,0,0.0516954024176906,0.00322580645161286
"United States","Nebraska","NE",2021-06-06,2021-06-12,7,2021,"23",1934408,315,26,311,4,289,1.34408046285996,0.206781609670762,0.0128617363344052
"United States","Nebraska","NE",2021-06-13,2021-06-19,7,2021,"24",1934408,324,3,320,4,321,0.155086207253072,0.206781609670762,0.0125
"United States","Nebraska","NE",2021-06-20,2021-06-26,7,2021,"25",1934408,305,0,320,-15,305,0,-0.775431036265359,-0.046875
"United States","Nebraska","NE",2021-06-27,2021-07-03,7,2021,"26",1934408,306,2,319,-13,304,0.103390804835381,-0.672040231429978,-0.0407523510971787
"United States","Nebraska","NE",2021-07-04,2021-07-10,7,2021,"27",1934408,279,1,317,-38,278,0.0516954024176906,-1.96442529187224,-0.1198738170347
"United States","Nebraska","NE",2021-07-11,2021-07-17,7,2021,"28",1934408,263,13,318,-55,250,0.672040231429978,-2.84324713297298,-0.172955974842767
"United States","Nevada","NV",2019-12-29,2020-01-04,7,2020,"1",3080156,521,0,593,-72,521,0,-2.33754394257953,-0.12141652613828
"United States","Nevada","NV",2020-01-05,2020-01-11,7,2020,"2",3080156,556,0,592,-36,556,0,-1.16877197128977,-0.0608108108108109
"United States","Nevada","NV",2020-01-12,2020-01-18,7,2020,"3",3080156,605,0,585,20,605,0,0.649317761827648,0.0341880341880343
"United States","Nevada","NV",2020-01-19,2020-01-25,7,2020,"4",3080156,577,0,566,11,577,0,0.357124769005206,0.0194346289752649
"United States","Nevada","NV",2020-01-26,2020-02-01,7,2020,"5",3080156,532,0,557,-25,532,0,-0.81164720228456,-0.0448833034111311
"United States","Nevada","NV",2020-02-02,2020-02-08,7,2020,"6",3080156,579,0,548,31,579,0,1.00644253083285,0.0565693430656935
"United States","Nevada","NV",2020-02-09,2020-02-15,7,2020,"7",3080156,530,0,543,-13,530,0,-0.422056545187971,-0.0239410681399632
"United States","Nevada","NV",2020-02-16,2020-02-22,7,2020,"8",3080156,546,0,542,4,546,0,0.12986355236553,0.00738007380073791
"United States","Nevada","NV",2020-02-23,2020-02-29,7,2020,"9",3080156,544,0,547,-3,544,0,-0.0973976642741472,-0.00548446069469832
"United States","Nevada","NV",2020-03-01,2020-03-07,7,2020,"10",3080156,535,0,546,-11,535,0,-0.357124769005206,-0.0201465201465202
"United States","Nevada","NV",2020-03-08,2020-03-14,7,2020,"11",3080156,515,0,547,-32,515,0,-1.03890841892424,-0.0585009140767825
"United States","Nevada","NV",2020-03-15,2020-03-21,7,2020,"12",3080156,508,2,542,-34,506,0.0649317761827648,-1.103840195107,-0.0627306273062731
"United States","Nevada","NV",2020-03-22,2020-03-28,7,2020,"13",3080156,543,12,540,3,531,0.389590657096589,0.0973976642741472,0.00555555555555554
"United States","Nevada","NV",2020-03-29,2020-04-04,7,2020,"14",3080156,593,32,528,65,561,1.03890841892424,2.11028272593986,0.123106060606061
"United States","Nevada","NV",2020-04-05,2020-04-11,7,2020,"15",3080156,588,56,529,59,532,1.81808973311741,1.91548739739156,0.111531190926276
"United States","Nevada","NV",2020-04-12,2020-04-18,7,2020,"16",3080156,546,66,525,21,480,2.14274861403124,0.68178364991903,0.04
"United States","Nevada","NV",2020-04-19,2020-04-25,7,2020,"17",3080156,565,48,517,48,517,1.55836262838635,1.55836262838635,0.0928433268858802
"United States","Nevada","NV",2020-04-26,2020-05-02,7,2020,"18",3080156,547,53,514,33,494,1.72069206884327,1.07137430701562,0.0642023346303502
"United States","Nevada","NV",2020-05-03,2020-05-09,7,2020,"19",3080156,544,49,507,37,495,1.59082851647774,1.20123785938115,0.0729783037475344
"United States","Nevada","NV",2020-05-10,2020-05-16,7,2020,"20",3080156,514,44,499,15,470,1.42849907602082,0.486988321370736,0.0300601202404809
"United States","Nevada","NV",2020-05-17,2020-05-23,7,2020,"21",3080156,536,44,497,39,492,1.42849907602082,1.26616963556391,0.0784708249496981
"United States","Nevada","NV",2020-05-24,2020-05-30,7,2020,"22",3080156,543,22,495,48,521,0.714249538010412,1.55836262838635,0.0969696969696969
"United States","Nevada","NV",2020-05-31,2020-06-06,7,2020,"23",3080156,562,25,497,65,537,0.81164720228456,2.11028272593986,0.130784708249497
"United States","Nevada","NV",2020-06-07,2020-06-13,7,2020,"24",3080156,543,9,499,44,534,0.292192992822441,1.42849907602082,0.0881763527054109
"United States","Nevada","NV",2020-06-14,2020-06-20,7,2020,"25",3080156,519,23,500,19,496,0.746715426101795,0.616851873736265,0.038
"United States","Nevada","NV",2020-06-21,2020-06-27,7,2020,"26",3080156,557,15,495,62,542,0.486988321370736,2.01288506166571,0.125252525252525
"United States","Nevada","NV",2020-06-28,2020-07-04,7,2020,"27",3080156,528,30,502,26,498,0.973976642741472,0.844113090375942,0.0517928286852589
"United States","Nevada","NV",2020-07-05,2020-07-11,7,2020,"28",3080156,633,59,492,141,574,1.91548739739156,4.57769022088492,0.286585365853659
"United States","Nevada","NV",2020-07-12,2020-07-18,7,2020,"29",3080156,640,57,482,158,583,1.8505556212088,5.12961031843842,0.327800829875519
"United States","Nevada","NV",2020-07-19,2020-07-25,7,2020,"30",3080156,657,86,479,178,571,2.79206637585889,5.77892808026606,0.37160751565762
"United States","Nevada","NV",2020-07-26,2020-08-01,7,2020,"31",3080156,620,100,476,144,520,3.24658880913824,4.67508788515906,0.302521008403361
"United States","Nevada","NV",2020-08-02,2020-08-08,7,2020,"32",3080156,694,117,462,232,577,3.79850890669174,7.53208603720071,0.502164502164502
"United States","Nevada","NV",2020-08-09,2020-08-15,7,2020,"33",3080156,662,120,462,200,542,3.89590657096589,6.49317761827648,0.432900432900433
"United States","Nevada","NV",2020-08-16,2020-08-22,7,2020,"34",3080156,648,128,459,189,520,4.15563367569695,6.13605284927127,0.411764705882353
"United States","Nevada","NV",2020-08-23,2020-08-29,7,2020,"35",3080156,633,105,463,170,528,3.40891824959515,5.51920097553501,0.367170626349892
"United States","Nevada","NV",2020-08-30,2020-09-05,7,2020,"36",3080156,640,86,457,183,554,2.79206637585889,5.94125752072298,0.400437636761488
"United States","Nevada","NV",2020-09-06,2020-09-12,7,2020,"37",3080156,559,61,462,97,498,1.98041917357433,3.14919114486409,0.20995670995671
"United States","Nevada","NV",2020-09-13,2020-09-19,7,2020,"38",3080156,537,79,462,75,458,2.56480515921921,2.43494160685368,0.162337662337662
"United States","Nevada","NV",2020-09-20,2020-09-26,7,2020,"39",3080156,528,54,462,66,474,1.75315795693465,2.14274861403124,0.142857142857143
"United States","Nevada","NV",2020-09-27,2020-10-03,7,2020,"40",3080156,564,38,468,96,526,1.23370374747253,3.11672525677271,0.205128205128205
"United States","Nevada","NV",2020-10-04,2020-10-10,7,2020,"41",3080156,558,39,466,92,519,1.26616963556391,2.98686170440718,0.197424892703863
"United States","Nevada","NV",2020-10-11,2020-10-17,7,2020,"42",3080156,526,48,470,56,478,1.55836262838635,1.81808973311741,0.119148936170213
"United States","Nevada","NV",2020-10-18,2020-10-24,7,2020,"43",3080156,541,36,475,66,505,1.16877197128977,2.14274861403124,0.138947368421053
"United States","Nevada","NV",2020-10-25,2020-10-31,7,2020,"44",3080156,604,34,465,139,570,1.103840195107,4.51275844470215,0.298924731182796
"United States","Nevada","NV",2020-11-01,2020-11-07,7,2020,"45",3080156,555,71,469,86,484,2.30507805448815,2.79206637585889,0.183368869936034
"United States","Nevada","NV",2020-11-08,2020-11-14,7,2020,"46",3080156,631,57,486,145,574,1.8505556212088,4.70755377325045,0.29835390946502
"United States","Nevada","NV",2020-11-15,2020-11-21,7,2020,"47",3080156,663,102,484,179,561,3.311520585321,5.81139396835745,0.369834710743802
"United States","Nevada","NV",2020-11-22,2020-11-28,7,2020,"48",3080156,744,105,487,257,639,3.40891824959515,8.34373323948527,0.527720739219713
"United States","Nevada","NV",2020-11-29,2020-12-05,7,2020,"49",3080156,773,170,497,276,603,5.51920097553501,8.96058511322154,0.55533199195171
"United States","Nevada","NV",2020-12-06,2020-12-12,7,2020,"50",3080156,908,214,506,402,694,6.94770005155583,13.0512870127357,0.794466403162055
"United States","Nevada","NV",2020-12-13,2020-12-19,7,2020,"51",3080156,845,222,518,327,623,7.20742715628689,10.616345405882,0.631274131274131
"United States","Nevada","NV",2020-12-20,2020-12-26,7,2020,"52",3080156,867,185,539,328,682,6.00618929690574,10.6488112939734,0.608534322820037
"United States","Nevada","NV",2020-12-27,2021-01-02,7,2020,"53",3080156,856,199,558,298,657,6.46071173018509,9.67483465123195,0.53405017921147
"United States","Nevada","NV",2021-01-03,2021-01-09,7,2021,"1",3080156,885,278,563,322,607,9.0255168894043,10.4540159654251,0.571936056838366
"United States","Nevada","NV",2021-01-10,2021-01-16,7,2021,"2",3080156,845,300,569,276,545,9.73976642741471,8.96058511322154,0.48506151142355
"United States","Nevada","NV",2021-01-17,2021-01-23,7,2021,"3",3080156,825,243,566,259,582,7.88921080620592,8.40866501566804,0.457597173144876
"United States","Nevada","NV",2021-01-24,2021-01-30,7,2021,"4",3080156,782,244,554,228,538,7.9216766942973,7.40222248483518,0.411552346570397
"United States","Nevada","NV",2021-01-31,2021-02-06,7,2021,"5",3080156,719,198,543,176,521,6.42824584209371,5.7139963040833,0.324125230202578
"United States","Nevada","NV",2021-02-07,2021-02-13,7,2021,"6",3080156,702,227,546,156,475,7.3697565967438,5.06467854225565,0.285714285714286
"United States","Nevada","NV",2021-02-14,2021-02-20,7,2021,"7",3080156,637,172,532,105,465,5.58413275171777,3.40891824959515,0.197368421052632
"United States","Nevada","NV",2021-02-21,2021-02-27,7,2021,"8",3080156,674,90,524,150,584,2.92192992822441,4.86988321370736,0.286259541984733
"United States","Nevada","NV",2021-02-28,2021-03-06,7,2021,"9",3080156,564,77,533,31,487,2.49987338303644,1.00644253083285,0.0581613508442778
"United States","Nevada","NV",2021-03-07,2021-03-13,7,2021,"10",3080156,613,60,531,82,553,1.94795328548294,2.66220282349336,0.154425612052731
"United States","Nevada","NV",2021-03-14,2021-03-20,7,2021,"11",3080156,600,71,530,70,529,2.30507805448815,2.27261216639677,0.132075471698113
"United States","Nevada","NV",2021-03-21,2021-03-27,7,2021,"12",3080156,558,61,523,35,497,1.98041917357433,1.13630608319838,0.0669216061185469
"United States","Nevada","NV",2021-03-28,2021-04-03,7,2021,"13",3080156,580,38,522,58,542,1.23370374747253,1.88302150930018,0.111111111111111
"United States","Nevada","NV",2021-04-04,2021-04-10,7,2021,"14",3080156,549,171,522,27,378,5.55166686362639,0.876578978467324,0.0517241379310345
"United States","Nevada","NV",2021-04-11,2021-04-17,7,2021,"15",3080156,540,33,523,17,507,1.07137430701562,0.551920097553501,0.0325047801147227
"United States","Nevada","NV",2021-04-18,2021-04-24,7,2021,"16",3080156,582,57,519,63,525,1.8505556212088,2.04535094975709,0.121387283236994
"United States","Nevada","NV",2021-04-25,2021-05-01,7,2021,"17",3080156,557,42,510,47,515,1.36356729983806,1.52589674029497,0.0921568627450979
"United States","Nevada","NV",2021-05-02,2021-05-08,7,2021,"18",3080156,595,34,502,93,561,1.103840195107,3.01932759249856,0.185258964143426
"United States","Nevada","NV",2021-05-09,2021-05-15,7,2021,"19",3080156,560,32,501,59,528,1.03890841892424,1.91548739739156,0.117764471057884
"United States","Nevada","NV",2021-05-16,2021-05-22,7,2021,"20",3080156,513,22,498,15,491,0.714249538010412,0.486988321370736,0.0301204819277108
"United States","Nevada","NV",2021-05-23,2021-05-29,7,2021,"21",3080156,500,34,503,-3,466,1.103840195107,-0.0973976642741472,-0.00596421471172959
"United States","Nevada","NV",2021-05-30,2021-06-05,7,2021,"22",3080156,572,14,508,64,558,0.454522433279353,2.07781683784847,0.125984251968504
"United States","Nevada","NV",2021-06-06,2021-06-12,7,2021,"23",3080156,547,22,511,36,525,0.714249538010412,1.16877197128977,0.0704500978473581
"United States","Nevada","NV",2021-06-13,2021-06-19,7,2021,"24",3080156,568,27,524,44,541,0.876578978467324,1.42849907602082,0.083969465648855
"United States","Nevada","NV",2021-06-20,2021-06-26,7,2021,"25",3080156,543,18,520,23,525,0.584385985644883,0.746715426101795,0.0442307692307693
"United States","Nevada","NV",2021-06-27,2021-07-03,7,2021,"26",3080156,556,30,519,37,526,0.973976642741472,1.20123785938115,0.071290944123314
"United States","Nevada","NV",2021-07-04,2021-07-10,7,2021,"27",3080156,593,23,513,80,570,0.746715426101795,2.59727104731059,0.155945419103314
"United States","Nevada","NV",2021-07-11,2021-07-17,7,2021,"28",3080156,663,38,511,152,625,1.23370374747253,4.93481498989012,0.297455968688845
"United States","Nevada","NV",2021-07-18,2021-07-24,7,2021,"29",3080156,577,59,510,67,518,1.91548739739156,2.17521450212262,0.131372549019608
"United States","Nevada","NV",2021-07-25,2021-07-31,7,2021,"30",3080156,605,95,501,104,510,3.08425936868133,3.37645236150377,0.207584830339321
"United States","Nevada","NV",2021-08-01,2021-08-07,7,2021,"31",3080156,458,93,496,-38,365,3.01932759249856,-1.23370374747253,-0.0766129032258065
"United States","New Hampshire","NH",2019-12-29,2020-01-04,7,2020,"1",1359711,260,0,268,-8,260,0,-0.588360320685793,-0.0298507462686567
"United States","New Hampshire","NH",2020-01-05,2020-01-11,7,2020,"2",1359711,263,0,271,-8,263,0,-0.588360320685793,-0.0295202952029521
"United States","New Hampshire","NH",2020-01-12,2020-01-18,7,2020,"3",1359711,245,0,273,-28,245,0,-2.05926112240028,-0.102564102564103
"United States","New Hampshire","NH",2020-01-19,2020-01-25,7,2020,"4",1359711,241,0,274,-33,241,0,-2.4269863228289,-0.12043795620438
"United States","New Hampshire","NH",2020-01-26,2020-02-01,7,2020,"5",1359711,240,0,271,-31,240,0,-2.27989624265745,-0.114391143911439
"United States","New Hampshire","NH",2020-02-02,2020-02-08,7,2020,"6",1359711,256,0,276,-20,256,0,-1.47090080171448,-0.072463768115942
"United States","New Hampshire","NH",2020-02-09,2020-02-15,7,2020,"7",1359711,236,0,273,-37,236,0,-2.72116648317179,-0.135531135531135
"United States","New Hampshire","NH",2020-02-16,2020-02-22,7,2020,"8",1359711,277,0,271,6,277,0,0.441270240514345,0.0221402214022139
"United States","New Hampshire","NH",2020-02-23,2020-02-29,7,2020,"9",1359711,228,0,265,-37,228,0,-2.72116648317179,-0.139622641509434
"United States","New Hampshire","NH",2020-03-01,2020-03-07,7,2020,"10",1359711,266,0,256,10,266,0,0.735450400857241,0.0390625
"United States","New Hampshire","NH",2020-03-08,2020-03-14,7,2020,"11",1359711,240,0,249,-9,240,0,-0.661905360771517,-0.036144578313253
"United States","New Hampshire","NH",2020-03-15,2020-03-21,7,2020,"12",1359711,252,0,249,3,252,0,0.220635120257172,0.0120481927710843
"United States","New Hampshire","NH",2020-03-22,2020-03-28,7,2020,"13",1359711,258,3,247,11,255,0.220635120257172,0.808995440942965,0.0445344129554657
"United States","New Hampshire","NH",2020-03-29,2020-04-04,7,2020,"14",1359711,248,6,245,3,242,0.441270240514345,0.220635120257172,0.0122448979591836
"United States","New Hampshire","NH",2020-04-05,2020-04-11,7,2020,"15",1359711,270,14,251,19,256,1.02963056120014,1.39735576162876,0.0756972111553784
"United States","New Hampshire","NH",2020-04-12,2020-04-18,7,2020,"16",1359711,242,15,252,-10,227,1.10317560128586,-0.735450400857241,-0.0396825396825397
"United States","New Hampshire","NH",2020-04-19,2020-04-25,7,2020,"17",1359711,274,22,251,23,252,1.61799088188593,1.69153592197165,0.0916334661354581
"United States","New Hampshire","NH",2020-04-26,2020-05-02,7,2020,"18",1359711,266,24,249,17,242,1.76508096205738,1.25026568145731,0.0682730923694779
"United States","New Hampshire","NH",2020-05-03,2020-05-09,7,2020,"19",1359711,292,47,246,46,245,3.45661688402903,3.38307184394331,0.186991869918699
"United States","New Hampshire","NH",2020-05-10,2020-05-16,7,2020,"20",1359711,285,40,240,45,245,2.94180160342896,3.30952680385758,0.1875
"United States","New Hampshire","NH",2020-05-17,2020-05-23,7,2020,"21",1359711,268,37,236,32,231,2.72116648317179,2.35344128274317,0.135593220338983
"United States","New Hampshire","NH",2020-05-24,2020-05-30,7,2020,"22",1359711,250,34,234,16,216,2.50053136291462,1.17672064137159,0.0683760683760684
"United States","New Hampshire","NH",2020-05-31,2020-06-06,7,2020,"23",1359711,259,41,233,26,218,3.01534664351469,1.91217104222883,0.111587982832618
"United States","New Hampshire","NH",2020-06-07,2020-06-13,7,2020,"24",1359711,302,35,232,70,267,2.57407640300034,5.14815280600069,0.301724137931034
"United States","New Hampshire","NH",2020-06-14,2020-06-20,7,2020,"25",1359711,238,21,235,3,217,1.54444584180021,0.220635120257172,0.0127659574468084
"United States","New Hampshire","NH",2020-06-21,2020-06-27,7,2020,"26",1359711,250,28,239,11,222,2.05926112240028,0.808995440942965,0.0460251046025104
"United States","New Hampshire","NH",2020-06-28,2020-07-04,7,2020,"27",1359711,247,9,237,10,238,0.661905360771517,0.735450400857241,0.0421940928270041
"United States","New Hampshire","NH",2020-07-05,2020-07-11,7,2020,"28",1359711,249,15,238,11,234,1.10317560128586,0.808995440942965,0.046218487394958
"United States","New Hampshire","NH",2020-07-12,2020-07-18,7,2020,"29",1359711,231,5,239,-8,226,0.367725200428621,-0.588360320685793,-0.0334728033472803
"United States","New Hampshire","NH",2020-07-19,2020-07-25,7,2020,"30",1359711,266,13,239,27,253,0.956085521114413,1.98571608231455,0.112970711297071
"United States","New Hampshire","NH",2020-07-26,2020-08-01,7,2020,"31",1359711,248,7,240,8,241,0.514815280600069,0.588360320685793,0.0333333333333334
"United States","New Hampshire","NH",2020-08-02,2020-08-08,7,2020,"32",1359711,233,3,241,-8,230,0.220635120257172,-0.588360320685793,-0.033195020746888
"United States","New Hampshire","NH",2020-08-09,2020-08-15,7,2020,"33",1359711,230,4,239,-9,226,0.294180160342896,-0.661905360771517,-0.0376569037656904
"United States","New Hampshire","NH",2020-08-16,2020-08-22,7,2020,"34",1359711,250,6,237,13,244,0.441270240514345,0.956085521114413,0.0548523206751055
"United States","New Hampshire","NH",2020-08-23,2020-08-29,7,2020,"35",1359711,231,3,239,-8,228,0.220635120257172,-0.588360320685793,-0.0334728033472803
"United States","New Hampshire","NH",2020-08-30,2020-09-05,7,2020,"36",1359711,234,0,241,-7,234,0,-0.514815280600069,-0.029045643153527
"United States","New Hampshire","NH",2020-09-06,2020-09-12,7,2020,"37",1359711,228,3,238,-10,225,0.220635120257172,-0.735450400857241,-0.042016806722689
"United States","New Hampshire","NH",2020-09-13,2020-09-19,7,2020,"38",1359711,226,3,240,-14,223,0.220635120257172,-1.02963056120014,-0.0583333333333333
"United States","New Hampshire","NH",2020-09-20,2020-09-26,7,2020,"39",1359711,273,1,247,26,272,0.0735450400857241,1.91217104222883,0.105263157894737
"United States","New Hampshire","NH",2020-09-27,2020-10-03,7,2020,"40",1359711,222,3,244,-22,219,0.220635120257172,-1.61799088188593,-0.0901639344262295
"United States","New Hampshire","NH",2020-10-04,2020-10-10,7,2020,"41",1359711,255,13,244,11,242,0.956085521114413,0.808995440942965,0.0450819672131149
"United States","New Hampshire","NH",2020-10-11,2020-10-17,7,2020,"42",1359711,253,11,248,5,242,0.808995440942965,0.367725200428621,0.0201612903225807
"United States","New Hampshire","NH",2020-10-18,2020-10-24,7,2020,"43",1359711,234,7,249,-15,227,0.514815280600069,-1.10317560128586,-0.0602409638554217
"United States","New Hampshire","NH",2020-10-25,2020-10-31,7,2020,"44",1359711,257,10,242,15,247,0.735450400857241,1.10317560128586,0.0619834710743801
"United States","New Hampshire","NH",2020-11-01,2020-11-07,7,2020,"45",1359711,263,6,239,24,257,0.441270240514345,1.76508096205738,0.100418410041841
"United States","New Hampshire","NH",2020-11-08,2020-11-14,7,2020,"46",1359711,285,10,241,44,275,0.735450400857241,3.23598176377186,0.182572614107884
"United States","New Hampshire","NH",2020-11-15,2020-11-21,7,2020,"47",1359711,259,9,242,17,250,0.661905360771517,1.25026568145731,0.0702479338842976
"United States","New Hampshire","NH",2020-11-22,2020-11-28,7,2020,"48",1359711,284,6,245,39,278,0.441270240514345,2.86825656334324,0.159183673469388
"United States","New Hampshire","NH",2020-11-29,2020-12-05,7,2020,"49",1359711,313,45,245,68,268,3.30952680385758,5.00106272582924,0.277551020408163
"United States","New Hampshire","NH",2020-12-06,2020-12-12,7,2020,"50",1359711,312,41,251,61,271,3.01534664351469,4.48624744522917,0.243027888446215
"United States","New Hampshire","NH",2020-12-13,2020-12-19,7,2020,"51",1359711,288,50,252,36,238,3.6772520042862,2.64762144308607,0.142857142857143
"United States","New Hampshire","NH",2020-12-20,2020-12-26,7,2020,"52",1359711,357,6,253,104,351,0.441270240514345,7.64868416891531,0.411067193675889
"United States","New Hampshire","NH",2020-12-27,2021-01-02,7,2020,"53",1359711,305,113,260,45,192,8.31058952968682,3.30952680385758,0.173076923076923
"United States","New Hampshire","NH",2021-01-03,2021-01-09,7,2021,"1",1359711,323,77,259,64,246,5.66296808660076,4.70688256548634,0.247104247104247
"United States","New Hampshire","NH",2021-01-10,2021-01-16,7,2021,"2",1359711,357,81,260,97,276,5.95714824694365,7.13386888831524,0.373076923076923
"United States","New Hampshire","NH",2021-01-17,2021-01-23,7,2021,"3",1359711,296,44,264,32,252,3.23598176377186,2.35344128274317,0.121212121212121
"United States","New Hampshire","NH",2021-01-24,2021-01-30,7,2021,"4",1359711,272,71,265,7,201,5.22169784608641,0.514815280600069,0.0264150943396226
"United States","New Hampshire","NH",2021-01-31,2021-02-06,7,2021,"5",1359711,289,56,262,27,233,4.11852224480055,1.98571608231455,0.103053435114504
"United States","New Hampshire","NH",2021-02-07,2021-02-13,7,2021,"6",1359711,257,32,266,-9,225,2.35344128274317,-0.661905360771517,-0.0338345864661654
"United States","New Hampshire","NH",2021-02-14,2021-02-20,7,2021,"7",1359711,264,23,258,6,241,1.69153592197165,0.441270240514345,0.0232558139534884
"United States","New Hampshire","NH",2021-02-21,2021-02-27,7,2021,"8",1359711,248,17,258,-10,231,1.25026568145731,-0.735450400857241,-0.0387596899224806
"United States","New Hampshire","NH",2021-02-28,2021-03-06,7,2021,"9",1359711,250,11,252,-2,239,0.808995440942965,-0.147090080171448,-0.00793650793650791
"United States","New Hampshire","NH",2021-03-07,2021-03-13,7,2021,"10",1359711,241,14,243,-2,227,1.02963056120014,-0.147090080171448,-0.00823045267489708
"United States","New Hampshire","NH",2021-03-14,2021-03-20,7,2021,"11",1359711,234,22,239,-5,212,1.61799088188593,-0.367725200428621,-0.0209205020920502
"United States","New Hampshire","NH",2021-03-21,2021-03-27,7,2021,"12",1359711,249,14,239,10,235,1.02963056120014,0.735450400857241,0.0418410041841004
"United States","New Hampshire","NH",2021-03-28,2021-04-03,7,2021,"13",1359711,217,16,233,-16,201,1.17672064137159,-1.17672064137159,-0.0686695278969958
"United States","New Hampshire","NH",2021-04-04,2021-04-10,7,2021,"14",1359711,233,9,235,-2,224,0.661905360771517,-0.147090080171448,-0.00851063829787235
"United States","New Hampshire","NH",2021-04-11,2021-04-17,7,2021,"15",1359711,228,10,237,-9,218,0.735450400857241,-0.661905360771517,-0.0379746835443038
"United States","New Hampshire","NH",2021-04-18,2021-04-24,7,2021,"16",1359711,258,16,237,21,242,1.17672064137159,1.54444584180021,0.0886075949367089
"United States","New Hampshire","NH",2021-04-25,2021-05-01,7,2021,"17",1359711,250,22,235,15,228,1.61799088188593,1.10317560128586,0.0638297872340425
"United States","New Hampshire","NH",2021-05-02,2021-05-08,7,2021,"18",1359711,248,10,237,11,238,0.735450400857241,0.808995440942965,0.0464135021097047
"United States","New Hampshire","NH",2021-05-09,2021-05-15,7,2021,"19",1359711,235,20,229,6,215,1.47090080171448,0.441270240514345,0.0262008733624455
"United States","New Hampshire","NH",2021-05-16,2021-05-22,7,2021,"20",1359711,274,13,223,51,261,0.956085521114413,3.75079704437193,0.228699551569507
"United States","New Hampshire","NH",2021-05-23,2021-05-29,7,2021,"21",1359711,233,8,216,17,225,0.588360320685793,1.25026568145731,0.0787037037037037
"United States","New Hampshire","NH",2021-05-30,2021-06-05,7,2021,"22",1359711,250,3,218,32,247,0.220635120257172,2.35344128274317,0.146788990825688
"United States","New Hampshire","NH",2021-06-06,2021-06-12,7,2021,"23",1359711,255,5,217,38,250,0.367725200428621,2.79471152325752,0.175115207373272
"United States","New Hampshire","NH",2021-06-13,2021-06-19,7,2021,"24",1359711,244,7,215,29,237,0.514815280600069,2.132806162486,0.134883720930232
"United States","New Hampshire","NH",2021-06-20,2021-06-26,7,2021,"25",1359711,240,4,218,22,236,0.294180160342896,1.61799088188593,0.100917431192661
"United States","New Hampshire","NH",2021-06-27,2021-07-03,7,2021,"26",1359711,260,1,223,37,259,0.0735450400857241,2.72116648317179,0.165919282511211
"United States","New Hampshire","NH",2021-07-04,2021-07-10,7,2021,"27",1359711,248,3,223,25,245,0.220635120257172,1.8386260021431,0.112107623318386
"United States","New Hampshire","NH",2021-07-11,2021-07-17,7,2021,"28",1359711,242,6,222,20,236,0.441270240514345,1.47090080171448,0.0900900900900901
"United States","New Hampshire","NH",2021-07-18,2021-07-24,7,2021,"29",1359711,252,4,230,22,248,0.294180160342896,1.61799088188593,0.0956521739130434
"United States","New Hampshire","NH",2021-07-25,2021-07-31,7,2021,"30",1359711,237,2,230,7,235,0.147090080171448,0.514815280600069,0.0304347826086957
"United States","New Hampshire","NH",2021-08-01,2021-08-07,7,2021,"31",1359711,244,2,231,13,242,0.147090080171448,0.956085521114413,0.0562770562770563
"United States","New Jersey","NJ",2019-12-29,2020-01-04,7,2020,"1",8882190,1628,0,1640,-12,1628,0,-0.135101816106163,-0.00731707317073171
"United States","New Jersey","NJ",2020-01-05,2020-01-11,7,2020,"2",8882190,1588,0,1660,-72,1588,0,-0.810610896636978,-0.0433734939759036
"United States","New Jersey","NJ",2020-01-12,2020-01-18,7,2020,"3",8882190,1490,0,1663,-173,1490,0,-1.94771784886385,-0.104028863499699
"United States","New Jersey","NJ",2020-01-19,2020-01-25,7,2020,"4",8882190,1579,0,1655,-76,1579,0,-0.855644835339032,-0.0459214501510574
"United States","New Jersey","NJ",2020-01-26,2020-02-01,7,2020,"5",8882190,1517,0,1636,-119,1517,0,-1.33975967638612,-0.0727383863080685
"United States","New Jersey","NJ",2020-02-02,2020-02-08,7,2020,"6",8882190,1495,0,1620,-125,1495,0,-1.4073105844392,-0.0771604938271605
"United States","New Jersey","NJ",2020-02-09,2020-02-15,7,2020,"7",8882190,1488,0,1596,-108,1488,0,-1.21591634495547,-0.0676691729323309
"United States","New Jersey","NJ",2020-02-16,2020-02-22,7,2020,"8",8882190,1494,0,1579,-85,1494,0,-0.956971197418655,-0.0538315389487017
"United States","New Jersey","NJ",2020-02-23,2020-02-29,7,2020,"9",8882190,1571,0,1551,20,1571,0,0.225169693510272,0.0128949065119277
"United States","New Jersey","NJ",2020-03-01,2020-03-07,7,2020,"10",8882190,1509,0,1543,-34,1509,0,-0.382788478967462,-0.0220349967595593
"United States","New Jersey","NJ",2020-03-08,2020-03-14,7,2020,"11",8882190,1477,1,1540,-63,1476,0.0112584846755136,-0.709284534557356,-0.0409090909090909
"United States","New Jersey","NJ",2020-03-15,2020-03-21,7,2020,"12",8882190,1600,15,1521,79,1585,0.168877270132704,0.889420289365573,0.051939513477975
"United States","New Jersey","NJ",2020-03-22,2020-03-28,7,2020,"13",8882190,2124,124,1520,604,2000,1.39605209976368,6.8001247440102,0.397368421052632
"United States","New Jersey","NJ",2020-03-29,2020-04-04,7,2020,"14",8882190,3484,697,1504,1980,2787,7.84716381883297,22.2917996575169,1.31648936170213
"United States","New Jersey","NJ",2020-04-05,2020-04-11,7,2020,"15",8882190,4774,1346,1482,3292,3428,15.1539203732413,37.0629315517907,2.22132253711201
"United States","New Jersey","NJ",2020-04-12,2020-04-18,7,2020,"16",8882190,4733,1888,1470,3263,2845,21.2560190673696,36.7364354962008,2.21972789115646
"United States","New Jersey","NJ",2020-04-19,2020-04-25,7,2020,"17",8882190,3979,1795,1448,2531,2184,20.2089799925469,28.4952247137249,1.74792817679558
"United States","New Jersey","NJ",2020-04-26,2020-05-02,7,2020,"18",8882190,3181,1876,1426,1755,1305,21.1209172512635,19.7586406055263,1.23071528751753
"United States","New Jersey","NJ",2020-05-03,2020-05-09,7,2020,"19",8882190,2603,1373,1411,1192,1230,15.4578994594802,13.4201137332122,0.84479092841956
"United States","New Jersey","NJ",2020-05-10,2020-05-16,7,2020,"20",8882190,2287,1134,1391,896,1153,12.7671216220324,10.0876022692602,0.644140905823149
"United States","New Jersey","NJ",2020-05-17,2020-05-23,7,2020,"21",8882190,1937,831,1372,565,1106,9.35580076535179,6.36104384166517,0.411807580174927
"United States","New Jersey","NJ",2020-05-24,2020-05-30,7,2020,"22",8882190,1746,553,1376,370,1193,6.22594202555901,4.16563932994003,0.268895348837209
"United States","New Jersey","NJ",2020-05-31,2020-06-06,7,2020,"23",8882190,1587,472,1386,201,1115,5.31400476684241,2.26295541977823,0.145021645021645
"United States","New Jersey","NJ",2020-06-07,2020-06-13,7,2020,"24",8882190,1486,482,1372,114,1004,5.42658961359755,1.28346725300855,0.0830903790087463
"United States","New Jersey","NJ",2020-06-14,2020-06-20,7,2020,"25",8882190,1412,269,1382,30,1143,3.02853237771315,0.337754540265408,0.0217076700434153
"United States","New Jersey","NJ",2020-06-21,2020-06-27,7,2020,"26",8882190,1445,2092,1384,61,-647,23.5527499411744,0.686767565206329,0.0440751445086704
"United States","New Jersey","NJ",2020-06-28,2020-07-04,7,2020,"27",8882190,1407,241,1378,29,1166,2.71329480679877,0.326496055589894,0.021044992743106
"United States","New Jersey","NJ",2020-07-05,2020-07-11,7,2020,"28",8882190,1389,336,1376,13,1053,3.78285085097256,0.146360300781677,0.00944767441860472
"United States","New Jersey","NJ",2020-07-12,2020-07-18,7,2020,"29",8882190,1324,174,1373,-49,1150,1.95897633353936,-0.551665749100166,-0.0356882738528769
"United States","New Jersey","NJ",2020-07-19,2020-07-25,7,2020,"30",8882190,1370,77,1365,5,1293,0.866903320014546,0.0562924233775679,0.00366300366300365
"United States","New Jersey","NJ",2020-07-26,2020-08-01,7,2020,"31",8882190,1392,54,1368,24,1338,0.607958172477734,0.270203632212326,0.0175438596491229
"United States","New Jersey","NJ",2020-08-02,2020-08-08,7,2020,"32",8882190,1344,39,1364,-20,1305,0.43908090234503,-0.225169693510272,-0.0146627565982405
"United States","New Jersey","NJ",2020-08-09,2020-08-15,7,2020,"33",8882190,1308,41,1368,-60,1267,0.461597871696057,-0.675509080530815,-0.043859649122807
"United States","New Jersey","NJ",2020-08-16,2020-08-22,7,2020,"34",8882190,1341,33,1371,-30,1308,0.371529994291948,-0.337754540265408,-0.0218818380743983
"United States","New Jersey","NJ",2020-08-23,2020-08-29,7,2020,"35",8882190,1335,-10,1363,-28,1345,-0.112584846755136,-0.31523757091438,-0.020542920029347
"United States","New Jersey","NJ",2020-08-30,2020-09-05,7,2020,"36",8882190,1397,52,1364,33,1345,0.585441203126706,0.371529994291948,0.0241935483870968
"United States","New Jersey","NJ",2020-09-06,2020-09-12,7,2020,"37",8882190,1389,42,1350,39,1347,0.472856356371571,0.43908090234503,0.028888888888889
"United States","New Jersey","NJ",2020-09-13,2020-09-19,7,2020,"38",8882190,1378,37,1344,34,1341,0.416563932994003,0.382788478967462,0.0252976190476191
"United States","New Jersey","NJ",2020-09-20,2020-09-26,7,2020,"39",8882190,1395,39,1337,58,1356,0.43908090234503,0.652992111179788,0.0433807030665669
"United States","New Jersey","NJ",2020-09-27,2020-10-03,7,2020,"40",8882190,1330,32,1343,-13,1298,0.360271509616435,-0.146360300781677,-0.00967982129560685
"United States","New Jersey","NJ",2020-10-04,2020-10-10,7,2020,"41",8882190,1401,36,1361,40,1365,0.405305448318489,0.450339387020543,0.0293901542983102
"United States","New Jersey","NJ",2020-10-11,2020-10-17,7,2020,"42",8882190,1341,33,1370,-29,1308,0.371529994291948,-0.326496055589894,-0.0211678832116788
"United States","New Jersey","NJ",2020-10-18,2020-10-24,7,2020,"43",8882190,1470,77,1373,97,1393,0.866903320014546,1.09207301352482,0.0706482155863073
"United States","New Jersey","NJ",2020-10-25,2020-10-31,7,2020,"44",8882190,1434,67,1384,50,1367,0.75431847325941,0.562924233775679,0.0361271676300579
"United States","New Jersey","NJ",2020-11-01,2020-11-07,7,2020,"45",8882190,1567,77,1405,162,1490,0.866903320014546,1.8238745174332,0.115302491103203
"United States","New Jersey","NJ",2020-11-08,2020-11-14,7,2020,"46",8882190,1632,123,1424,208,1509,1.38479361508817,2.34176481250683,0.146067415730337
"United States","New Jersey","NJ",2020-11-15,2020-11-21,7,2020,"47",8882190,1677,198,1436,241,1479,2.22917996575169,2.71329480679877,0.167827298050139
"United States","New Jersey","NJ",2020-11-22,2020-11-28,7,2020,"48",8882190,1697,219,1449,248,1478,2.46560814393747,2.79210419952737,0.171152518978606
"United States","New Jersey","NJ",2020-11-29,2020-12-05,7,2020,"49",8882190,1904,339,1462,442,1565,3.8166263049991,4.976250226577,0.302325581395349
"United States","New Jersey","NJ",2020-12-06,2020-12-12,7,2020,"50",8882190,2026,427,1471,555,1599,4.8073729564443,6.24845899491004,0.377294357579878
"United States","New Jersey","NJ",2020-12-13,2020-12-19,7,2020,"51",8882190,2094,442,1479,615,1652,4.976250226577,6.92396807544085,0.415821501014199
"United States","New Jersey","NJ",2020-12-20,2020-12-26,7,2020,"52",8882190,2065,438,1493,572,1627,4.93121628787495,6.43985323439377,0.38312123241795
"United States","New Jersey","NJ",2020-12-27,2021-01-02,7,2020,"53",8882190,2215,576,1522,693,1639,6.48488717309582,7.80212988013091,0.455321944809461
"United States","New Jersey","NJ",2021-01-03,2021-01-09,7,2021,"1",8882190,2055,667,1539,516,1388,7.50940927856756,5.80937809256501,0.335282651072125
"United States","New Jersey","NJ",2021-01-10,2021-01-16,7,2021,"2",8882190,2159,560,1562,597,1599,6.30475141828761,6.72131535128161,0.382202304737516
"United States","New Jersey","NJ",2021-01-17,2021-01-23,7,2021,"3",8882190,1989,520,1580,409,1469,5.85441203126706,4.60472023228506,0.258860759493671
"United States","New Jersey","NJ",2021-01-24,2021-01-30,7,2021,"4",8882190,2004,521,1590,414,1483,5.86567051594258,4.66101265566262,0.260377358490566
"United States","New Jersey","NJ",2021-01-31,2021-02-06,7,2021,"5",8882190,2028,509,1588,440,1519,5.73056869983641,4.95373325722598,0.277078085642317
"United States","New Jersey","NJ",2021-02-07,2021-02-13,7,2021,"6",8882190,1860,476,1582,278,1384,5.35903870554447,3.12985873979278,0.175726927939317
"United States","New Jersey","NJ",2021-02-14,2021-02-20,7,2021,"7",8882190,1821,395,1559,262,1426,4.44710144682787,2.94972298498456,0.168056446440026
"United States","New Jersey","NJ",2021-02-21,2021-02-27,7,2021,"8",8882190,1808,404,1542,266,1404,4.54842780890749,2.99475692368661,0.172503242542153
"United States","New Jersey","NJ",2021-02-28,2021-03-06,7,2021,"9",8882190,1722,318,1523,199,1404,3.58019812681332,2.2404384504272,0.130663164806303
"United States","New Jersey","NJ",2021-03-07,2021-03-13,7,2021,"10",8882190,1594,331,1500,94,1263,3.726558427595,1.05829755949828,0.0626666666666666
"United States","New Jersey","NJ",2021-03-14,2021-03-20,7,2021,"11",8882190,1681,246,1484,197,1435,2.76958723017634,2.21792148107618,0.132749326145553
"United States","New Jersey","NJ",2021-03-21,2021-03-27,7,2021,"12",8882190,1631,248,1471,160,1383,2.79210419952737,1.80135754808217,0.108769544527532
"United States","New Jersey","NJ",2021-03-28,2021-04-03,7,2021,"13",8882190,1597,255,1461,136,1342,2.87091359225596,1.53115391586985,0.0930869267624914
"United States","New Jersey","NJ",2021-04-04,2021-04-10,7,2021,"14",8882190,1685,222,1449,236,1463,2.49938359796402,2.65700238342121,0.162870945479641
"United States","New Jersey","NJ",2021-04-11,2021-04-17,7,2021,"15",8882190,1592,275,1430,162,1317,3.09608328576624,1.8238745174332,0.113286713286713
"United States","New Jersey","NJ",2021-04-18,2021-04-24,7,2021,"16",8882190,1667,233,1408,259,1434,2.62322692939467,2.91594753095802,0.183948863636364
"United States","New Jersey","NJ",2021-04-25,2021-05-01,7,2021,"17",8882190,1654,221,1390,264,1433,2.4881251132885,2.97223995433559,0.189928057553957
"United States","New Jersey","NJ",2021-05-02,2021-05-08,7,2021,"18",8882190,1479,203,1374,105,1276,2.28547238912926,1.18214089092893,0.0764192139737991
"United States","New Jersey","NJ",2021-05-09,2021-05-15,7,2021,"19",8882190,1484,161,1378,106,1323,1.81261603275769,1.19339937560444,0.0769230769230769
"United States","New Jersey","NJ",2021-05-16,2021-05-22,7,2021,"20",8882190,1471,132,1366,105,1339,1.48611997716779,1.18214089092893,0.0768667642752563
"United States","New Jersey","NJ",2021-05-23,2021-05-29,7,2021,"21",8882190,1334,75,1357,-23,1259,0.844386350663519,-0.258945147536812,-0.0169491525423728
"United States","New Jersey","NJ",2021-05-30,2021-06-05,7,2021,"22",8882190,1428,0,1355,73,1428,0,0.821869381312492,0.0538745387453874
"United States","New Jersey","NJ",2021-06-06,2021-06-12,7,2021,"23",8882190,1332,0,1362,-30,1332,0,-0.337754540265408,-0.0220264317180616
"United States","New Jersey","NJ",2021-06-13,2021-06-19,7,2021,"24",8882190,1351,198,1365,-14,1153,2.22917996575169,-0.15761878545719,-0.0102564102564102
"United States","New Jersey","NJ",2021-06-20,2021-06-26,7,2021,"25",8882190,1390,53,1367,23,1337,0.59669968780222,0.258945147536812,0.0168251645940014
"United States","New Jersey","NJ",2021-06-27,2021-07-03,7,2021,"26",8882190,1394,0,1365,29,1394,0,0.326496055589894,0.0212454212454212
"United States","New Jersey","NJ",2021-07-04,2021-07-10,7,2021,"27",8882190,1408,80,1374,34,1328,0.900678774041087,0.382788478967462,0.024745269286754
"United States","New Jersey","NJ",2021-07-11,2021-07-17,7,2021,"28",8882190,1323,0,1364,-41,1323,0,-0.461597871696057,-0.0300586510263929
"United States","New Jersey","NJ",2021-07-18,2021-07-24,7,2021,"29",8882190,1409,55,1364,45,1354,0.619216657153247,0.506631810398111,0.032991202346041
"United States","New Jersey","NJ",2021-07-25,2021-07-31,7,2021,"30",8882190,1341,34,1354,-13,1307,0.382788478967462,-0.146360300781677,-0.00960118168389956
"United States","New Jersey","NJ",2021-08-01,2021-08-07,7,2021,"31",8882190,1300,27,1357,-57,1273,0.303979086238867,-0.641733626504274,-0.0420044215180545
"United States","New Mexico","NM",2019-12-29,2020-01-04,7,2020,"1",2096829,408,0,395,13,408,0,0.619983794577431,0.0329113924050632
"United States","New Mexico","NM",2020-01-05,2020-01-11,7,2020,"2",2096829,410,0,392,18,410,0,0.858439100184135,0.0459183673469388
"United States","New Mexico","NM",2020-01-12,2020-01-18,7,2020,"3",2096829,388,0,390,-2,388,0,-0.0953821222426817,-0.00512820512820511
"United States","New Mexico","NM",2020-01-19,2020-01-25,7,2020,"4",2096829,404,0,391,13,404,0,0.619983794577431,0.0332480818414322
"United States","New Mexico","NM",2020-01-26,2020-02-01,7,2020,"5",2096829,370,0,391,-21,370,0,-1.00151228354816,-0.0537084398976982
"United States","New Mexico","NM",2020-02-02,2020-02-08,7,2020,"6",2096829,377,0,394,-17,377,0,-0.810748039062794,-0.0431472081218274
"United States","New Mexico","NM",2020-02-09,2020-02-15,7,2020,"7",2096829,382,0,396,-14,382,0,-0.667674855698772,-0.0353535353535354
"United States","New Mexico","NM",2020-02-16,2020-02-22,7,2020,"8",2096829,391,0,399,-8,391,0,-0.381528488970727,-0.0200501253132832
"United States","New Mexico","NM",2020-02-23,2020-02-29,7,2020,"9",2096829,396,0,394,2,396,0,0.0953821222426817,0.0050761421319796
"United States","New Mexico","NM",2020-03-01,2020-03-07,7,2020,"10",2096829,400,0,397,3,400,0,0.143073183364023,0.00755667506297231
"United States","New Mexico","NM",2020-03-08,2020-03-14,7,2020,"11",2096829,342,0,392,-50,342,0,-2.38455305606704,-0.127551020408163
"United States","New Mexico","NM",2020-03-15,2020-03-21,7,2020,"12",2096829,390,0,387,3,390,0,0.143073183364023,0.00775193798449614
"United States","New Mexico","NM",2020-03-22,2020-03-28,7,2020,"13",2096829,365,2,385,-20,363,0.0953821222426817,-0.953821222426817,-0.051948051948052
"United States","New Mexico","NM",2020-03-29,2020-04-04,7,2020,"14",2096829,399,9,381,18,390,0.429219550092068,0.858439100184135,0.0472440944881889
"United States","New Mexico","NM",2020-04-05,2020-04-11,7,2020,"15",2096829,411,9,378,33,402,0.429219550092068,1.57380501700425,0.0873015873015872
"United States","New Mexico","NM",2020-04-12,2020-04-18,7,2020,"16",2096829,422,33,375,47,389,1.57380501700425,2.24147987270302,0.125333333333333
"United States","New Mexico","NM",2020-04-19,2020-04-25,7,2020,"17",2096829,407,40,377,30,367,1.90764244485363,1.43073183364023,0.0795755968169762
"United States","New Mexico","NM",2020-04-26,2020-05-02,7,2020,"18",2096829,420,45,369,51,375,2.14609775046034,2.43224411718838,0.138211382113821
"United States","New Mexico","NM",2020-05-03,2020-05-09,7,2020,"19",2096829,442,53,367,75,389,2.52762623943106,3.57682958410056,0.204359673024523
"United States","New Mexico","NM",2020-05-10,2020-05-16,7,2020,"20",2096829,474,62,362,112,412,2.95684578952313,5.34139884559017,0.30939226519337
"United States","New Mexico","NM",2020-05-17,2020-05-23,7,2020,"21",2096829,396,55,366,30,341,2.62300836167375,1.43073183364023,0.0819672131147542
"United States","New Mexico","NM",2020-05-24,2020-05-30,7,2020,"22",2096829,433,43,358,75,390,2.05071562821766,3.57682958410056,0.209497206703911
"United States","New Mexico","NM",2020-05-31,2020-06-06,7,2020,"23",2096829,448,41,355,93,407,1.95533350597497,4.4352686842847,0.261971830985916
"United States","New Mexico","NM",2020-06-07,2020-06-13,7,2020,"24",2096829,445,39,352,93,406,1.85995138373229,4.4352686842847,0.264204545454545
"United States","New Mexico","NM",2020-06-14,2020-06-20,7,2020,"25",2096829,417,35,355,62,382,1.66918713924693,2.95684578952313,0.174647887323944
"United States","New Mexico","NM",2020-06-21,2020-06-27,7,2020,"26",2096829,399,25,348,51,374,1.19227652803352,2.43224411718838,0.146551724137931
"United States","New Mexico","NM",2020-06-28,2020-07-04,7,2020,"27",2096829,448,22,347,101,426,1.0492033446695,4.81679717325543,0.291066282420749
"United States","New Mexico","NM",2020-07-05,2020-07-11,7,2020,"28",2096829,408,30,349,59,378,1.43073183364023,2.81377260615911,0.169054441260745
"United States","New Mexico","NM",2020-07-12,2020-07-18,7,2020,"29",2096829,402,26,344,58,376,1.23996758915486,2.76608154503777,0.168604651162791
"United States","New Mexico","NM",2020-07-19,2020-07-25,7,2020,"30",2096829,435,38,345,90,397,1.81226032261095,4.29219550092068,0.260869565217391
"United States","New Mexico","NM",2020-07-26,2020-08-01,7,2020,"31",2096829,407,44,343,64,363,2.098406689339,3.05222791176581,0.186588921282799
"United States","New Mexico","NM",2020-08-02,2020-08-08,7,2020,"32",2096829,433,30,343,90,403,1.43073183364023,4.29219550092068,0.262390670553936
"United States","New Mexico","NM",2020-08-09,2020-08-15,7,2020,"33",2096829,394,30,337,57,364,1.43073183364023,2.71839048391643,0.169139465875371
"United States","New Mexico","NM",2020-08-16,2020-08-22,7,2020,"34",2096829,411,32,347,64,379,1.52611395588291,3.05222791176581,0.184438040345821
"United States","New Mexico","NM",2020-08-23,2020-08-29,7,2020,"35",2096829,397,26,349,48,371,1.23996758915486,2.28917093382436,0.137535816618911
"United States","New Mexico","NM",2020-08-30,2020-09-05,7,2020,"36",2096829,376,31,354,22,345,1.47842289476157,1.0492033446695,0.0621468926553672
"United States","New Mexico","NM",2020-09-06,2020-09-12,7,2020,"37",2096829,400,21,352,48,379,1.00151228354816,2.28917093382436,0.136363636363636
"United States","New Mexico","NM",2020-09-13,2020-09-19,7,2020,"38",2096829,398,26,353,45,372,1.23996758915486,2.14609775046034,0.127478753541076
"United States","New Mexico","NM",2020-09-20,2020-09-26,7,2020,"39",2096829,399,23,354,45,376,1.09689440579084,2.14609775046034,0.127118644067797
"United States","New Mexico","NM",2020-09-27,2020-10-03,7,2020,"40",2096829,388,20,350,38,368,0.953821222426817,1.81226032261095,0.108571428571429
"United States","New Mexico","NM",2020-10-04,2020-10-10,7,2020,"41",2096829,389,17,356,33,372,0.810748039062794,1.57380501700425,0.0926966292134832
"United States","New Mexico","NM",2020-10-11,2020-10-17,7,2020,"42",2096829,406,22,363,43,384,1.0492033446695,2.05071562821766,0.118457300275482
"United States","New Mexico","NM",2020-10-18,2020-10-24,7,2020,"43",2096829,434,36,364,70,398,1.71687820036827,3.33837427849386,0.192307692307692
"United States","New Mexico","NM",2020-10-25,2020-10-31,7,2020,"44",2096829,460,53,362,98,407,2.52762623943106,4.6737239898914,0.270718232044199
"United States","New Mexico","NM",2020-11-01,2020-11-07,7,2020,"45",2096829,519,86,361,158,433,4.10143125643531,7.53518765717185,0.437673130193906
"United States","New Mexico","NM",2020-11-08,2020-11-14,7,2020,"46",2096829,577,104,355,222,473,4.95987035661945,10.5874155689377,0.625352112676056
"United States","New Mexico","NM",2020-11-15,2020-11-21,7,2020,"47",2096829,587,142,359,228,445,6.7721306792304,10.8735619356657,0.635097493036212
"United States","New Mexico","NM",2020-11-22,2020-11-28,7,2020,"48",2096829,601,177,365,236,424,8.44131781847733,11.2550904246364,0.646575342465753
"United States","New Mexico","NM",2020-11-29,2020-12-05,7,2020,"49",2096829,662,211,360,302,451,10.0628138966029,14.4027004586449,0.838888888888889
"United States","New Mexico","NM",2020-12-06,2020-12-12,7,2020,"50",2096829,687,175,369,318,512,8.34593569623465,15.1657574365864,0.861788617886179
"United States","New Mexico","NM",2020-12-13,2020-12-19,7,2020,"51",2096829,662,242,380,282,420,11.5412367913645,13.4488792362181,0.742105263157895
"United States","New Mexico","NM",2020-12-20,2020-12-26,7,2020,"52",2096829,626,161,380,246,465,7.67826084053588,11.7320010358498,0.647368421052632
"United States","New Mexico","NM",2020-12-27,2021-01-02,7,2020,"53",2096829,607,218,387,220,389,10.3966513244523,10.492033446695,0.568475452196382
"United States","New Mexico","NM",2021-01-03,2021-01-09,7,2021,"1",2096829,585,198,405,180,387,9.44283010202549,8.58439100184135,0.444444444444444
"United States","New Mexico","NM",2021-01-10,2021-01-16,7,2021,"2",2096829,535,177,407,128,358,8.44131781847733,6.10445582353163,0.314496314496314
"United States","New Mexico","NM",2021-01-17,2021-01-23,7,2021,"3",2096829,530,206,402,128,324,9.82435859099621,6.10445582353163,0.318407960199005
"United States","New Mexico","NM",2021-01-24,2021-01-30,7,2021,"4",2096829,481,150,398,83,331,7.15365916820113,3.95835807307129,0.208542713567839
"United States","New Mexico","NM",2021-01-31,2021-02-06,7,2021,"5",2096829,466,121,395,71,345,5.77061839568224,3.3860653396152,0.179746835443038
"United States","New Mexico","NM",2021-02-07,2021-02-13,7,2021,"6",2096829,468,130,397,71,338,6.19983794577431,3.3860653396152,0.178841309823678
"United States","New Mexico","NM",2021-02-14,2021-02-20,7,2021,"7",2096829,436,94,395,41,342,4.48295974540604,1.95533350597497,0.10379746835443
"United States","New Mexico","NM",2021-02-21,2021-02-27,7,2021,"8",2096829,469,90,402,67,379,4.29219550092068,3.19530109512984,0.166666666666667
"United States","New Mexico","NM",2021-02-28,2021-03-06,7,2021,"9",2096829,451,97,403,48,354,4.62603292877006,2.28917093382436,0.119106699751861
"United States","New Mexico","NM",2021-03-07,2021-03-13,7,2021,"10",2096829,413,54,401,12,359,2.57531730055241,0.57229273345609,0.0299251870324189
"United States","New Mexico","NM",2021-03-14,2021-03-20,7,2021,"11",2096829,453,38,393,60,415,1.81226032261095,2.86146366728045,0.152671755725191
"United States","New Mexico","NM",2021-03-21,2021-03-27,7,2021,"12",2096829,448,36,393,55,412,1.71687820036827,2.62300836167375,0.139949109414758
"United States","New Mexico","NM",2021-03-28,2021-04-03,7,2021,"13",2096829,443,24,386,57,419,1.14458546691218,2.71839048391643,0.147668393782384
"United States","New Mexico","NM",2021-04-04,2021-04-10,7,2021,"14",2096829,427,27,379,48,400,1.2876586502762,2.28917093382436,0.12664907651715
"United States","New Mexico","NM",2021-04-11,2021-04-17,7,2021,"15",2096829,440,25,377,63,415,1.19227652803352,3.00453685064447,0.16710875331565
"United States","New Mexico","NM",2021-04-18,2021-04-24,7,2021,"16",2096829,412,23,381,31,389,1.09689440579084,1.47842289476157,0.0813648293963254
"United States","New Mexico","NM",2021-04-25,2021-05-01,7,2021,"17",2096829,391,43,382,9,348,2.05071562821766,0.429219550092068,0.0235602094240839
"United States","New Mexico","NM",2021-05-02,2021-05-08,7,2021,"18",2096829,414,31,375,39,383,1.47842289476157,1.85995138373229,0.104
"United States","New Mexico","NM",2021-05-09,2021-05-15,7,2021,"19",2096829,442,15,370,72,427,0.715365916820113,3.43375640073654,0.194594594594595
"United States","New Mexico","NM",2021-05-16,2021-05-22,7,2021,"20",2096829,412,18,369,43,394,0.858439100184135,2.05071562821766,0.116531165311653
"United States","New Mexico","NM",2021-05-23,2021-05-29,7,2021,"21",2096829,401,132,372,29,269,6.29522006801699,1.38304077251888,0.0779569892473118
"United States","New Mexico","NM",2021-05-30,2021-06-05,7,2021,"22",2096829,408,17,371,37,391,0.810748039062794,1.76456926148961,0.0997304582210243
"United States","New Mexico","NM",2021-06-06,2021-06-12,7,2021,"23",2096829,355,17,367,-12,338,0.810748039062794,-0.57229273345609,-0.0326975476839237
"United States","New Mexico","NM",2021-06-13,2021-06-19,7,2021,"24",2096829,411,19,371,40,392,0.906130161305476,1.90764244485363,0.107816711590297
"United States","New Mexico","NM",2021-06-20,2021-06-26,7,2021,"25",2096829,399,19,375,24,380,0.906130161305476,1.14458546691218,0.0640000000000001
"United States","New Mexico","NM",2021-06-27,2021-07-03,7,2021,"26",2096829,409,9,368,41,400,0.429219550092068,1.95533350597497,0.111413043478261
"United States","New Mexico","NM",2021-07-04,2021-07-10,7,2021,"27",2096829,362,10,364,-2,352,0.476910611213408,-0.0953821222426817,-0.00549450549450547
"United States","New Mexico","NM",2021-07-11,2021-07-17,7,2021,"28",2096829,369,25,361,8,344,1.19227652803352,0.381528488970727,0.0221606648199446
"United States","New Mexico","NM",2021-07-18,2021-07-24,7,2021,"29",2096829,356,18,351,5,338,0.858439100184135,0.238455305606704,0.0142450142450143
"United States","New Mexico","NM",2021-07-25,2021-07-31,7,2021,"30",2096829,326,13,350,-24,313,0.619983794577431,-1.14458546691218,-0.0685714285714286
"United States","New Mexico","NM",2021-08-01,2021-08-07,7,2021,"31",2096829,268,15,354,-86,253,0.715365916820113,-4.10143125643531,-0.242937853107345
"United States","New York","NY",2019-12-29,2020-01-04,7,2020,"1",19453561,3319,0,3419,-100,3319,0,-0.514044703692039,-0.0292483182217023
"United States","New York","NY",2020-01-05,2020-01-11,7,2020,"2",19453561,3229,0,3423,-194,3229,0,-0.997246725162555,-0.0566754309085598
"United States","New York","NY",2020-01-12,2020-01-18,7,2020,"3",19453561,3298,0,3433,-135,3298,0,-0.693960349984252,-0.0393242062336149
"United States","New York","NY",2020-01-19,2020-01-25,7,2020,"4",19453561,3205,0,3400,-195,3205,0,-1.00238717219948,-0.0573529411764706
"United States","New York","NY",2020-01-26,2020-02-01,7,2020,"5",19453561,3202,0,3355,-153,3202,0,-0.786488396648819,-0.0456035767511177
"United States","New York","NY",2020-02-02,2020-02-08,7,2020,"6",19453561,3231,0,3301,-70,3231,0,-0.359831292584427,-0.0212056952438655
"United States","New York","NY",2020-02-09,2020-02-15,7,2020,"7",19453561,3120,0,3264,-144,3120,0,-0.740224373316536,-0.0441176470588235
"United States","New York","NY",2020-02-16,2020-02-22,7,2020,"8",19453561,3129,0,3239,-110,3129,0,-0.565449174061243,-0.0339610991046619
"United States","New York","NY",2020-02-23,2020-02-29,7,2020,"9",19453561,3271,0,3194,77,3271,0,0.39581442184287,0.0241077019411395
"United States","New York","NY",2020-03-01,2020-03-07,7,2020,"10",19453561,3185,0,3172,13,3185,0,0.066825811479965,0.00409836065573765
"United States","New York","NY",2020-03-08,2020-03-14,7,2020,"11",19453561,3117,3,3143,-26,3114,0.0154213411107612,-0.13365162295993,-0.00827235125676107
"United States","New York","NY",2020-03-15,2020-03-21,7,2020,"12",19453561,3535,75,3099,436,3460,0.385533527769029,2.24123490809729,0.140690545337206
"United States","New York","NY",2020-03-22,2020-03-28,7,2020,"13",19453561,5350,914,3079,2271,4436,4.69836859174523,11.6739552208462,0.737577135433582
"United States","New York","NY",2020-03-29,2020-04-04,7,2020,"14",19453561,10070,3532,3066,7004,6538,18.1560589344028,36.0036910465904,2.28440965427267
"United States","New York","NY",2020-04-05,2020-04-11,7,2020,"15",19453561,12529,6588,3043,9486,5941,33.8652650792315,48.7622805922268,3.11731843575419
"United States","New York","NY",2020-04-12,2020-04-18,7,2020,"16",19453561,10365,5117,3023,7342,5248,26.3036674879216,37.7411621450695,2.42871319880913
"United States","New York","NY",2020-04-19,2020-04-25,7,2020,"17",19453561,7794,5242,2990,4804,2552,26.9462233675367,24.6947075653655,1.6066889632107
"United States","New York","NY",2020-04-26,2020-05-02,7,2020,"18",19453561,5976,2513,2946,3030,3463,12.9179434037809,15.5755545218688,1.02851323828921
"United States","New York","NY",2020-05-03,2020-05-09,7,2020,"19",19453561,4851,2737,2892,1959,2114,14.0694035400511,10.070135745327,0.677385892116183
"United States","New York","NY",2020-05-10,2020-05-16,7,2020,"20",19453561,4111,1246,2880,1231,2865,6.4049970080028,6.327890302449,0.427430555555556
"United States","New York","NY",2020-05-17,2020-05-23,7,2020,"21",19453561,3556,920,2835,721,2636,4.72921127396676,3.7062623136196,0.254320987654321
"United States","New York","NY",2020-05-24,2020-05-30,7,2020,"22",19453561,3281,671,2825,456,2610,3.44923996177358,2.3440438488357,0.16141592920354
"United States","New York","NY",2020-05-31,2020-06-06,7,2020,"23",19453561,3088,550,2866,222,2538,2.82724587030621,1.14117924219633,0.0774598743893928
"United States","New York","NY",2020-06-07,2020-06-13,7,2020,"24",19453561,2996,428,2842,154,2568,2.20011133180193,0.79162884368574,0.0541871921182266
"United States","New York","NY",2020-06-14,2020-06-20,7,2020,"25",19453561,2891,303,2857,34,2588,1.55755545218688,0.174775199255293,0.0119005950297515
"United States","New York","NY",2020-06-21,2020-06-27,7,2020,"26",19453561,3004,266,2881,123,2738,1.36735891182082,0.632274985541208,0.042693509198195
"United States","New York","NY",2020-06-28,2020-07-04,7,2020,"27",19453561,2883,751,2860,23,2132,3.86047572472721,0.118230281849169,0.00804195804195795
"United States","New York","NY",2020-07-05,2020-07-11,7,2020,"28",19453561,2920,153,2829,91,2767,0.786488396648819,0.467780680359755,0.0321668434075646
"United States","New York","NY",2020-07-12,2020-07-18,7,2020,"29",19453561,2818,157,2810,8,2661,0.807050184796501,0.0411235762953631,0.00284697508896792
"United States","New York","NY",2020-07-19,2020-07-25,7,2020,"30",19453561,2834,129,2805,29,2705,0.66311766776273,0.149072964070691,0.0103386809269161
"United States","New York","NY",2020-07-26,2020-08-01,7,2020,"31",19453561,2871,95,2791,80,2776,0.488342468507437,0.411235762953631,0.0286635614475099
"United States","New York","NY",2020-08-02,2020-08-08,7,2020,"32",19453561,2841,60,2799,42,2781,0.308426822215223,0.215898775550656,0.015005359056806
"United States","New York","NY",2020-08-09,2020-08-15,7,2020,"33",19453561,2811,67,2793,18,2744,0.344409951473666,0.092528046664567,0.00644468313641244
"United States","New York","NY",2020-08-16,2020-08-22,7,2020,"34",19453561,2841,53,2787,54,2788,0.272443692956781,0.277584139993701,0.0193756727664156
"United States","New York","NY",2020-08-23,2020-08-29,7,2020,"35",19453561,2810,58,2788,22,2752,0.298145928141382,0.113089834812249,0.00789096126255373
"United States","New York","NY",2020-08-30,2020-09-05,7,2020,"36",19453561,2768,57,2787,-19,2711,0.293005481104462,-0.0976684937014873,-0.00681736634373875
"United States","New York","NY",2020-09-06,2020-09-12,7,2020,"37",19453561,2757,46,2787,-30,2711,0.236460563698338,-0.154213411107612,-0.0107642626480086
"United States","New York","NY",2020-09-13,2020-09-19,7,2020,"38",19453561,2886,54,2807,79,2832,0.277584139993701,0.406095315916711,0.0281439258995368
"United States","New York","NY",2020-09-20,2020-09-26,7,2020,"39",19453561,3080,34,2831,249,3046,0.174775199255293,1.27997131219318,0.0879547862945955
"United States","New York","NY",2020-09-27,2020-10-03,7,2020,"40",19453561,2951,80,2864,87,2871,0.411235762953631,0.447218892212074,0.030377094972067
"United States","New York","NY",2020-10-04,2020-10-10,7,2020,"41",19453561,3108,83,2901,207,3025,0.426657104064392,1.06407253664252,0.0713547052740435
"United States","New York","NY",2020-10-11,2020-10-17,7,2020,"42",19453561,2985,85,2924,61,2900,0.436937998138233,0.313567269252144,0.0208618331053352
"United States","New York","NY",2020-10-18,2020-10-24,7,2020,"43",19453561,2939,81,2938,1,2858,0.416376209990551,0.00514044703692039,0.000340367597004843
"United States","New York","NY",2020-10-25,2020-10-31,7,2020,"44",19453561,3076,116,2965,111,2960,0.596291856282765,0.570589621098163,0.0374367622259697
"United States","New York","NY",2020-11-01,2020-11-07,7,2020,"45",19453561,3317,134,2987,330,3183,0.688819902947332,1.69634752218373,0.110478741211918
"United States","New York","NY",2020-11-08,2020-11-14,7,2020,"46",19453561,3158,192,2993,165,2966,0.986965831088714,0.848173761091864,0.0551286334781156
"United States","New York","NY",2020-11-15,2020-11-21,7,2020,"47",19453561,3288,230,3018,270,3058,1.18230281849169,1.3879206999685,0.0894632206759443
"United States","New York","NY",2020-11-22,2020-11-28,7,2020,"48",19453561,3375,338,3033,342,3037,1.73747109847909,1.75803288662677,0.112759643916914
"United States","New York","NY",2020-11-29,2020-12-05,7,2020,"49",19453561,3569,461,3065,504,3108,2.3697460840203,2.59078530660787,0.164437194127243
"United States","New York","NY",2020-12-06,2020-12-12,7,2020,"50",19453561,3872,591,3093,779,3281,3.03800419881995,4.00440824176098,0.251859036534109
"United States","New York","NY",2020-12-13,2020-12-19,7,2020,"51",19453561,4118,827,3131,987,3291,4.25114969953316,5.07362122544042,0.31523474928138
"United States","New York","NY",2020-12-20,2020-12-26,7,2020,"52",19453561,4358,657,3167,1191,3701,3.37727370325669,6.12227242097218,0.376065677297127
"United States","New York","NY",2020-12-27,2021-01-02,7,2020,"53",19453561,4339,1315,3239,1100,3024,6.75968785355031,5.65449174061243,0.339610991046619
"United States","New York","NY",2021-01-03,2021-01-09,7,2021,"1",19453561,4549,1190,3277,1272,3359,6.11713197393526,6.53864863096273,0.38815990234971
"United States","New York","NY",2021-01-10,2021-01-16,7,2021,"2",19453561,4667,1341,3309,1358,3326,6.89333947651024,6.98072707613789,0.410395889996978
"United States","New York","NY",2021-01-17,2021-01-23,7,2021,"3",19453561,4540,1322,3298,1242,3218,6.79567098280875,6.38443521985512,0.376591873862947
"United States","New York","NY",2021-01-24,2021-01-30,7,2021,"4",19453561,4443,1311,3298,1145,3132,6.73912606540263,5.88581185727384,0.347180109157065
"United States","New York","NY",2021-01-31,2021-02-06,7,2021,"5",19453561,4393,1217,3276,1117,3176,6.25592404393211,5.74187934024007,0.340964590964591
"United States","New York","NY",2021-02-07,2021-02-13,7,2021,"6",19453561,4128,1090,3216,912,3038,5.60308727024322,4.68808769767139,0.283582089552239
"United States","New York","NY",2021-02-14,2021-02-20,7,2021,"7",19453561,4014,942,3212,802,3072,4.842301108779,4.12263852361015,0.249688667496887
"United States","New York","NY",2021-02-21,2021-02-27,7,2021,"8",19453561,3927,832,3181,746,3095,4.27685193471776,3.83477348954261,0.234517447343603
"United States","New York","NY",2021-02-28,2021-03-06,7,2021,"9",19453561,3665,646,3149,516,3019,3.32072878585057,2.65247067105092,0.163861543347094
"United States","New York","NY",2021-03-07,2021-03-13,7,2021,"10",19453561,3618,679,3124,494,2939,3.49036353806894,2.53938083623867,0.158130601792574
"United States","New York","NY",2021-03-14,2021-03-20,7,2021,"11",19453561,3501,469,3071,430,3032,2.41086966031566,2.21039222587577,0.140019537609899
"United States","New York","NY",2021-03-21,2021-03-27,7,2021,"12",19453561,3579,675,3040,539,2904,3.46980174992126,2.77070095290009,0.177302631578947
"United States","New York","NY",2021-03-28,2021-04-03,7,2021,"13",19453561,3398,468,3020,378,2930,2.40572921327874,1.94308897995591,0.125165562913907
"United States","New York","NY",2021-04-04,2021-04-10,7,2021,"14",19453561,3461,479,3005,456,2982,2.46227413068487,2.3440438488357,0.151747088186356
"United States","New York","NY",2021-04-11,2021-04-17,7,2021,"15",19453561,3215,535,2969,246,2680,2.75013916475241,1.26454997108242,0.0828561805321657
"United States","New York","NY",2021-04-18,2021-04-24,7,2021,"16",19453561,3320,346,2940,380,2974,1.77859467477445,1.95336987402975,0.129251700680272
"United States","New York","NY",2021-04-25,2021-05-01,7,2021,"17",19453561,3218,314,2904,314,2904,1.614100369593,1.614100369593,0.108126721763085
"United States","New York","NY",2021-05-02,2021-05-08,7,2021,"18",19453561,3116,131,2881,235,2985,0.673398561836571,1.20800505367629,0.0815688996876085
"United States","New York","NY",2021-05-09,2021-05-15,7,2021,"19",19453561,3116,503,2854,262,2613,2.58564485957095,1.34679712367314,0.0918009810791871
"United States","New York","NY",2021-05-16,2021-05-22,7,2021,"20",19453561,3202,200,2820,382,3002,1.02808940738408,1.96365076810359,0.135460992907801
"United States","New York","NY",2021-05-23,2021-05-29,7,2021,"21",19453561,2947,178,2806,141,2769,0.914999572571829,0.724803032205775,0.0502494654312189
"United States","New York","NY",2021-05-30,2021-06-05,7,2021,"22",19453561,3038,137,2813,225,2901,0.704241244058093,1.15660058330709,0.0799857803057233
"United States","New York","NY",2021-06-06,2021-06-12,7,2021,"23",19453561,2839,107,2827,12,2732,0.550027832950481,0.0616853644430446,0.00424478245489923
"United States","New York","NY",2021-06-13,2021-06-19,7,2021,"24",19453561,2878,78,2841,37,2800,0.40095486887979,0.190196540366054,0.0130235832453363
"United States","New York","NY",2021-06-20,2021-06-26,7,2021,"25",19453561,2874,39,2842,32,2835,0.200477434439895,0.164494305181452,0.0112596762843069
"United States","New York","NY",2021-06-27,2021-07-03,7,2021,"26",19453561,2979,52,2850,129,2927,0.26730324591986,0.66311766776273,0.0452631578947369
"United States","New York","NY",2021-07-04,2021-07-10,7,2021,"27",19453561,2950,34,2848,102,2916,0.174775199255293,0.524325597765879,0.035814606741573
"United States","New York","NY",2021-07-11,2021-07-17,7,2021,"28",19453561,2900,35,2817,83,2865,0.179915646292214,0.426657104064392,0.0294639687610934
"United States","New York","NY",2021-07-18,2021-07-24,7,2021,"29",19453561,2966,42,2811,155,2924,0.215898775550656,0.79676929072266,0.055140519388118
"United States","New York","NY",2021-07-25,2021-07-31,7,2021,"30",19453561,2964,41,2801,163,2923,0.210758328513736,0.837892867018023,0.0581935023205997
"United States","New York","NY",2021-08-01,2021-08-07,7,2021,"31",19453561,3073,60,2775,298,3013,0.308426822215223,1.53185321700228,0.107387387387387
"United States","North Carolina","NC",2019-12-29,2020-01-04,7,2020,"1",10488084,2003,0,2078,-75,2003,0,-0.715097247504883,-0.03609239653513
"United States","North Carolina","NC",2020-01-05,2020-01-11,7,2020,"2",10488084,1984,0,2096,-112,1984,0,-1.06787855627396,-0.0534351145038168
"United States","North Carolina","NC",2020-01-12,2020-01-18,7,2020,"3",10488084,1902,0,2099,-197,1902,0,-1.87832210344616,-0.0938542162934731
"United States","North Carolina","NC",2020-01-19,2020-01-25,7,2020,"4",10488084,1994,0,2076,-82,1994,0,-0.781839657272005,-0.0394990366088632
"United States","North Carolina","NC",2020-01-26,2020-02-01,7,2020,"5",10488084,1983,0,2074,-91,1983,0,-0.867651326972591,-0.0438765670202508
"United States","North Carolina","NC",2020-02-02,2020-02-08,7,2020,"6",10488084,2053,0,2067,-14,2053,0,-0.133484819534245,-0.00677310111272378
"United States","North Carolina","NC",2020-02-09,2020-02-15,7,2020,"7",10488084,2060,0,2046,14,2060,0,0.133484819534245,0.00684261974584555
"United States","North Carolina","NC",2020-02-16,2020-02-22,7,2020,"8",10488084,1925,0,2041,-116,1925,0,-1.10601707614089,-0.0568348848603626
"United States","North Carolina","NC",2020-02-23,2020-02-29,7,2020,"9",10488084,1972,0,2015,-43,1972,0,-0.409989088569466,-0.0213399503722085
"United States","North Carolina","NC",2020-03-01,2020-03-07,7,2020,"10",10488084,2032,0,1988,44,2032,0,0.419523718536198,0.0221327967806841
"United States","North Carolina","NC",2020-03-08,2020-03-14,7,2020,"11",10488084,2025,0,1995,30,2025,0,0.286038899001953,0.0150375939849625
"United States","North Carolina","NC",2020-03-15,2020-03-21,7,2020,"12",10488084,2052,0,1991,61,2052,0,0.581612427970638,0.0306378704168759
"United States","North Carolina","NC",2020-03-22,2020-03-28,7,2020,"13",10488084,1877,4,1970,-93,1873,0.0381385198669271,-0.886720586906054,-0.0472081218274112
"United States","North Carolina","NC",2020-03-29,2020-04-04,7,2020,"14",10488084,2024,20,1924,100,2004,0.190692599334635,0.953462996673177,0.0519750519750519
"United States","North Carolina","NC",2020-04-05,2020-04-11,7,2020,"15",10488084,2016,55,1898,118,1961,0.524404648170247,1.12508633607435,0.0621707060063224
"United States","North Carolina","NC",2020-04-12,2020-04-18,7,2020,"16",10488084,2029,84,1874,155,1945,0.800908917205469,1.47786764484342,0.0827107790821771
"United States","North Carolina","NC",2020-04-19,2020-04-25,7,2020,"17",10488084,2104,125,1852,252,1979,1.19182874584147,2.40272675161641,0.136069114470842
"United States","North Carolina","NC",2020-04-26,2020-05-02,7,2020,"18",10488084,1948,131,1826,122,1817,1.24903652564186,1.16322485594128,0.0668127053669223
"United States","North Carolina","NC",2020-05-03,2020-05-09,7,2020,"19",10488084,2059,123,1807,252,1936,1.17275948590801,2.40272675161641,0.139457664637521
"United States","North Carolina","NC",2020-05-10,2020-05-16,7,2020,"20",10488084,2039,105,1811,228,1934,1.00113614650684,2.17389563241484,0.125897294312534
"United States","North Carolina","NC",2020-05-17,2020-05-23,7,2020,"21",10488084,2061,84,1796,265,1977,0.800908917205469,2.52667694118392,0.147550111358575
"United States","North Carolina","NC",2020-05-24,2020-05-30,7,2020,"22",10488084,1991,144,1791,200,1847,1.37298671520937,1.90692599334635,0.111669458403127
"United States","North Carolina","NC",2020-05-31,2020-06-06,7,2020,"23",10488084,1967,115,1798,169,1852,1.09648244617415,1.61135246437767,0.0939933259176864
"United States","North Carolina","NC",2020-06-07,2020-06-13,7,2020,"24",10488084,1878,114,1778,100,1764,1.08694781620742,0.953462996673177,0.0562429696287965
"United States","North Carolina","NC",2020-06-14,2020-06-20,7,2020,"25",10488084,1938,108,1783,155,1830,1.02974003640703,1.47786764484342,0.0869321368480089
"United States","North Carolina","NC",2020-06-21,2020-06-27,7,2020,"26",10488084,1946,106,1783,163,1840,1.01067077647357,1.55414468457728,0.0914189568143577
"United States","North Carolina","NC",2020-06-28,2020-07-04,7,2020,"27",10488084,2001,77,1770,231,1924,0.734166507438346,2.20249952231504,0.130508474576271
"United States","North Carolina","NC",2020-07-05,2020-07-11,7,2020,"28",10488084,1979,98,1768,211,1881,0.934393736739713,2.0118069229804,0.119343891402715
"United States","North Carolina","NC",2020-07-12,2020-07-18,7,2020,"29",10488084,2027,136,1753,274,1891,1.29670967547552,2.6124886108845,0.156303479749002
"United States","North Carolina","NC",2020-07-19,2020-07-25,7,2020,"30",10488084,2147,149,1741,406,1998,1.42065986504303,3.8710597664931,0.233199310740954
"United States","North Carolina","NC",2020-07-26,2020-08-01,7,2020,"31",10488084,2085,186,1730,355,1899,1.77344117381211,3.38479363818978,0.205202312138728
"United States","North Carolina","NC",2020-08-02,2020-08-08,7,2020,"32",10488084,2061,196,1731,330,1865,1.86878747347943,3.14642788902148,0.190641247833622
"United States","North Carolina","NC",2020-08-09,2020-08-15,7,2020,"33",10488084,2160,183,1740,420,1977,1.74483728391191,4.00454458602734,0.241379310344828
"United States","North Carolina","NC",2020-08-16,2020-08-22,7,2020,"34",10488084,2123,178,1741,382,1945,1.69716413407825,3.64222864729154,0.219414129810454
"United States","North Carolina","NC",2020-08-23,2020-08-29,7,2020,"35",10488084,2070,162,1737,333,1908,1.54461005461055,3.17503177892168,0.191709844559586
"United States","North Carolina","NC",2020-08-30,2020-09-05,7,2020,"36",10488084,2167,206,1724,443,1961,1.96413377314674,4.22384107526217,0.256960556844548
"United States","North Carolina","NC",2020-09-06,2020-09-12,7,2020,"37",10488084,2124,158,1725,399,1966,1.50647153474362,3.80431735672598,0.231304347826087
"United States","North Carolina","NC",2020-09-13,2020-09-19,7,2020,"38",10488084,2261,188,1728,533,2073,1.79251043374557,5.08195777226803,0.308449074074074
"United States","North Carolina","NC",2020-09-20,2020-09-26,7,2020,"39",10488084,2072,205,1724,348,1867,1.95459914318001,3.31805122842266,0.201856148491879
"United States","North Carolina","NC",2020-09-27,2020-10-03,7,2020,"40",10488084,2038,189,1758,280,1849,1.8020450637123,2.6696963906849,0.159271899886234
"United States","North Carolina","NC",2020-10-04,2020-10-10,7,2020,"41",10488084,2117,136,1765,352,1981,1.29670967547552,3.35618974828958,0.19943342776204
"United States","North Carolina","NC",2020-10-11,2020-10-17,7,2020,"42",10488084,2130,164,1785,345,1966,1.56367931454401,3.28944733852246,0.19327731092437
"United States","North Carolina","NC",2020-10-18,2020-10-24,7,2020,"43",10488084,2130,63,1802,328,2067,0.600681687904101,3.12735862908802,0.182019977802442
"United States","North Carolina","NC",2020-10-25,2020-10-31,7,2020,"44",10488084,2159,175,1813,346,1984,1.66856024417806,3.29898196848919,0.190843905129619
"United States","North Carolina","NC",2020-11-01,2020-11-07,7,2020,"45",10488084,2382,381,1826,556,2001,3.6326940173248,5.30125426150286,0.304490690032859
"United States","North Carolina","NC",2020-11-08,2020-11-14,7,2020,"46",10488084,2230,171,1834,396,2059,1.63042172431113,3.77571346682578,0.215921483097056
"United States","North Carolina","NC",2020-11-15,2020-11-21,7,2020,"47",10488084,2176,286,1845,331,1890,2.72690417048529,3.15596251898822,0.17940379403794
"United States","North Carolina","NC",2020-11-22,2020-11-28,7,2020,"48",10488084,2320,133,1856,464,2187,1.26810578557533,4.42406830456354,0.25
"United States","North Carolina","NC",2020-11-29,2020-12-05,7,2020,"49",10488084,2378,377,1894,484,2001,3.59455549745788,4.61476090389818,0.255543822597677
"United States","North Carolina","NC",2020-12-06,2020-12-12,7,2020,"50",10488084,2459,278,1917,542,2181,2.65062713075143,5.16776944196862,0.282733437663015
"United States","North Carolina","NC",2020-12-13,2020-12-19,7,2020,"51",10488084,2588,389,1941,647,2199,3.70897105705866,6.16890558847545,0.333333333333333
"United States","North Carolina","NC",2020-12-20,2020-12-26,7,2020,"52",10488084,2670,42,1973,697,2628,0.400454458602734,6.64563708681204,0.353269133299544
"United States","North Carolina","NC",2020-12-27,2021-01-02,7,2020,"53",10488084,2839,667,2003,836,2172,6.35959818781009,7.97095065218776,0.417373939091363
"United States","North Carolina","NC",2021-01-03,2021-01-09,7,2021,"1",10488084,2928,534,2004,924,2394,5.09149240223476,8.80999808926016,0.461077844311377
"United States","North Carolina","NC",2021-01-10,2021-01-16,7,2021,"2",10488084,2996,590,2028,968,2406,5.62543168037174,9.22952180779635,0.477317554240631
"United States","North Carolina","NC",2021-01-17,2021-01-23,7,2021,"3",10488084,2859,570,2054,805,2289,5.43473908103711,7.67537712321907,0.391918208373905
"United States","North Carolina","NC",2021-01-24,2021-01-30,7,2021,"4",10488084,2845,702,2049,796,2143,6.6933102366457,7.58956545351849,0.388482186432406
"United States","North Carolina","NC",2021-01-31,2021-02-06,7,2021,"5",10488084,2599,639,2065,534,1960,6.0926285487416,5.09149240223476,0.258595641646489
"United States","North Carolina","NC",2021-02-07,2021-02-13,7,2021,"6",10488084,2463,527,2067,396,1936,5.02474999246764,3.77571346682578,0.191582002902758
"United States","North Carolina","NC",2021-02-14,2021-02-20,7,2021,"7",10488084,2391,444,2049,342,1947,4.23337570522891,3.26084344862227,0.166910688140556
"United States","North Carolina","NC",2021-02-21,2021-02-27,7,2021,"8",10488084,2188,316,2021,167,1872,3.01294306948724,1.59228320444421,0.0826323602177139
"United States","North Carolina","NC",2021-02-28,2021-03-06,7,2021,"9",10488084,1090,290,1999,-909,800,2.76504269035221,-8.66697863975918,-0.454727363681841
"United States","North Carolina","NC",2021-08-01,2021-08-07,7,2021,"31",10488084,939,101,1793,-854,838,0.962997626639909,-8.14257399158893,-0.476296709425544
"United States","North Dakota","ND",2019-12-29,2020-01-04,7,2020,"1",762062,149,0,148,1,149,0,0.131222918870118,0.0067567567567568
"United States","North Dakota","ND",2020-01-05,2020-01-11,7,2020,"2",762062,151,0,151,0,151,0,0,0
"United States","North Dakota","ND",2020-01-12,2020-01-18,7,2020,"3",762062,171,0,152,19,171,0,2.49323545853225,0.125
"United States","North Dakota","ND",2020-01-19,2020-01-25,7,2020,"4",762062,147,0,150,-3,147,0,-0.393668756610355,-0.02
"United States","North Dakota","ND",2020-01-26,2020-02-01,7,2020,"5",762062,130,0,147,-17,130,0,-2.23078962079201,-0.115646258503401
"United States","North Dakota","ND",2020-02-02,2020-02-08,7,2020,"6",762062,138,0,147,-9,138,0,-1.18100626983106,-0.0612244897959183
"United States","North Dakota","ND",2020-02-09,2020-02-15,7,2020,"7",762062,148,0,143,5,148,0,0.656114594350591,0.034965034965035
"United States","North Dakota","ND",2020-02-16,2020-02-22,7,2020,"8",762062,176,0,145,31,176,0,4.06791048497366,0.213793103448276
"United States","North Dakota","ND",2020-02-23,2020-02-29,7,2020,"9",762062,152,0,146,6,152,0,0.787337513220709,0.0410958904109588
"United States","North Dakota","ND",2020-03-01,2020-03-07,7,2020,"10",762062,171,0,148,23,171,0,3.01812713401272,0.155405405405405
"United States","North Dakota","ND",2020-03-08,2020-03-14,7,2020,"11",762062,148,0,143,5,148,0,0.656114594350591,0.034965034965035
"United States","North Dakota","ND",2020-03-15,2020-03-21,7,2020,"12",762062,150,0,143,7,150,0,0.918560432090827,0.048951048951049
"United States","North Dakota","ND",2020-03-22,2020-03-28,7,2020,"13",762062,119,1,143,-24,118,0.131222918870118,-3.14935005288284,-0.167832167832168
"United States","North Dakota","ND",2020-03-29,2020-04-04,7,2020,"14",762062,140,2,142,-2,138,0.262445837740236,-0.262445837740236,-0.0140845070422535
"United States","North Dakota","ND",2020-04-05,2020-04-11,7,2020,"15",762062,158,4,144,14,154,0.524891675480473,1.83712086418165,0.0972222222222223
"United States","North Dakota","ND",2020-04-12,2020-04-18,7,2020,"16",762062,157,2,139,18,155,0.262445837740236,2.36201253966213,0.129496402877698
"United States","North Dakota","ND",2020-04-19,2020-04-25,7,2020,"17",762062,158,7,135,23,151,0.918560432090827,3.01812713401272,0.17037037037037
"United States","North Dakota","ND",2020-04-26,2020-05-02,7,2020,"18",762062,148,8,133,15,140,1.04978335096095,1.96834378305177,0.112781954887218
"United States","North Dakota","ND",2020-05-03,2020-05-09,7,2020,"19",762062,141,10,132,9,131,1.31222918870118,1.18100626983106,0.0681818181818181
"United States","North Dakota","ND",2020-05-10,2020-05-16,7,2020,"20",762062,153,8,130,23,145,1.04978335096095,3.01812713401272,0.176923076923077
"United States","North Dakota","ND",2020-05-17,2020-05-23,7,2020,"21",762062,140,10,130,10,130,1.31222918870118,1.31222918870118,0.0769230769230769
"United States","North Dakota","ND",2020-05-24,2020-05-30,7,2020,"22",762062,143,7,133,10,136,0.918560432090827,1.31222918870118,0.0751879699248121
"United States","North Dakota","ND",2020-05-31,2020-06-06,7,2020,"23",762062,161,13,130,31,148,1.70589794531154,4.06791048497366,0.238461538461539
"United States","North Dakota","ND",2020-06-07,2020-06-13,7,2020,"24",762062,143,2,131,12,141,0.262445837740236,1.57467502644142,0.0916030534351144
"United States","North Dakota","ND",2020-06-14,2020-06-20,7,2020,"25",762062,142,2,130,12,140,0.262445837740236,1.57467502644142,0.0923076923076922
"United States","North Dakota","ND",2020-06-21,2020-06-27,7,2020,"26",762062,131,2,131,0,129,0.262445837740236,0,0
"United States","North Dakota","ND",2020-06-28,2020-07-04,7,2020,"27",762062,117,2,129,-12,115,0.262445837740236,-1.57467502644142,-0.0930232558139535
"United States","North Dakota","ND",2020-07-05,2020-07-11,7,2020,"28",762062,135,7,128,7,128,0.918560432090827,0.918560432090827,0.0546875
"United States","North Dakota","ND",2020-07-12,2020-07-18,7,2020,"29",762062,134,3,129,5,131,0.393668756610355,0.656114594350591,0.0387596899224807
"United States","North Dakota","ND",2020-07-19,2020-07-25,7,2020,"30",762062,132,9,125,7,123,1.18100626983106,0.918560432090827,0.056
"United States","North Dakota","ND",2020-07-26,2020-08-01,7,2020,"31",762062,139,4,124,15,135,0.524891675480473,1.96834378305177,0.120967741935484
"United States","North Dakota","ND",2020-08-02,2020-08-08,7,2020,"32",762062,154,9,125,29,145,1.18100626983106,3.80546464723343,0.232
"United States","North Dakota","ND",2020-08-09,2020-08-15,7,2020,"33",762062,136,9,121,15,127,1.18100626983106,1.96834378305177,0.12396694214876
"United States","North Dakota","ND",2020-08-16,2020-08-22,7,2020,"34",762062,132,14,120,12,118,1.83712086418165,1.57467502644142,0.1
"United States","North Dakota","ND",2020-08-23,2020-08-29,7,2020,"35",762062,141,6,122,19,135,0.787337513220709,2.49323545853225,0.155737704918033
"United States","North Dakota","ND",2020-08-30,2020-09-05,7,2020,"36",762062,163,14,127,36,149,1.83712086418165,4.72402507932425,0.283464566929134
"United States","North Dakota","ND",2020-09-06,2020-09-12,7,2020,"37",762062,143,12,127,16,131,1.57467502644142,2.09956670192189,0.125984251968504
"United States","North Dakota","ND",2020-09-13,2020-09-19,7,2020,"38",762062,165,25,130,35,140,3.28057297175295,4.59280216045414,0.269230769230769
"United States","North Dakota","ND",2020-09-20,2020-09-26,7,2020,"39",762062,178,19,135,43,159,2.49323545853225,5.64258551141508,0.318518518518518
"United States","North Dakota","ND",2020-09-27,2020-10-03,7,2020,"40",762062,197,60,136,61,137,7.87337513220709,8.00459805107721,0.448529411764706
"United States","North Dakota","ND",2020-10-04,2020-10-10,7,2020,"41",762062,239,65,138,101,174,8.52948972655768,13.2535148058819,0.731884057971014
"United States","North Dakota","ND",2020-10-11,2020-10-17,7,2020,"42",762062,223,63,140,83,160,8.26704388881745,10.8915022662198,0.592857142857143
"United States","North Dakota","ND",2020-10-18,2020-10-24,7,2020,"43",762062,195,49,145,50,146,6.42992302463579,6.56114594350591,0.344827586206897
"United States","North Dakota","ND",2020-10-25,2020-10-31,7,2020,"44",762062,246,76,140,106,170,9.97294183412898,13.9096294002325,0.757142857142857
"United States","North Dakota","ND",2020-11-01,2020-11-07,7,2020,"45",762062,269,104,141,128,165,13.6471835624923,16.7965336153751,0.907801418439716
"United States","North Dakota","ND",2020-11-08,2020-11-14,7,2020,"46",762062,255,98,140,115,157,12.8598460492716,15.0906356700636,0.821428571428571
"United States","North Dakota","ND",2020-11-15,2020-11-21,7,2020,"47",762062,273,108,137,136,165,14.1720752379728,17.8463169663361,0.992700729927007
"United States","North Dakota","ND",2020-11-22,2020-11-28,7,2020,"48",762062,248,81,137,111,167,10.6290564284796,14.5657439945831,0.81021897810219
"United States","North Dakota","ND",2020-11-29,2020-12-05,7,2020,"49",762062,283,92,140,143,191,12.0725085360509,18.7648773984269,1.02142857142857
"United States","North Dakota","ND",2020-12-06,2020-12-12,7,2020,"50",762062,231,57,137,94,174,7.47970637559674,12.3349543737911,0.686131386861314
"United States","North Dakota","ND",2020-12-13,2020-12-19,7,2020,"51",762062,200,140,137,63,60,18.3712086418165,8.26704388881745,0.45985401459854
"United States","North Dakota","ND",2020-12-20,2020-12-26,7,2020,"52",762062,200,60,139,61,140,7.87337513220709,8.00459805107721,0.438848920863309
"United States","North Dakota","ND",2020-12-27,2021-01-02,7,2020,"53",762062,163,46,143,20,117,6.03625426802544,2.62445837740236,0.13986013986014
"United States","North Dakota","ND",2021-01-03,2021-01-09,7,2021,"1",762062,156,42,145,11,114,5.51136259254496,1.4434521075713,0.0758620689655172
"United States","North Dakota","ND",2021-01-10,2021-01-16,7,2021,"2",762062,153,29,146,7,124,3.80546464723343,0.918560432090827,0.047945205479452
"United States","North Dakota","ND",2021-01-17,2021-01-23,7,2021,"3",762062,140,30,147,-7,110,3.93668756610354,-0.918560432090827,-0.0476190476190477
"United States","North Dakota","ND",2021-01-24,2021-01-30,7,2021,"4",762062,147,11,146,1,136,1.4434521075713,0.131222918870118,0.00684931506849318
"United States","North Dakota","ND",2021-01-31,2021-02-06,7,2021,"5",762062,157,6,145,12,151,0.787337513220709,1.57467502644142,0.0827586206896551
"United States","North Dakota","ND",2021-02-07,2021-02-13,7,2021,"6",762062,119,4,147,-28,115,0.524891675480473,-3.67424172836331,-0.19047619047619
"United States","North Dakota","ND",2021-02-14,2021-02-20,7,2021,"7",762062,131,6,145,-14,125,0.787337513220709,-1.83712086418165,-0.096551724137931
"United States","North Dakota","ND",2021-02-21,2021-02-27,7,2021,"8",762062,164,8,144,20,156,1.04978335096095,2.62445837740236,0.138888888888889
"United States","North Dakota","ND",2021-02-28,2021-03-06,7,2021,"9",762062,157,4,144,13,153,0.524891675480473,1.70589794531154,0.0902777777777777
"United States","North Dakota","ND",2021-03-07,2021-03-13,7,2021,"10",762062,137,9,144,-7,128,1.18100626983106,-0.918560432090827,-0.0486111111111112
"United States","North Dakota","ND",2021-03-14,2021-03-20,7,2021,"11",762062,144,3,145,-1,141,0.393668756610355,-0.131222918870118,-0.00689655172413794
"United States","North Dakota","ND",2021-03-21,2021-03-27,7,2021,"12",762062,146,6,150,-4,140,0.787337513220709,-0.524891675480473,-0.0266666666666666
"United States","North Dakota","ND",2021-03-28,2021-04-03,7,2021,"13",762062,140,0,150,-10,140,0,-1.31222918870118,-0.0666666666666667
"United States","North Dakota","ND",2021-04-04,2021-04-10,7,2021,"14",762062,137,3,152,-15,134,0.393668756610355,-1.96834378305177,-0.0986842105263158
"United States","North Dakota","ND",2021-04-11,2021-04-17,7,2021,"15",762062,147,8,156,-9,139,1.04978335096095,-1.18100626983106,-0.0576923076923077
"United States","North Dakota","ND",2021-04-18,2021-04-24,7,2021,"16",762062,128,7,150,-22,121,0.918560432090827,-2.8869042151426,-0.146666666666667
"United States","North Dakota","ND",2021-04-25,2021-05-01,7,2021,"17",762062,146,8,146,0,138,1.04978335096095,0,0
"United States","North Dakota","ND",2021-05-02,2021-05-08,7,2021,"18",762062,147,5,148,-1,142,0.656114594350591,-0.131222918870118,-0.0067567567567568
"United States","North Dakota","ND",2021-05-09,2021-05-15,7,2021,"19",762062,140,5,149,-9,135,0.656114594350591,-1.18100626983106,-0.0604026845637584
"United States","North Dakota","ND",2021-05-16,2021-05-22,7,2021,"20",762062,158,3,147,11,155,0.393668756610355,1.4434521075713,0.0748299319727892
"United States","North Dakota","ND",2021-05-23,2021-05-29,7,2021,"21",762062,125,5,148,-23,120,0.656114594350591,-3.01812713401272,-0.155405405405405
"United States","North Dakota","ND",2021-05-30,2021-06-05,7,2021,"22",762062,150,4,144,6,146,0.524891675480473,0.787337513220709,0.0416666666666667
"United States","North Dakota","ND",2021-06-06,2021-06-12,7,2021,"23",762062,143,4,145,-2,139,0.524891675480473,-0.262445837740236,-0.0137931034482759
"United States","North Dakota","ND",2021-06-13,2021-06-19,7,2021,"24",762062,131,3,142,-11,128,0.393668756610355,-1.4434521075713,-0.0774647887323944
"United States","North Dakota","ND",2021-06-20,2021-06-26,7,2021,"25",762062,157,5,140,17,152,0.656114594350591,2.23078962079201,0.121428571428571
"United States","North Dakota","ND",2021-06-27,2021-07-03,7,2021,"26",762062,155,0,137,18,155,0,2.36201253966213,0.131386861313869
"United States","North Dakota","ND",2021-07-04,2021-07-10,7,2021,"27",762062,147,4,138,9,143,0.524891675480473,1.18100626983106,0.0652173913043479
"United States","North Dakota","ND",2021-07-11,2021-07-17,7,2021,"28",762062,130,5,136,-6,125,0.656114594350591,-0.787337513220709,-0.0441176470588235
"United States","North Dakota","ND",2021-07-18,2021-07-24,7,2021,"29",762062,142,1,138,4,141,0.131222918870118,0.524891675480473,0.0289855072463767
"United States","North Dakota","ND",2021-07-25,2021-07-31,7,2021,"30",762062,129,1,137,-8,128,0.131222918870118,-1.04978335096095,-0.0583941605839416
"United States","North Dakota","ND",2021-08-01,2021-08-07,7,2021,"31",762062,120,3,143,-23,117,0.393668756610355,-3.01812713401272,-0.160839160839161
"United States","Ohio","OH",2019-12-29,2020-01-04,7,2020,"1",11689100,2541,0,2802,-261,2541,0,-2.23284940671224,-0.0931477516059958
"United States","Ohio","OH",2020-01-05,2020-01-11,7,2020,"2",11689100,2615,0,2855,-240,2615,0,-2.05319485674688,-0.0840630472854641
"United States","Ohio","OH",2020-01-12,2020-01-18,7,2020,"3",11689100,2478,0,2831,-353,2478,0,-3.01990743513187,-0.124690921935712
"United States","Ohio","OH",2020-01-19,2020-01-25,7,2020,"4",11689100,2564,0,2768,-204,2564,0,-1.74521562823485,-0.0736994219653179
"United States","Ohio","OH",2020-01-26,2020-02-01,7,2020,"5",11689100,2493,0,2709,-216,2493,0,-1.8478753710722,-0.079734219269103
"United States","Ohio","OH",2020-02-02,2020-02-08,7,2020,"6",11689100,2533,0,2670,-137,2533,0,-1.17203206405968,-0.0513108614232209
"United States","Ohio","OH",2020-02-09,2020-02-15,7,2020,"7",11689100,2495,0,2661,-166,2495,0,-1.42012644258326,-0.0623825629462608
"United States","Ohio","OH",2020-02-16,2020-02-22,7,2020,"8",11689100,2527,0,2625,-98,2527,0,-0.838387899838311,-0.0373333333333333
"United States","Ohio","OH",2020-02-23,2020-02-29,7,2020,"9",11689100,2461,0,2578,-117,2461,0,-1.00093249266411,-0.0453840186190846
"United States","Ohio","OH",2020-03-01,2020-03-07,7,2020,"10",11689100,2510,0,2575,-65,2510,0,-0.556073607035614,-0.025242718446602
"United States","Ohio","OH",2020-03-08,2020-03-14,7,2020,"11",11689100,2556,0,2570,-14,2556,0,-0.119769699976902,-0.0054474708171206
"United States","Ohio","OH",2020-03-15,2020-03-21,7,2020,"12",11689100,2520,3,2567,-47,2517,0.025664935709336,-0.402083992779598,-0.0183093104791585
"United States","Ohio","OH",2020-03-22,2020-03-28,7,2020,"13",11689100,2511,22,2558,-47,2489,0.188209528535131,-0.402083992779598,-0.0183737294761532
"United States","Ohio","OH",2020-03-29,2020-04-04,7,2020,"14",11689100,2571,77,2555,16,2494,0.658733349872959,0.136879657116459,0.00626223091976508
"United States","Ohio","OH",2020-04-05,2020-04-11,7,2020,"15",11689100,2633,145,2526,107,2488,1.24047189261791,0.915382706966319,0.0423594615993665
"United States","Ohio","OH",2020-04-12,2020-04-18,7,2020,"16",11689100,2657,204,2519,138,2453,1.74521562823485,1.18058704262946,0.054783644303295
"United States","Ohio","OH",2020-04-19,2020-04-25,7,2020,"17",11689100,2835,258,2465,370,2577,2.2071844710029,3.16534207081811,0.150101419878296
"United States","Ohio","OH",2020-04-26,2020-05-02,7,2020,"18",11689100,2737,312,2415,322,2425,2.66915331377095,2.75470309946874,0.133333333333333
"United States","Ohio","OH",2020-05-03,2020-05-09,7,2020,"19",11689100,2616,310,2374,242,2306,2.65204335663139,2.07030481388644,0.101937657961247
"United States","Ohio","OH",2020-05-10,2020-05-16,7,2020,"20",11689100,2685,279,2350,335,2406,2.38683902096825,2.86591782087586,0.142553191489362
"United States","Ohio","OH",2020-05-17,2020-05-23,7,2020,"21",11689100,2664,341,2331,333,2323,2.91724769229453,2.8488078637363,0.142857142857143
"United States","Ohio","OH",2020-05-24,2020-05-30,7,2020,"22",11689100,2530,195,2320,210,2335,1.66822082110684,1.79654549965352,0.0905172413793103
"United States","Ohio","OH",2020-05-31,2020-06-06,7,2020,"23",11689100,2597,224,2310,287,2373,1.91631519963042,2.45527884952648,0.124242424242424
"United States","Ohio","OH",2020-06-07,2020-06-13,7,2020,"24",11689100,2421,184,2304,117,2237,1.57411605683928,1.00093249266411,0.05078125
"United States","Ohio","OH",2020-06-14,2020-06-20,7,2020,"25",11689100,2404,143,2295,109,2261,1.22336193547835,0.932492664105876,0.0474945533769062
"United States","Ohio","OH",2020-06-21,2020-06-27,7,2020,"26",11689100,2429,107,2314,115,2322,0.915382706966319,0.983822535524548,0.0496974935177181
"United States","Ohio","OH",2020-06-28,2020-07-04,7,2020,"27",11689100,2529,103,2323,206,2426,0.881162792687204,1.76232558537441,0.0886784330606973
"United States","Ohio","OH",2020-07-05,2020-07-11,7,2020,"28",11689100,2515,129,2291,224,2386,1.10359223550145,1.91631519963042,0.0977738978611959
"United States","Ohio","OH",2020-07-12,2020-07-18,7,2020,"29",11689100,2537,96,2274,263,2441,0.821277942698753,2.24995936385179,0.115655233069481
"United States","Ohio","OH",2020-07-19,2020-07-25,7,2020,"30",11689100,2504,165,2277,227,2339,1.41157146401348,1.94198013533976,0.0996925779534474
"United States","Ohio","OH",2020-07-26,2020-08-01,7,2020,"31",11689100,2621,218,2283,338,2403,1.86498532821175,2.89158275658519,0.148050810337276
"United States","Ohio","OH",2020-08-02,2020-08-08,7,2020,"32",11689100,2584,153,2268,316,2431,1.30891172117614,2.70337322805006,0.139329805996473
"United States","Ohio","OH",2020-08-09,2020-08-15,7,2020,"33",11689100,2588,156,2261,327,2432,1.33457665688547,2.79747799231763,0.144626271561256
"United States","Ohio","OH",2020-08-16,2020-08-22,7,2020,"34",11689100,2592,151,2259,333,2441,1.29180176403658,2.8488078637363,0.147410358565737
"United States","Ohio","OH",2020-08-23,2020-08-29,7,2020,"35",11689100,2650,286,2255,395,2364,2.4467238709567,3.37921653506258,0.175166297117517
"United States","Ohio","OH",2020-08-30,2020-09-05,7,2020,"36",11689100,2426,-5,2267,159,2431,-0.0427748928488934,1.36024159259481,0.070136744596383
"United States","Ohio","OH",2020-09-06,2020-09-12,7,2020,"37",11689100,2557,155,2273,284,2402,1.3260216783157,2.42961391381715,0.124945006599208
"United States","Ohio","OH",2020-09-13,2020-09-19,7,2020,"38",11689100,2485,201,2285,200,2284,1.71955069252552,1.71099571395574,0.087527352297593
"United States","Ohio","OH",2020-09-20,2020-09-26,7,2020,"39",11689100,2630,128,2283,347,2502,1.09503725693167,2.9685775637132,0.151992991677617
"United States","Ohio","OH",2020-09-27,2020-10-03,7,2020,"40",11689100,2602,185,2271,331,2417,1.58267103540906,2.83169790659674,0.145750770585645
"United States","Ohio","OH",2020-10-04,2020-10-10,7,2020,"41",11689100,2665,72,2246,419,2593,0.615958457024065,3.58453602073727,0.186553873552983
"United States","Ohio","OH",2020-10-11,2020-10-17,7,2020,"42",11689100,2650,70,2260,390,2580,0.598848499884508,3.33644164221369,0.172566371681416
"United States","Ohio","OH",2020-10-18,2020-10-24,7,2020,"43",11689100,2691,139,2282,409,2552,1.18914202119924,3.49898623503948,0.179228746713409
"United States","Ohio","OH",2020-10-25,2020-10-31,7,2020,"44",11689100,2763,95,2303,460,2668,0.812722964128975,3.93529014209819,0.199739470256188
"United States","Ohio","OH",2020-11-01,2020-11-07,7,2020,"45",11689100,3028,205,2327,701,2823,1.75377060680463,5.99703997741486,0.301246239793726
"United States","Ohio","OH",2020-11-08,2020-11-14,7,2020,"46",11689100,3070,208,2360,710,2862,1.77943554251397,6.07403478454286,0.300847457627119
"United States","Ohio","OH",2020-11-15,2020-11-21,7,2020,"47",11689100,3256,28,2379,877,3228,0.239539399953803,7.50271620569591,0.368642286675074
"United States","Ohio","OH",2020-11-22,2020-11-28,7,2020,"48",11689100,3568,657,2394,1174,2911,5.62062092034459,10.0435448409202,0.490392648287385
"United States","Ohio","OH",2020-11-29,2020-12-05,7,2020,"49",11689100,3910,544,2414,1496,3366,4.6539083419596,12.7982479403889,0.619718309859155
"United States","Ohio","OH",2020-12-06,2020-12-12,7,2020,"50",11689100,4230,530,2429,1801,3700,4.5341386419827,15.4075164041714,0.741457389872376
"United States","Ohio","OH",2020-12-13,2020-12-19,7,2020,"51",11689100,4066,550,2439,1627,3516,4.70523821337828,13.9189501330299,0.667076670766708
"United States","Ohio","OH",2020-12-20,2020-12-26,7,2020,"52",11689100,3913,453,2479,1434,3460,3.87540529210974,12.2678392690626,0.578459056070996
"United States","Ohio","OH",2020-12-27,2021-01-02,7,2020,"53",11689100,3910,541,2523,1387,3369,4.62824340625027,11.865755276283,0.549742370194213
"United States","Ohio","OH",2021-01-03,2021-01-09,7,2021,"1",11689100,3679,582,2563,1116,3097,4.97899752761119,9.54735608387301,0.435427233710495
"United States","Ohio","OH",2021-01-10,2021-01-16,7,2021,"2",11689100,3579,535,2600,979,3044,4.5769135348316,8.37532401981333,0.376538461538461
"United States","Ohio","OH",2021-01-17,2021-01-23,7,2021,"3",11689100,3284,546,2571,713,2738,4.67101829909916,6.0996997202522,0.277323998444185
"United States","Ohio","OH",2021-01-24,2021-01-30,7,2021,"4",11689100,3126,441,2560,566,2685,3.7727455492724,4.84211787049473,0.22109375
"United States","Ohio","OH",2021-01-31,2021-02-06,7,2021,"5",11689100,3107,532,2513,594,2575,4.55124859912226,5.08165727044854,0.236370871468365
"United States","Ohio","OH",2021-02-07,2021-02-13,7,2021,"6",11689100,2947,4687,2492,455,-1740,40.0971845565527,3.8925152492493,0.182584269662921
"United States","Ohio","OH",2021-02-14,2021-02-20,7,2021,"7",11689100,2847,422,2475,372,2425,3.6102009564466,3.18245202795767,0.15030303030303
"United States","Ohio","OH",2021-02-21,2021-02-27,7,2021,"8",11689100,2785,484,2481,304,2301,4.14060962777288,2.60071348521272,0.122531237404272
"United States","Ohio","OH",2021-02-28,2021-03-06,7,2021,"9",11689100,2580,637,2475,105,1943,5.44952134894902,0.898272749826762,0.0424242424242425
"United States","Ohio","OH",2021-03-07,2021-03-13,7,2021,"10",11689100,2557,565,2498,59,1992,4.83356289192496,0.504743735616942,0.0236188951160929
"United States","Ohio","OH",2021-03-14,2021-03-20,7,2021,"11",11689100,2412,338,2480,-68,2074,2.89158275658519,-0.58173854274495,-0.0274193548387097
"United States","Ohio","OH",2021-03-21,2021-03-27,7,2021,"12",11689100,2500,127,2453,47,2373,1.08648227836189,0.402083992779598,0.019160211985324
"United States","Ohio","OH",2021-03-28,2021-04-03,7,2021,"13",11689100,2403,-270,2453,-50,2673,-2.30984421384024,-0.427748928488934,-0.0203832042397065
"United States","Ohio","OH",2021-04-04,2021-04-10,7,2021,"14",11689100,2558,184,2437,121,2374,1.57411605683928,1.03515240694322,0.0496512105047189
"United States","Ohio","OH",2021-04-11,2021-04-17,7,2021,"15",11689100,2419,164,2412,7,2255,1.4030164854437,0.0598848499884508,0.00290215588723042
"United States","Ohio","OH",2021-04-18,2021-04-24,7,2021,"16",11689100,2577,131,2394,183,2446,1.12070219264101,1.5655610782695,0.0764411027568923
"United States","Ohio","OH",2021-04-25,2021-05-01,7,2021,"17",11689100,2474,162,2344,130,2312,1.38590652830415,1.11214721407123,0.0554607508532423
"United States","Ohio","OH",2021-05-02,2021-05-08,7,2021,"18",11689100,2406,144,2327,79,2262,1.23191691404813,0.675843307012516,0.0339492909325312
"United States","Ohio","OH",2021-05-09,2021-05-15,7,2021,"19",11689100,2424,100,2303,121,2324,0.855497856977868,1.03515240694322,0.0525401650021711
"United States","Ohio","OH",2021-05-16,2021-05-22,7,2021,"20",11689100,2562,181,2295,267,2381,1.54845112112994,2.28417927813091,0.116339869281046
"United States","Ohio","OH",2021-05-23,2021-05-29,7,2021,"21",11689100,2449,152,2273,176,2297,1.30035674260636,1.50567622828105,0.0774307083150021
"United States","Ohio","OH",2021-05-30,2021-06-05,7,2021,"22",11689100,2433,119,2257,176,2314,1.01804244980366,1.50567622828105,0.0779796189632256
"United States","Ohio","OH",2021-06-06,2021-06-12,7,2021,"23",11689100,2305,111,2272,33,2194,0.949602621245434,0.282314292802697,0.014524647887324
"United States","Ohio","OH",2021-06-13,2021-06-19,7,2021,"24",11689100,2406,75,2268,138,2331,0.641623392733401,1.18058704262946,0.0608465608465609
"United States","Ohio","OH",2021-06-20,2021-06-26,7,2021,"25",11689100,2372,115,2279,93,2257,0.983822535524548,0.795613006989417,0.0408073716542343
"United States","Ohio","OH",2021-06-27,2021-07-03,7,2021,"26",11689100,2355,63,2287,68,2292,0.538963649896057,0.58173854274495,0.0297332750327941
"United States","Ohio","OH",2021-07-04,2021-07-10,7,2021,"27",11689100,2370,36,2273,97,2334,0.307979228512033,0.829832921268532,0.0426748790145182
"United States","Ohio","OH",2021-07-11,2021-07-17,7,2021,"28",11689100,2332,57,2259,73,2275,0.487633778477385,0.624513435593844,0.0323151837096061
"United States","Ohio","OH",2021-07-18,2021-07-24,7,2021,"29",11689100,2358,30,2245,113,2328,0.256649357093361,0.966712578384991,0.0503340757238306
"United States","Ohio","OH",2021-07-25,2021-07-31,7,2021,"30",11689100,2433,25,2245,188,2408,0.213874464244467,1.60833597111839,0.0837416481069042
"United States","Ohio","OH",2021-08-01,2021-08-07,7,2021,"31",11689100,2298,64,2238,60,2234,0.547518628465836,0.513298714186721,0.0268096514745308
"United States","Oklahoma","OK",2019-12-29,2020-01-04,7,2020,"1",3956971,901,0,927,-26,901,0,-0.657068247404391,-0.0280474649406688
"United States","Oklahoma","OK",2020-01-05,2020-01-11,7,2020,"2",3956971,823,0,931,-108,823,0,-2.72936041229516,-0.116004296455424
"United States","Oklahoma","OK",2020-01-12,2020-01-18,7,2020,"3",3956971,850,0,946,-96,850,0,-2.42609814426237,-0.101479915433404
"United States","Oklahoma","OK",2020-01-19,2020-01-25,7,2020,"4",3956971,803,0,932,-129,803,0,-3.26006938135255,-0.138412017167382
"United States","Oklahoma","OK",2020-01-26,2020-02-01,7,2020,"5",3956971,833,0,920,-87,833,0,-2.19865144323777,-0.0945652173913043
"United States","Oklahoma","OK",2020-02-02,2020-02-08,7,2020,"6",3956971,816,0,908,-92,816,0,-2.32501072158477,-0.101321585903084
"United States","Oklahoma","OK",2020-02-09,2020-02-15,7,2020,"7",3956971,806,0,897,-91,806,0,-2.29973886591537,-0.101449275362319
"United States","Oklahoma","OK",2020-02-16,2020-02-22,7,2020,"8",3956971,818,0,879,-61,818,0,-1.54158319583338,-0.0693970420932878
"United States","Oklahoma","OK",2020-02-23,2020-02-29,7,2020,"9",3956971,829,0,857,-28,829,0,-0.70761195874319,-0.0326721120186698
"United States","Oklahoma","OK",2020-03-01,2020-03-07,7,2020,"10",3956971,799,0,849,-50,799,0,-1.26359278346998,-0.0588928150765606
"United States","Oklahoma","OK",2020-03-08,2020-03-14,7,2020,"11",3956971,792,0,842,-50,792,0,-1.26359278346998,-0.0593824228028503
"United States","Oklahoma","OK",2020-03-15,2020-03-21,7,2020,"12",3956971,827,1,822,5,826,0.0252718556693996,0.126359278346998,0.0060827250608273
"United States","Oklahoma","OK",2020-03-22,2020-03-28,7,2020,"13",3956971,856,14,802,54,842,0.353805979371595,1.36468020614758,0.0673316708229426
"United States","Oklahoma","OK",2020-03-29,2020-04-04,7,2020,"14",3956971,784,27,789,-5,757,0.68234010307379,-0.126359278346998,-0.00633713561470217
"United States","Oklahoma","OK",2020-04-05,2020-04-11,7,2020,"15",3956971,857,52,782,75,805,1.31413649480878,1.89538917520497,0.0959079283887467
"United States","Oklahoma","OK",2020-04-12,2020-04-18,7,2020,"16",3956971,799,37,786,13,762,0.935058659767787,0.328534123702195,0.0165394402035624
"United States","Oklahoma","OK",2020-04-19,2020-04-25,7,2020,"17",3956971,780,63,788,-8,717,1.59212690717218,-0.202174845355197,-0.0101522842639594
"United States","Oklahoma","OK",2020-04-26,2020-05-02,7,2020,"18",3956971,759,44,780,-21,715,1.11196164945358,-0.530708969057393,-0.0269230769230769
"United States","Oklahoma","OK",2020-05-03,2020-05-09,7,2020,"19",3956971,776,32,772,4,744,0.808699381420789,0.101087422677599,0.00518134715025909
"United States","Oklahoma","OK",2020-05-10,2020-05-16,7,2020,"20",3956971,733,18,764,-31,715,0.454893402049194,-0.783427525751389,-0.0405759162303665
"United States","Oklahoma","OK",2020-05-17,2020-05-23,7,2020,"21",3956971,815,23,754,61,792,0.581252680396192,1.54158319583338,0.0809018567639257
"United States","Oklahoma","OK",2020-05-24,2020-05-30,7,2020,"22",3956971,740,22,743,-3,718,0.555980824726792,-0.075815567008199,-0.00403768506056523
"United States","Oklahoma","OK",2020-05-31,2020-06-06,7,2020,"23",3956971,789,14,737,52,775,0.353805979371595,1.31413649480878,0.0705563093622794
"United States","Oklahoma","OK",2020-06-07,2020-06-13,7,2020,"24",3956971,770,12,724,46,758,0.303262268032796,1.16250536079238,0.0635359116022098
"United States","Oklahoma","OK",2020-06-14,2020-06-20,7,2020,"25",3956971,741,9,722,19,732,0.227446701024597,0.480165257718593,0.0263157894736843
"United States","Oklahoma","OK",2020-06-21,2020-06-27,7,2020,"26",3956971,765,16,727,38,749,0.404349690710394,0.960330515437187,0.0522696011004127
"United States","Oklahoma","OK",2020-06-28,2020-07-04,7,2020,"27",3956971,781,14,728,53,767,0.353805979371595,1.33940835047818,0.0728021978021978
"United States","Oklahoma","OK",2020-07-05,2020-07-11,7,2020,"28",3956971,768,23,738,30,745,0.581252680396192,0.758155670081989,0.0406504065040652
"United States","Oklahoma","OK",2020-07-12,2020-07-18,7,2020,"29",3956971,794,30,735,59,764,0.758155670081989,1.49103948449458,0.0802721088435374
"United States","Oklahoma","OK",2020-07-19,2020-07-25,7,2020,"30",3956971,904,45,740,164,859,1.13723350512298,4.14458432978154,0.221621621621622
"United States","Oklahoma","OK",2020-07-26,2020-08-01,7,2020,"31",3956971,881,53,750,131,828,1.33940835047818,3.31061309269135,0.174666666666667
"United States","Oklahoma","OK",2020-08-02,2020-08-08,7,2020,"32",3956971,814,54,741,73,760,1.36468020614758,1.84484546386617,0.0985155195681511
"United States","Oklahoma","OK",2020-08-09,2020-08-15,7,2020,"33",3956971,860,54,736,124,806,1.36468020614758,3.13371010300556,0.168478260869565
"United States","Oklahoma","OK",2020-08-16,2020-08-22,7,2020,"34",3956971,877,68,729,148,809,1.71848618551918,3.74023463907115,0.203017832647462
"United States","Oklahoma","OK",2020-08-23,2020-08-29,7,2020,"35",3956971,814,72,725,89,742,1.81957360819677,2.24919515457657,0.122758620689655
"United States","Oklahoma","OK",2020-08-30,2020-09-05,7,2020,"36",3956971,828,53,721,107,775,1.33940835047818,2.70408855662576,0.148404993065187
"United States","Oklahoma","OK",2020-09-06,2020-09-12,7,2020,"37",3956971,802,49,721,81,753,1.23832092780058,2.04702030922137,0.112343966712899
"United States","Oklahoma","OK",2020-09-13,2020-09-19,7,2020,"38",3956971,793,44,718,75,749,1.11196164945358,1.89538917520497,0.104456824512535
"United States","Oklahoma","OK",2020-09-20,2020-09-26,7,2020,"39",3956971,909,61,717,192,848,1.54158319583338,4.85219628852473,0.267782426778243
"United States","Oklahoma","OK",2020-09-27,2020-10-03,7,2020,"40",3956971,851,47,725,126,804,1.18777721646178,3.18425381434436,0.173793103448276
"United States","Oklahoma","OK",2020-10-04,2020-10-10,7,2020,"41",3956971,970,44,719,251,926,1.11196164945358,6.34323577301931,0.349095966620306
"United States","Oklahoma","OK",2020-10-11,2020-10-17,7,2020,"42",3956971,862,73,724,138,789,1.84484546386617,3.48751608237715,0.19060773480663
"United States","Oklahoma","OK",2020-10-18,2020-10-24,7,2020,"43",3956971,945,77,722,223,868,1.94593288654377,5.63562381427612,0.308864265927978
"United States","Oklahoma","OK",2020-10-25,2020-10-31,7,2020,"44",3956971,1025,92,740,285,933,2.32501072158477,7.2024788657789,0.385135135135135
"United States","Oklahoma","OK",2020-11-01,2020-11-07,7,2020,"45",3956971,1028,92,746,282,936,2.32501072158477,7.1266632987707,0.378016085790885
"United States","Oklahoma","OK",2020-11-08,2020-11-14,7,2020,"46",3956971,1065,87,760,305,978,2.19865144323777,7.70791597916689,0.401315789473684
"United States","Oklahoma","OK",2020-11-15,2020-11-21,7,2020,"47",3956971,1148,87,776,372,1061,2.19865144323777,9.40113030901667,0.479381443298969
"United States","Oklahoma","OK",2020-11-22,2020-11-28,7,2020,"48",3956971,1148,114,780,368,1034,2.88099154631156,9.30004288633907,0.471794871794872
"United States","Oklahoma","OK",2020-11-29,2020-12-05,7,2020,"49",3956971,1321,157,778,543,1164,3.96768134009574,13.722617628484,0.697943444730077
"United States","Oklahoma","OK",2020-12-06,2020-12-12,7,2020,"50",3956971,1212,168,784,428,1044,4.24567175245914,10.816354226503,0.545918367346939
"United States","Oklahoma","OK",2020-12-13,2020-12-19,7,2020,"51",3956971,1281,147,792,489,1134,3.71496278340175,12.3579374223364,0.617424242424242
"United States","Oklahoma","OK",2020-12-20,2020-12-26,7,2020,"52",3956971,1272,168,791,481,1104,4.24567175245914,12.1557625769812,0.608091024020228
"United States","Oklahoma","OK",2020-12-27,2021-01-02,7,2020,"53",3956971,1337,170,804,533,1167,4.29621546379794,13.46989907179,0.662935323383085
"United States","Oklahoma","OK",2021-01-03,2021-01-09,7,2021,"1",3956971,1258,211,830,428,1047,5.33236154624333,10.816354226503,0.51566265060241
"United States","Oklahoma","OK",2021-01-10,2021-01-16,7,2021,"2",3956971,1303,214,847,456,1089,5.40817711325152,11.5239661852462,0.538370720188902
"United States","Oklahoma","OK",2021-01-17,2021-01-23,7,2021,"3",3956971,1306,279,861,445,1027,7.0508477317625,11.2459757728828,0.516840882694541
"United States","Oklahoma","OK",2021-01-24,2021-01-30,7,2021,"4",3956971,1171,273,858,313,898,6.8992165977461,7.91009082452209,0.364801864801865
"United States","Oklahoma","OK",2021-01-31,2021-02-06,7,2021,"5",3956971,1053,257,859,194,796,6.49486690703571,4.90273999986353,0.225844004656578
"United States","Oklahoma","OK",2021-02-07,2021-02-13,7,2021,"6",3956971,985,233,840,145,752,5.88834237097012,3.66441907206295,0.172619047619048
"United States","Oklahoma","OK",2021-02-14,2021-02-20,7,2021,"7",3956971,1012,161,837,175,851,4.06876876277334,4.42257474214494,0.209080047789725
"United States","Oklahoma","OK",2021-02-21,2021-02-27,7,2021,"8",3956971,926,224,828,98,702,5.66089566994552,2.47664185560117,0.118357487922705
"United States","Oklahoma","OK",2021-02-28,2021-03-06,7,2021,"9",3956971,886,156,825,61,730,3.94240948442635,1.54158319583338,0.073939393939394
"United States","Oklahoma","OK",2021-03-07,2021-03-13,7,2021,"10",3956971,847,167,812,35,680,4.22039989678974,0.884514948428988,0.0431034482758621
"United States","Oklahoma","OK",2021-03-14,2021-03-20,7,2021,"11",3956971,774,86,797,-23,688,2.17337958756837,-0.581252680396192,-0.0288582183186951
"United States","Oklahoma","OK",2021-03-21,2021-03-27,7,2021,"12",3956971,832,62,778,54,770,1.56685505150278,1.36468020614758,0.0694087403598971
"United States","Oklahoma","OK",2021-03-28,2021-04-03,7,2021,"13",3956971,785,103,754,31,682,2.60300113394816,0.783427525751389,0.0411140583554377
"United States","Oklahoma","OK",2021-04-04,2021-04-10,7,2021,"14",3956971,834,1716,746,88,-882,43.3665043286898,2.22392329890717,0.117962466487936
"United States","Oklahoma","OK",2021-04-11,2021-04-17,7,2021,"15",3956971,783,28,736,47,755,0.70761195874319,1.18777721646178,0.0638586956521738
"United States","Oklahoma","OK",2021-04-18,2021-04-24,7,2021,"16",3956971,785,19,740,45,766,0.480165257718593,1.13723350512298,0.0608108108108107
"United States","Oklahoma","OK",2021-04-25,2021-05-01,7,2021,"17",3956971,737,72,741,-4,665,1.81957360819677,-0.101087422677599,-0.00539811066126861
"United States","Oklahoma","OK",2021-05-02,2021-05-08,7,2021,"18",3956971,826,44,737,89,782,1.11196164945358,2.24919515457657,0.120759837177748
"United States","Oklahoma","OK",2021-05-09,2021-05-15,7,2021,"19",3956971,780,46,740,40,734,1.16250536079238,1.01087422677599,0.0540540540540539
"United States","Oklahoma","OK",2021-05-16,2021-05-22,7,2021,"20",3956971,780,40,733,47,740,1.01087422677599,1.18777721646178,0.0641200545702592
"United States","Oklahoma","OK",2021-05-23,2021-05-29,7,2021,"21",3956971,749,373,708,41,376,9.42640216468607,1.03614608244539,0.057909604519774
"United States","Oklahoma","OK",2021-05-30,2021-06-05,7,2021,"22",3956971,750,25,712,38,725,0.631796391734991,0.960330515437187,0.053370786516854
"United States","Oklahoma","OK",2021-06-06,2021-06-12,7,2021,"23",3956971,822,9,709,113,813,0.227446701024597,2.85571969064216,0.159379407616361
"United States","Oklahoma","OK",2021-06-13,2021-06-19,7,2021,"24",3956971,812,29,709,103,783,0.73288381441259,2.60300113394816,0.145275035260931
"United States","Oklahoma","OK",2021-06-20,2021-06-26,7,2021,"25",3956971,765,30,712,53,735,0.758155670081989,1.33940835047818,0.074438202247191
"United States","Oklahoma","OK",2021-06-27,2021-07-03,7,2021,"26",3956971,777,4,709,68,773,0.101087422677599,1.71848618551918,0.0959097320169253
"United States","Oklahoma","OK",2021-07-04,2021-07-10,7,2021,"27",3956971,782,18,706,76,764,0.454893402049194,1.92066103087437,0.107648725212464
"United States","Oklahoma","OK",2021-07-11,2021-07-17,7,2021,"28",3956971,729,11,708,21,718,0.277990412363396,0.530708969057393,0.0296610169491525
"United States","Oklahoma","OK",2021-07-18,2021-07-24,7,2021,"29",3956971,746,37,712,34,709,0.935058659767787,0.859243092759588,0.047752808988764
"United States","Oklahoma","OK",2021-07-25,2021-07-31,7,2021,"30",3956971,667,31,709,-42,636,0.783427525751389,-1.06141793811479,-0.0592383638928068
"United States","Oklahoma","OK",2021-08-01,2021-08-07,7,2021,"31",3956971,520,46,707,-187,474,1.16250536079238,-4.72583701017773,-0.264497878359265
"United States","Oregon","OR",2019-12-29,2020-01-04,7,2020,"1",4217737,737,0,807,-70,737,0,-1.65965777382516,-0.0867410161090458
"United States","Oregon","OR",2020-01-05,2020-01-11,7,2020,"2",4217737,764,0,805,-41,764,0,-0.972085267526164,-0.0509316770186335
"United States","Oregon","OR",2020-01-12,2020-01-18,7,2020,"3",4217737,769,0,791,-22,769,0,-0.521606728916478,-0.0278128950695322
"United States","Oregon","OR",2020-01-19,2020-01-25,7,2020,"4",4217737,745,0,768,-23,745,0,-0.545316125685409,-0.0299479166666666
"United States","Oregon","OR",2020-01-26,2020-02-01,7,2020,"5",4217737,728,0,743,-15,728,0,-0.355640951533962,-0.0201884253028264
"United States","Oregon","OR",2020-02-02,2020-02-08,7,2020,"6",4217737,727,0,724,3,727,0,0.0711281903067925,0.0041436464088398
"United States","Oregon","OR",2020-02-09,2020-02-15,7,2020,"7",4217737,783,0,718,65,783,0,1.5411107899805,0.0905292479108635
"United States","Oregon","OR",2020-02-16,2020-02-22,7,2020,"8",4217737,733,0,726,7,733,0,0.165965777382516,0.00964187327823685
"United States","Oregon","OR",2020-02-23,2020-02-29,7,2020,"9",4217737,735,0,728,7,735,0,0.165965777382516,0.00961538461538458
"United States","Oregon","OR",2020-03-01,2020-03-07,7,2020,"10",4217737,788,0,738,50,788,0,1.18546983844654,0.0677506775067751
"United States","Oregon","OR",2020-03-08,2020-03-14,7,2020,"11",4217737,746,1,726,20,745,0.0237093967689308,0.474187935378617,0.0275482093663912
"United States","Oregon","OR",2020-03-15,2020-03-21,7,2020,"12",4217737,775,3,718,57,772,0.0711281903067925,1.35143561582906,0.0793871866295264
"United States","Oregon","OR",2020-03-22,2020-03-28,7,2020,"13",4217737,768,9,709,59,759,0.213384570920377,1.39885440936692,0.0832157968970382
"United States","Oregon","OR",2020-03-29,2020-04-04,7,2020,"14",4217737,778,13,697,81,765,0.308222157996101,1.9204611382834,0.116212338593974
"United States","Oregon","OR",2020-04-05,2020-04-11,7,2020,"15",4217737,769,25,703,66,744,0.592734919223271,1.56482018674943,0.0938833570412518
"United States","Oregon","OR",2020-04-12,2020-04-18,7,2020,"16",4217737,765,21,693,72,744,0.497897332147547,1.70707656736302,0.103896103896104
"United States","Oregon","OR",2020-04-19,2020-04-25,7,2020,"17",4217737,770,15,681,89,755,0.355640951533962,2.11013631243484,0.130690161527166
"United States","Oregon","OR",2020-04-26,2020-05-02,7,2020,"18",4217737,714,22,678,36,692,0.521606728916478,0.85353828368151,0.0530973451327434
"United States","Oregon","OR",2020-05-03,2020-05-09,7,2020,"19",4217737,703,18,673,30,685,0.426769141840755,0.711281903067925,0.0445765230312036
"United States","Oregon","OR",2020-05-10,2020-05-16,7,2020,"20",4217737,716,10,672,44,706,0.237093967689308,1.04321345783296,0.0654761904761905
"United States","Oregon","OR",2020-05-17,2020-05-23,7,2020,"21",4217737,744,10,664,80,734,0.237093967689308,1.89675174151447,0.120481927710843
"United States","Oregon","OR",2020-05-24,2020-05-30,7,2020,"22",4217737,748,6,659,89,742,0.142256380613585,2.11013631243484,0.1350531107739
"United States","Oregon","OR",2020-05-31,2020-06-06,7,2020,"23",4217737,683,8,652,31,675,0.189675174151447,0.734991299836856,0.0475460122699387
"United States","Oregon","OR",2020-06-07,2020-06-13,7,2020,"24",4217737,727,13,651,76,714,0.308222157996101,1.80191415443874,0.116743471582181
"United States","Oregon","OR",2020-06-14,2020-06-20,7,2020,"25",4217737,731,15,656,75,716,0.355640951533962,1.77820475766981,0.114329268292683
"United States","Oregon","OR",2020-06-21,2020-06-27,7,2020,"26",4217737,689,14,649,40,675,0.331931554765032,0.948375870757233,0.0616332819722649
"United States","Oregon","OR",2020-06-28,2020-07-04,7,2020,"27",4217737,760,10,639,121,750,0.237093967689308,2.86883700904063,0.189358372456964
"United States","Oregon","OR",2020-07-05,2020-07-11,7,2020,"28",4217737,713,19,638,75,694,0.450478538609686,1.77820475766981,0.117554858934169
"United States","Oregon","OR",2020-07-12,2020-07-18,7,2020,"29",4217737,759,25,646,113,734,0.592734919223271,2.67916183488918,0.174922600619195
"United States","Oregon","OR",2020-07-19,2020-07-25,7,2020,"30",4217737,740,29,650,90,711,0.687572506298994,2.13384570920377,0.138461538461538
"United States","Oregon","OR",2020-07-26,2020-08-01,7,2020,"31",4217737,719,39,650,69,680,0.924666473988302,1.63594837705623,0.106153846153846
"United States","Oregon","OR",2020-08-02,2020-08-08,7,2020,"32",4217737,768,30,644,124,738,0.711281903067925,2.93996519934742,0.192546583850932
"United States","Oregon","OR",2020-08-09,2020-08-15,7,2020,"33",4217737,777,31,639,138,746,0.734991299836856,3.27189675411245,0.215962441314554
"United States","Oregon","OR",2020-08-16,2020-08-22,7,2020,"34",4217737,789,31,634,155,758,0.734991299836856,3.67495649918428,0.244479495268139
"United States","Oregon","OR",2020-08-23,2020-08-29,7,2020,"35",4217737,749,38,628,121,711,0.900957077219371,2.86883700904063,0.192675159235669
"United States","Oregon","OR",2020-08-30,2020-09-05,7,2020,"36",4217737,707,25,621,86,682,0.592734919223271,2.03900812212805,0.138486312399356
"United States","Oregon","OR",2020-09-06,2020-09-12,7,2020,"37",4217737,737,25,621,116,712,0.592734919223271,2.75029002519598,0.186795491143317
"United States","Oregon","OR",2020-09-13,2020-09-19,7,2020,"38",4217737,790,19,623,167,771,0.450478538609686,3.95946926041145,0.268057784911717
"United States","Oregon","OR",2020-09-20,2020-09-26,7,2020,"39",4217737,730,19,632,98,711,0.450478538609686,2.32352088335522,0.15506329113924
"United States","Oregon","OR",2020-09-27,2020-10-03,7,2020,"40",4217737,733,20,647,86,713,0.474187935378617,2.03900812212805,0.132921174652241
"United States","Oregon","OR",2020-10-04,2020-10-10,7,2020,"41",4217737,761,34,658,103,727,0.806119490143648,2.44206786719988,0.156534954407295
"United States","Oregon","OR",2020-10-11,2020-10-17,7,2020,"42",4217737,713,23,650,63,690,0.545316125685409,1.49369199644264,0.0969230769230769
"United States","Oregon","OR",2020-10-18,2020-10-24,7,2020,"43",4217737,763,33,660,103,730,0.782410093374717,2.44206786719988,0.156060606060606
"United States","Oregon","OR",2020-10-25,2020-10-31,7,2020,"44",4217737,782,35,661,121,747,0.829828886912579,2.86883700904063,0.183055975794251
"United States","Oregon","OR",2020-11-01,2020-11-07,7,2020,"45",4217737,835,41,667,168,794,0.972085267526164,3.98317865718038,0.251874062968516
"United States","Oregon","OR",2020-11-08,2020-11-14,7,2020,"46",4217737,838,30,672,166,808,0.711281903067925,3.93575986364252,0.24702380952381
"United States","Oregon","OR",2020-11-15,2020-11-21,7,2020,"47",4217737,835,60,691,144,775,1.42256380613585,3.41415313472604,0.208393632416787
"United States","Oregon","OR",2020-11-22,2020-11-28,7,2020,"48",4217737,880,77,682,198,803,1.82562355120767,4.6944605602483,0.290322580645161
"United States","Oregon","OR",2020-11-29,2020-12-05,7,2020,"49",4217737,936,131,688,248,805,3.10593097672994,5.87993039869485,0.36046511627907
"United States","Oregon","OR",2020-12-06,2020-12-12,7,2020,"50",4217737,941,110,695,246,831,2.60803364458239,5.83251160515698,0.353956834532374
"United States","Oregon","OR",2020-12-13,2020-12-19,7,2020,"51",4217737,979,165,715,264,814,3.91205046687359,6.25928074699774,0.369230769230769
"United States","Oregon","OR",2020-12-20,2020-12-26,7,2020,"52",4217737,878,113,735,143,765,2.67916183488918,3.39044373795711,0.194557823129252
"United States","Oregon","OR",2020-12-27,2021-01-02,7,2020,"53",4217737,904,62,769,135,842,1.46998259967371,3.20076856380566,0.17555266579974
"United States","Oregon","OR",2021-01-03,2021-01-09,7,2021,"1",4217737,885,98,780,105,787,2.32352088335522,2.48948666073774,0.134615384615385
"United States","Oregon","OR",2021-01-10,2021-01-16,7,2021,"2",4217737,888,183,780,108,705,4.33881960871434,2.56061485104453,0.138461538461538
"United States","Oregon","OR",2021-01-17,2021-01-23,7,2021,"3",4217737,854,107,778,76,747,2.5369054542756,1.80191415443874,0.0976863753213368
"United States","Oregon","OR",2021-01-24,2021-01-30,7,2021,"4",4217737,836,73,765,71,763,1.73078596413195,1.68336717059409,0.0928104575163398
"United States","Oregon","OR",2021-01-31,2021-02-06,7,2021,"5",4217737,835,64,750,85,771,1.51740139321157,2.01529872535912,0.113333333333333
"United States","Oregon","OR",2021-02-07,2021-02-13,7,2021,"6",4217737,791,92,748,43,699,2.18126450274164,1.01950406106403,0.0574866310160427
"United States","Oregon","OR",2021-02-14,2021-02-20,7,2021,"7",4217737,814,55,757,57,759,1.3040168222912,1.35143561582906,0.0752972258916778
"United States","Oregon","OR",2021-02-21,2021-02-27,7,2021,"8",4217737,807,57,765,42,750,1.35143561582906,0.995794664295095,0.0549019607843138
"United States","Oregon","OR",2021-02-28,2021-03-06,7,2021,"9",4217737,800,87,778,22,713,2.06271751889698,0.521606728916478,0.0282776349614395
"United States","Oregon","OR",2021-03-07,2021-03-13,7,2021,"10",4217737,786,26,778,8,760,0.616444315992202,0.189675174151447,0.0102827763496145
"United States","Oregon","OR",2021-03-14,2021-03-20,7,2021,"11",4217737,831,38,773,58,793,0.900957077219371,1.37514501259799,0.0750323415265199
"United States","Oregon","OR",2021-03-21,2021-03-27,7,2021,"12",4217737,809,16,768,41,793,0.379350348302893,0.972085267526164,0.0533854166666667
"United States","Oregon","OR",2021-03-28,2021-04-03,7,2021,"13",4217737,816,12,764,52,804,0.28451276122717,1.2328886319844,0.0680628272251309
"United States","Oregon","OR",2021-04-04,2021-04-10,7,2021,"14",4217737,786,55,747,39,731,1.3040168222912,0.924666473988302,0.0522088353413654
"United States","Oregon","OR",2021-04-11,2021-04-17,7,2021,"15",4217737,746,17,736,10,729,0.403059745071824,0.237093967689308,0.013586956521739
"United States","Oregon","OR",2021-04-18,2021-04-24,7,2021,"16",4217737,793,19,726,67,774,0.450478538609686,1.58852958351837,0.0922865013774106
"United States","Oregon","OR",2021-04-25,2021-05-01,7,2021,"17",4217737,779,19,724,55,760,0.450478538609686,1.3040168222912,0.0759668508287292
"United States","Oregon","OR",2021-05-02,2021-05-08,7,2021,"18",4217737,777,27,724,53,750,0.640153712761132,1.25659802875333,0.0732044198895028
"United States","Oregon","OR",2021-05-09,2021-05-15,7,2021,"19",4217737,811,60,719,92,751,1.42256380613585,2.18126450274164,0.127955493741307
"United States","Oregon","OR",2021-05-16,2021-05-22,7,2021,"20",4217737,823,31,719,104,792,0.734991299836856,2.46577726396881,0.144645340751043
"United States","Oregon","OR",2021-05-23,2021-05-29,7,2021,"21",4217737,780,52,713,67,728,1.2328886319844,1.58852958351837,0.0939691444600281
"United States","Oregon","OR",2021-05-30,2021-06-05,7,2021,"22",4217737,800,21,721,79,779,0.497897332147547,1.87304234474554,0.109570041608877
"United States","Oregon","OR",2021-06-06,2021-06-12,7,2021,"23",4217737,791,40,717,74,751,0.948375870757233,1.75449536090088,0.103207810320781
"United States","Oregon","OR",2021-06-13,2021-06-19,7,2021,"24",4217737,770,24,718,52,746,0.56902552245434,1.2328886319844,0.0724233983286908
"United States","Oregon","OR",2021-06-20,2021-06-26,7,2021,"25",4217737,762,11,714,48,751,0.260803364458239,1.13805104490868,0.0672268907563025
"United States","Oregon","OR",2021-06-27,2021-07-03,7,2021,"26",4217737,921,20,719,202,901,0.474187935378617,4.78929814732403,0.280945757997218
"United States","Oregon","OR",2021-07-04,2021-07-10,7,2021,"27",4217737,776,11,710,66,765,0.260803364458239,1.56482018674943,0.0929577464788733
"United States","Oregon","OR",2021-07-11,2021-07-17,7,2021,"28",4217737,763,25,709,54,738,0.592734919223271,1.28030742552226,0.0761636107193231
"United States","Oregon","OR",2021-07-18,2021-07-24,7,2021,"29",4217737,725,19,709,16,706,0.450478538609686,0.379350348302893,0.0225669957686883
"United States","Oregon","OR",2021-07-25,2021-07-31,7,2021,"30",4217737,679,22,709,-30,657,0.521606728916478,-0.711281903067925,-0.0423131170662906
"United States","Oregon","OR",2021-08-01,2021-08-07,7,2021,"31",4217737,540,31,707,-167,509,0.734991299836856,-3.95946926041145,-0.236209335219236
"United States","Pennsylvania","PA",2019-12-29,2020-01-04,7,2020,"1",12801989,2785,0,2997,-212,2785,0,-1.65599267426335,-0.0707374040707374
"United States","Pennsylvania","PA",2020-01-05,2020-01-11,7,2020,"2",12801989,2849,0,3041,-192,2849,0,-1.49976695027624,-0.0631371259454127
"United States","Pennsylvania","PA",2020-01-12,2020-01-18,7,2020,"3",12801989,2862,0,3018,-156,2862,0,-1.21856064709945,-0.0516898608349901
"United States","Pennsylvania","PA",2020-01-19,2020-01-25,7,2020,"4",12801989,2795,0,2988,-193,2795,0,-1.5075782364756,-0.0645917001338688
"United States","Pennsylvania","PA",2020-01-26,2020-02-01,7,2020,"5",12801989,2810,0,2975,-165,2810,0,-1.28886222289365,-0.0554621848739496
"United States","Pennsylvania","PA",2020-02-02,2020-02-08,7,2020,"6",12801989,2787,0,2950,-163,2787,0,-1.27323965049493,-0.0552542372881356
"United States","Pennsylvania","PA",2020-02-09,2020-02-15,7,2020,"7",12801989,2811,0,2911,-100,2811,0,-0.781128619935543,-0.0343524562006183
"United States","Pennsylvania","PA",2020-02-16,2020-02-22,7,2020,"8",12801989,2704,0,2896,-192,2704,0,-1.49976695027624,-0.0662983425414365
"United States","Pennsylvania","PA",2020-02-23,2020-02-29,7,2020,"9",12801989,2774,0,2843,-69,2774,0,-0.538978747755525,-0.0242701371790363
"United States","Pennsylvania","PA",2020-03-01,2020-03-07,7,2020,"10",12801989,2787,0,2830,-43,2787,0,-0.335885306572283,-0.0151943462897527
"United States","Pennsylvania","PA",2020-03-08,2020-03-14,7,2020,"11",12801989,2833,0,2805,28,2833,0,0.218716013581952,0.00998217468805707
"United States","Pennsylvania","PA",2020-03-15,2020-03-21,7,2020,"12",12801989,2603,2,2785,-182,2601,0.0156225723987109,-1.42165408828269,-0.0653500897666068
"United States","Pennsylvania","PA",2020-03-22,2020-03-28,7,2020,"13",12801989,2735,32,2757,-22,2703,0.249961158379374,-0.171848296385819,-0.00797968806673921
"United States","Pennsylvania","PA",2020-03-29,2020-04-04,7,2020,"14",12801989,3004,102,2739,265,2902,0.796751192334254,2.06999084282919,0.0967506389193136
"United States","Pennsylvania","PA",2020-04-05,2020-04-11,7,2020,"15",12801989,3453,355,2692,761,3098,2.77300660077118,5.94438879770948,0.282689450222883
"United States","Pennsylvania","PA",2020-04-12,2020-04-18,7,2020,"16",12801989,3743,345,2662,1081,3398,2.69489373877762,8.44400038150322,0.406085649887303
"United States","Pennsylvania","PA",2020-04-19,2020-04-25,7,2020,"17",12801989,3823,700,2613,1210,3123,5.4679003395488,9.45165630122007,0.463069269039418
"United States","Pennsylvania","PA",2020-04-26,2020-05-02,7,2020,"18",12801989,3564,881,2550,1014,2683,6.88174314163213,7.9206442061464,0.397647058823529
"United States","Pennsylvania","PA",2020-05-03,2020-05-09,7,2020,"19",12801989,3439,1252,2501,938,2187,9.779730321593,7.32698645499539,0.375049980007997
"United States","Pennsylvania","PA",2020-05-10,2020-05-16,7,2020,"20",12801989,3284,534,2469,815,2750,4.1712268304558,6.36619825247467,0.330093155123532
"United States","Pennsylvania","PA",2020-05-17,2020-05-23,7,2020,"21",12801989,2977,893,2441,536,2084,6.9754785760244,4.18684940285451,0.219582138467841
"United States","Pennsylvania","PA",2020-05-24,2020-05-30,7,2020,"22",12801989,2792,440,2445,347,2352,3.43696592771639,2.71051631117633,0.141922290388548
"United States","Pennsylvania","PA",2020-05-31,2020-06-06,7,2020,"23",12801989,2730,394,2458,272,2336,3.07764676254604,2.12466984622468,0.110659072416599
"United States","Pennsylvania","PA",2020-06-07,2020-06-13,7,2020,"24",12801989,2573,280,2441,132,2293,2.18716013581952,1.03108977831492,0.0540761982793936
"United States","Pennsylvania","PA",2020-06-14,2020-06-20,7,2020,"25",12801989,2624,209,2453,171,2415,1.63255881566528,1.33572994008978,0.0697105584997961
"United States","Pennsylvania","PA",2020-06-21,2020-06-27,7,2020,"26",12801989,2561,183,2419,142,2378,1.42946537448204,1.10920264030847,0.0587019429516329
"United States","Pennsylvania","PA",2020-06-28,2020-07-04,7,2020,"27",12801989,2595,147,2396,199,2448,1.14825907130525,1.55444595367173,0.0830550918196995
"United States","Pennsylvania","PA",2020-07-05,2020-07-11,7,2020,"28",12801989,2677,148,2381,296,2529,1.1560703575046,2.31214071500921,0.124317513649727
"United States","Pennsylvania","PA",2020-07-12,2020-07-18,7,2020,"29",12801989,2560,110,2348,212,2450,0.859241481929097,1.65599267426335,0.090289608177172
"United States","Pennsylvania","PA",2020-07-19,2020-07-25,7,2020,"30",12801989,2535,107,2351,184,2428,0.835807623331031,1.4372766606814,0.0782645682688219
"United States","Pennsylvania","PA",2020-07-26,2020-08-01,7,2020,"31",12801989,2645,90,2355,290,2555,0.703015757941989,2.26527299781307,0.123142250530786
"United States","Pennsylvania","PA",2020-08-02,2020-08-08,7,2020,"32",12801989,2540,109,2357,183,2431,0.851430195729742,1.42946537448204,0.0776410691557063
"United States","Pennsylvania","PA",2020-08-09,2020-08-15,7,2020,"33",12801989,2661,152,2352,309,2509,1.18731550230203,2.41368743560083,0.131377551020408
"United States","Pennsylvania","PA",2020-08-16,2020-08-22,7,2020,"34",12801989,2634,111,2346,288,2523,0.867052768128453,2.24965042541436,0.122762148337596
"United States","Pennsylvania","PA",2020-08-23,2020-08-29,7,2020,"35",12801989,2589,95,2339,250,2494,0.742072188938766,1.95282154983886,0.106883283454468
"United States","Pennsylvania","PA",2020-08-30,2020-09-05,7,2020,"36",12801989,2604,89,2360,244,2515,0.695204471742633,1.90595383264272,0.103389830508475
"United States","Pennsylvania","PA",2020-09-06,2020-09-12,7,2020,"37",12801989,2619,77,2351,268,2542,0.601469037350368,2.09342470142725,0.113994045087197
"United States","Pennsylvania","PA",2020-09-13,2020-09-19,7,2020,"38",12801989,2618,119,2354,264,2499,0.929543057723296,2.06217955662983,0.11214953271028
"United States","Pennsylvania","PA",2020-09-20,2020-09-26,7,2020,"39",12801989,2678,147,2370,308,2531,1.14825907130525,2.40587614940147,0.129957805907173
"United States","Pennsylvania","PA",2020-09-27,2020-10-03,7,2020,"40",12801989,2681,96,2401,280,2585,0.749883475138121,2.18716013581952,0.116618075801749
"United States","Pennsylvania","PA",2020-10-04,2020-10-10,7,2020,"41",12801989,2769,73,2409,360,2696,0.570223892552946,2.81206303176795,0.149439601494396
"United States","Pennsylvania","PA",2020-10-11,2020-10-17,7,2020,"42",12801989,2669,194,2456,213,2475,1.51538952267495,1.66380396046271,0.0867263843648209
"United States","Pennsylvania","PA",2020-10-18,2020-10-24,7,2020,"43",12801989,2766,188,2449,317,2578,1.46852180547882,2.47617772519567,0.1294405879951
"United States","Pennsylvania","PA",2020-10-25,2020-10-31,7,2020,"44",12801989,2758,158,2455,303,2600,1.23418321949816,2.36681971840469,0.123421588594705
"United States","Pennsylvania","PA",2020-11-01,2020-11-07,7,2020,"45",12801989,2984,203,2477,507,2781,1.58569109846915,3.9603221030732,0.204683084376262
"United States","Pennsylvania","PA",2020-11-08,2020-11-14,7,2020,"46",12801989,3123,259,2487,636,2864,2.02312312563306,4.96797802279005,0.255729794933655
"United States","Pennsylvania","PA",2020-11-15,2020-11-21,7,2020,"47",12801989,3355,415,2516,839,2940,3.2416837727325,6.5536691212592,0.333465818759936
"United States","Pennsylvania","PA",2020-11-22,2020-11-28,7,2020,"48",12801989,3659,586,2541,1118,3073,4.57741371282228,8.73301797087937,0.439984258166076
"United States","Pennsylvania","PA",2020-11-29,2020-12-05,7,2020,"49",12801989,3903,987,2577,1326,2916,7.70973947876381,10.3577655003453,0.514551804423748
"United States","Pennsylvania","PA",2020-12-06,2020-12-12,7,2020,"50",12801989,4355,1174,2589,1766,3181,9.17044999804327,13.7947314280617,0.682116647354191
"United States","Pennsylvania","PA",2020-12-13,2020-12-19,7,2020,"51",12801989,4456,1389,2611,1845,3067,10.8498765309047,14.4118230378108,0.70662581386442
"United States","Pennsylvania","PA",2020-12-20,2020-12-26,7,2020,"52",12801989,4490,1054,2651,1839,3436,8.23309565412062,14.3649553206146,0.693700490380988
"United States","Pennsylvania","PA",2020-12-27,2021-01-02,7,2020,"53",12801989,4424,1360,2676,1748,3064,10.6233492311234,13.6541282764733,0.65321375186846
"United States","Pennsylvania","PA",2021-01-03,2021-01-09,7,2021,"1",12801989,4001,1428,2735,1266,2573,11.1545166926796,9.88908832838397,0.462888482632541
"United States","Pennsylvania","PA",2021-01-10,2021-01-16,7,2021,"2",12801989,3885,1521,2789,1096,2364,11.8809663092196,8.56116967449355,0.392972391538186
"United States","Pennsylvania","PA",2021-01-17,2021-01-23,7,2021,"3",12801989,3846,1338,2797,1049,2508,10.4515009347376,8.19403922312384,0.375044690740079
"United States","Pennsylvania","PA",2021-01-24,2021-01-30,7,2021,"4",12801989,3584,1076,2792,792,2508,8.40494395050644,6.1865386698895,0.283667621776504
"United States","Pennsylvania","PA",2021-01-31,2021-02-06,7,2021,"5",12801989,3393,794,2787,606,2599,6.20216124228821,4.73363943680939,0.217438105489774
"United States","Pennsylvania","PA",2021-02-07,2021-02-13,7,2021,"6",12801989,3230,564,2744,486,2666,4.40556541643646,3.79628509288674,0.177113702623907
"United States","Pennsylvania","PA",2021-02-14,2021-02-20,7,2021,"7",12801989,3116,611,2727,389,2505,4.77269586780617,3.03859033154926,0.142647598093143
"United States","Pennsylvania","PA",2021-02-21,2021-02-27,7,2021,"8",12801989,2897,370,2725,172,2527,2.89017589376151,1.34354122628913,0.0631192660550459
"United States","Pennsylvania","PA",2021-02-28,2021-03-06,7,2021,"9",12801989,2768,381,2706,62,2387,2.97610004195442,0.484299744360037,0.0229120473022912
"United States","Pennsylvania","PA",2021-03-07,2021-03-13,7,2021,"10",12801989,2708,253,2679,29,2455,1.97625540843692,0.226527299781307,0.0108249346771183
"United States","Pennsylvania","PA",2021-03-14,2021-03-20,7,2021,"11",12801989,2807,207,2668,139,2600,1.61693624326657,1.0857687817104,0.0520989505247376
"United States","Pennsylvania","PA",2021-03-21,2021-03-27,7,2021,"12",12801989,2696,207,2651,45,2489,1.61693624326657,0.351507878970994,0.0169747265182949
"United States","Pennsylvania","PA",2021-03-28,2021-04-03,7,2021,"13",12801989,2620,201,2645,-25,2419,1.57006852607044,-0.195282154983886,-0.00945179584120981
"United States","Pennsylvania","PA",2021-04-04,2021-04-10,7,2021,"14",12801989,2772,172,2613,159,2600,1.34354122628913,1.24199450569751,0.060849598163031
"United States","Pennsylvania","PA",2021-04-11,2021-04-17,7,2021,"15",12801989,2842,299,2578,264,2543,2.33557457360727,2.06217955662983,0.102404965089216
"United States","Pennsylvania","PA",2021-04-18,2021-04-24,7,2021,"16",12801989,2788,277,2549,239,2511,2.16372627722145,1.86689740164595,0.0937622597096901
"United States","Pennsylvania","PA",2021-04-25,2021-05-01,7,2021,"17",12801989,2679,315,2513,166,2364,2.46055515279696,1.296673509093,0.0660565061679268
"United States","Pennsylvania","PA",2021-05-02,2021-05-08,7,2021,"18",12801989,2729,279,2468,261,2450,2.17934884962016,2.03874569803177,0.105753646677472
"United States","Pennsylvania","PA",2021-05-09,2021-05-15,7,2021,"19",12801989,2702,192,2460,242,2510,1.49976695027624,1.89033126024401,0.0983739837398374
"United States","Pennsylvania","PA",2021-05-16,2021-05-22,7,2021,"20",12801989,2699,305,2433,266,2394,2.38244229080341,2.07780212902854,0.109330045211673
"United States","Pennsylvania","PA",2021-05-23,2021-05-29,7,2021,"21",12801989,2525,158,2422,103,2367,1.23418321949816,0.804562478533609,0.0425268373245251
"United States","Pennsylvania","PA",2021-05-30,2021-06-05,7,2021,"22",12801989,2604,162,2415,189,2442,1.26542836429558,1.47633309167818,0.0782608695652174
"United States","Pennsylvania","PA",2021-06-06,2021-06-12,7,2021,"23",12801989,2418,125,2429,-11,2293,0.976410774919429,-0.0859241481929097,-0.00452861259777682
"United States","Pennsylvania","PA",2021-06-13,2021-06-19,7,2021,"24",12801989,2504,86,2426,78,2418,0.671770613144567,0.609280323549723,0.0321516900247321
"United States","Pennsylvania","PA",2021-06-20,2021-06-26,7,2021,"25",12801989,2484,83,2418,66,2401,0.648336754546501,0.515544889157458,0.0272952853598014
"United States","Pennsylvania","PA",2021-06-27,2021-07-03,7,2021,"26",12801989,2515,62,2403,112,2453,0.484299744360037,0.874864054327808,0.046608406158968
"United States","Pennsylvania","PA",2021-07-04,2021-07-10,7,2021,"27",12801989,2488,40,2391,97,2448,0.312451447974217,0.757694761337477,0.040568799665412
"United States","Pennsylvania","PA",2021-07-11,2021-07-17,7,2021,"28",12801989,2377,45,2390,-13,2332,0.351507878970994,-0.101546720591621,-0.00543933054393309
"United States","Pennsylvania","PA",2021-07-18,2021-07-24,7,2021,"29",12801989,2433,33,2379,54,2400,0.257772444578729,0.421809454765193,0.0226986128625473
"United States","Pennsylvania","PA",2021-07-25,2021-07-31,7,2021,"30",12801989,2372,27,2382,-10,2345,0.210904727382597,-0.0781128619935543,-0.00419815281276237
"United States","Pennsylvania","PA",2021-08-01,2021-08-07,7,2021,"31",12801989,1803,52,2381,-578,1751,0.406186882366482,-4.51492342322744,-0.242755144897102
"United States","Rhode Island","RI",2019-12-29,2020-01-04,7,2020,"1",1059361,225,0,228,-3,225,0,-0.283189583154373,-0.0131578947368421
"United States","Rhode Island","RI",2020-01-05,2020-01-11,7,2020,"2",1059361,201,0,227,-26,201,0,-2.45430972067123,-0.114537444933921
"United States","Rhode Island","RI",2020-01-12,2020-01-18,7,2020,"3",1059361,204,0,228,-24,204,0,-2.26551666523499,-0.105263157894737
"United States","Rhode Island","RI",2020-01-19,2020-01-25,7,2020,"4",1059361,199,0,225,-26,199,0,-2.45430972067123,-0.115555555555556
"United States","Rhode Island","RI",2020-01-26,2020-02-01,7,2020,"5",1059361,220,0,229,-9,220,0,-0.84956874946312,-0.0393013100436681
"United States","Rhode Island","RI",2020-02-02,2020-02-08,7,2020,"6",1059361,244,0,230,14,244,0,1.32155138805374,0.0608695652173914
"United States","Rhode Island","RI",2020-02-09,2020-02-15,7,2020,"7",1059361,183,0,229,-46,183,0,-4.34224027503372,-0.200873362445415
"United States","Rhode Island","RI",2020-02-16,2020-02-22,7,2020,"8",1059361,206,0,228,-22,206,0,-2.07672360979874,-0.0964912280701754
"United States","Rhode Island","RI",2020-02-23,2020-02-29,7,2020,"9",1059361,235,0,221,14,235,0,1.32155138805374,0.0633484162895928
"United States","Rhode Island","RI",2020-03-01,2020-03-07,7,2020,"10",1059361,251,0,219,32,251,0,3.02068888697998,0.146118721461187
"United States","Rhode Island","RI",2020-03-08,2020-03-14,7,2020,"11",1059361,196,0,219,-23,196,0,-2.17112013751686,-0.105022831050228
"United States","Rhode Island","RI",2020-03-15,2020-03-21,7,2020,"12",1059361,220,0,218,2,220,0,0.188793055436249,0.00917431192660545
"United States","Rhode Island","RI",2020-03-22,2020-03-28,7,2020,"13",1059361,200,2,210,-10,198,0.188793055436249,-0.943965277181244,-0.0476190476190477
"United States","Rhode Island","RI",2020-03-29,2020-04-04,7,2020,"14",1059361,236,13,214,22,223,1.22715486033562,2.07672360979874,0.102803738317757
"United States","Rhode Island","RI",2020-04-05,2020-04-11,7,2020,"15",1059361,246,41,218,28,205,3.8702576364431,2.64310277610748,0.128440366972477
"United States","Rhode Island","RI",2020-04-12,2020-04-18,7,2020,"16",1059361,273,81,221,52,192,7.64611874516808,4.90861944134247,0.235294117647059
"United States","Rhode Island","RI",2020-04-19,2020-04-25,7,2020,"17",1059361,297,78,216,81,219,7.3629291620137,7.64611874516808,0.375
"United States","Rhode Island","RI",2020-04-26,2020-05-02,7,2020,"18",1059361,332,81,220,112,251,7.64611874516808,10.5724111044299,0.509090909090909
"United States","Rhode Island","RI",2020-05-03,2020-05-09,7,2020,"19",1059361,381,122,219,162,259,11.5163763816112,15.2922374903362,0.73972602739726
"United States","Rhode Island","RI",2020-05-10,2020-05-16,7,2020,"20",1059361,303,71,215,88,232,6.70215346798683,8.30689443919495,0.409302325581395
"United States","Rhode Island","RI",2020-05-17,2020-05-23,7,2020,"21",1059361,279,108,203,76,171,10.1948249935574,7.17413610657746,0.374384236453202
"United States","Rhode Island","RI",2020-05-24,2020-05-30,7,2020,"22",1059361,254,121,198,56,133,11.4219798538931,5.28620555221497,0.282828282828283
"United States","Rhode Island","RI",2020-05-31,2020-06-06,7,2020,"23",1059361,241,54,193,48,187,5.09741249677872,4.53103333046997,0.248704663212435
"United States","Rhode Island","RI",2020-06-07,2020-06-13,7,2020,"24",1059361,209,61,195,14,148,5.75818819080559,1.32155138805374,0.0717948717948718
"United States","Rhode Island","RI",2020-06-14,2020-06-20,7,2020,"25",1059361,237,61,196,41,176,5.75818819080559,3.8702576364431,0.209183673469388
"United States","Rhode Island","RI",2020-06-21,2020-06-27,7,2020,"26",1059361,200,33,197,3,167,3.11508541469811,0.283189583154373,0.015228426395939
"United States","Rhode Island","RI",2020-06-28,2020-07-04,7,2020,"27",1059361,177,33,194,-17,144,3.11508541469811,-1.60474097120812,-0.0876288659793815
"United States","Rhode Island","RI",2020-07-05,2020-07-11,7,2020,"28",1059361,190,16,194,-4,174,1.51034444348999,-0.377586110872498,-0.020618556701031
"United States","Rhode Island","RI",2020-07-12,2020-07-18,7,2020,"29",1059361,190,14,190,0,176,1.32155138805374,0,0
"United States","Rhode Island","RI",2020-07-19,2020-07-25,7,2020,"30",1059361,173,4,188,-15,169,0.377586110872498,-1.41594791577187,-0.0797872340425532
"United States","Rhode Island","RI",2020-07-26,2020-08-01,7,2020,"31",1059361,200,-5,188,12,205,-0.471982638590622,1.13275833261749,0.0638297872340425
"United States","Rhode Island","RI",2020-08-02,2020-08-08,7,2020,"32",1059361,209,5,187,22,204,0.471982638590622,2.07672360979874,0.117647058823529
"United States","Rhode Island","RI",2020-08-09,2020-08-15,7,2020,"33",1059361,211,7,185,26,204,0.660775694026871,2.45430972067123,0.14054054054054
"United States","Rhode Island","RI",2020-08-16,2020-08-22,7,2020,"34",1059361,198,7,192,6,191,0.660775694026871,0.566379166308747,0.03125
"United States","Rhode Island","RI",2020-08-23,2020-08-29,7,2020,"35",1059361,187,12,192,-5,175,1.13275833261749,-0.471982638590622,-0.0260416666666666
"United States","Rhode Island","RI",2020-08-30,2020-09-05,7,2020,"36",1059361,207,11,191,16,196,1.03836180489937,1.51034444348999,0.0837696335078535
"United States","Rhode Island","RI",2020-09-06,2020-09-12,7,2020,"37",1059361,190,11,196,-6,179,1.03836180489937,-0.566379166308747,-0.0306122448979592
"United States","Rhode Island","RI",2020-09-13,2020-09-19,7,2020,"38",1059361,194,13,197,-3,181,1.22715486033562,-0.283189583154373,-0.0152284263959391
"United States","Rhode Island","RI",2020-09-20,2020-09-26,7,2020,"39",1059361,208,23,198,10,185,2.17112013751686,0.943965277181244,0.0505050505050506
"United States","Rhode Island","RI",2020-09-27,2020-10-03,7,2020,"40",1059361,218,14,197,21,204,1.32155138805374,1.98232708208061,0.106598984771574
"United States","Rhode Island","RI",2020-10-04,2020-10-10,7,2020,"41",1059361,214,12,198,16,202,1.13275833261749,1.51034444348999,0.0808080808080809
"United States","Rhode Island","RI",2020-10-11,2020-10-17,7,2020,"42",1059361,214,12,198,16,202,1.13275833261749,1.51034444348999,0.0808080808080809
"United States","Rhode Island","RI",2020-10-18,2020-10-24,7,2020,"43",1059361,196,23,197,-1,173,2.17112013751686,-0.0943965277181244,-0.00507614213197971
"United States","Rhode Island","RI",2020-10-25,2020-10-31,7,2020,"44",1059361,204,27,202,2,177,2.54870624838936,0.188793055436249,0.00990099009900991
"United States","Rhode Island","RI",2020-11-01,2020-11-07,7,2020,"45",1059361,228,23,203,25,205,2.17112013751686,2.35991319295311,0.123152709359606
"United States","Rhode Island","RI",2020-11-08,2020-11-14,7,2020,"46",1059361,235,24,200,35,211,2.26551666523499,3.30387847013435,0.175
"United States","Rhode Island","RI",2020-11-15,2020-11-21,7,2020,"47",1059361,226,31,203,23,195,2.92629235926186,2.17112013751686,0.113300492610837
"United States","Rhode Island","RI",2020-11-22,2020-11-28,7,2020,"48",1059361,268,33,208,60,235,3.11508541469811,5.66379166308746,0.288461538461539
"United States","Rhode Island","RI",2020-11-29,2020-12-05,7,2020,"49",1059361,289,62,210,79,227,5.85258471852371,7.45732568973183,0.376190476190476
"United States","Rhode Island","RI",2020-12-06,2020-12-12,7,2020,"50",1059361,325,74,216,109,251,6.98534305114121,10.2892215212756,0.50462962962963
"United States","Rhode Island","RI",2020-12-13,2020-12-19,7,2020,"51",1059361,329,98,214,115,231,9.25085971637619,10.8556006875843,0.537383177570093
"United States","Rhode Island","RI",2020-12-20,2020-12-26,7,2020,"52",1059361,302,116,219,83,186,10.9499972153024,7.83491180060433,0.378995433789954
"United States","Rhode Island","RI",2020-12-27,2021-01-02,7,2020,"53",1059361,284,85,221,63,199,8.02370485604058,5.94698124624184,0.285067873303168
"United States","Rhode Island","RI",2021-01-03,2021-01-09,7,2021,"1",1059361,295,132,221,74,163,12.4603416587924,6.98534305114121,0.334841628959276
"United States","Rhode Island","RI",2021-01-10,2021-01-16,7,2021,"2",1059361,295,71,223,72,224,6.70215346798683,6.79654999570496,0.322869955156951
"United States","Rhode Island","RI",2021-01-17,2021-01-23,7,2021,"3",1059361,309,88,222,87,221,8.30689443919495,8.21249791147682,0.391891891891892
"United States","Rhode Island","RI",2021-01-24,2021-01-30,7,2021,"4",1059361,263,73,221,42,190,6.89094652342308,3.96465416416123,0.190045248868778
"United States","Rhode Island","RI",2021-01-31,2021-02-06,7,2021,"5",1059361,269,74,218,51,195,6.98534305114121,4.81422291362435,0.23394495412844
"United States","Rhode Island","RI",2021-02-07,2021-02-13,7,2021,"6",1059361,248,67,215,33,181,6.32456735711434,3.11508541469811,0.153488372093023
"United States","Rhode Island","RI",2021-02-14,2021-02-20,7,2021,"7",1059361,222,94,215,7,128,8.87327360550369,0.660775694026871,0.0325581395348837
"United States","Rhode Island","RI",2021-02-21,2021-02-27,7,2021,"8",1059361,231,137,215,16,94,12.932324297383,1.51034444348999,0.0744186046511628
"United States","Rhode Island","RI",2021-02-28,2021-03-06,7,2021,"9",1059361,231,55,212,19,176,5.19180902449684,1.79353402664436,0.0896226415094339
"United States","Rhode Island","RI",2021-03-07,2021-03-13,7,2021,"10",1059361,244,33,210,34,211,3.11508541469811,3.20948194241623,0.161904761904762
"United States","Rhode Island","RI",2021-03-14,2021-03-20,7,2021,"11",1059361,213,26,213,0,187,2.45430972067123,0,0
"United States","Rhode Island","RI",2021-03-21,2021-03-27,7,2021,"12",1059361,212,32,211,1,180,3.02068888697998,0.0943965277181244,0.00473933649289093
"United States","Rhode Island","RI",2021-03-28,2021-04-03,7,2021,"13",1059361,198,36,207,-9,162,3.39827499785248,-0.84956874946312,-0.0434782608695652
"United States","Rhode Island","RI",2021-04-04,2021-04-10,7,2021,"14",1059361,220,8,207,13,212,0.755172221744995,1.22715486033562,0.0628019323671498
"United States","Rhode Island","RI",2021-04-11,2021-04-17,7,2021,"15",1059361,193,9,212,-19,184,0.84956874946312,-1.79353402664436,-0.089622641509434
"United States","Rhode Island","RI",2021-04-18,2021-04-24,7,2021,"16",1059361,203,13,216,-13,190,1.22715486033562,-1.22715486033562,-0.0601851851851852
"United States","Rhode Island","RI",2021-04-25,2021-05-01,7,2021,"17",1059361,211,11,212,-1,200,1.03836180489937,-0.0943965277181244,-0.00471698113207553
"United States","Rhode Island","RI",2021-05-02,2021-05-08,7,2021,"18",1059361,217,19,215,2,198,1.79353402664436,0.188793055436249,0.00930232558139532
"United States","Rhode Island","RI",2021-05-09,2021-05-15,7,2021,"19",1059361,244,10,212,32,234,0.943965277181244,3.02068888697998,0.150943396226415
"United States","Rhode Island","RI",2021-05-16,2021-05-22,7,2021,"20",1059361,194,4,205,-11,190,0.377586110872498,-1.03836180489937,-0.0536585365853659
"United States","Rhode Island","RI",2021-05-23,2021-05-29,7,2021,"21",1059361,193,4,201,-8,189,0.377586110872498,-0.755172221744995,-0.0398009950248757
"United States","Rhode Island","RI",2021-05-30,2021-06-05,7,2021,"22",1059361,191,9,201,-10,182,0.84956874946312,-0.943965277181244,-0.0497512437810945
"United States","Rhode Island","RI",2021-06-06,2021-06-12,7,2021,"23",1059361,210,5,199,11,205,0.471982638590622,1.03836180489937,0.0552763819095476
"United States","Rhode Island","RI",2021-06-13,2021-06-19,7,2021,"24",1059361,169,2,202,-33,167,0.188793055436249,-3.11508541469811,-0.163366336633663
"United States","Rhode Island","RI",2021-06-20,2021-06-26,7,2021,"25",1059361,191,4,200,-9,187,0.377586110872498,-0.84956874946312,-0.045
"United States","Rhode Island","RI",2021-06-27,2021-07-03,7,2021,"26",1059361,185,2,199,-14,183,0.188793055436249,-1.32155138805374,-0.0703517587939698
"United States","Rhode Island","RI",2021-07-04,2021-07-10,7,2021,"27",1059361,188,0,199,-11,188,0,-1.03836180489937,-0.0552763819095478
"United States","Rhode Island","RI",2021-07-11,2021-07-17,7,2021,"28",1059361,204,6,199,5,198,0.566379166308747,0.471982638590622,0.0251256281407035
"United States","Rhode Island","RI",2021-07-18,2021-07-24,7,2021,"29",1059361,150,3,195,-45,147,0.283189583154373,-4.2478437473156,-0.230769230769231
"United States","Rhode Island","RI",2021-07-25,2021-07-31,7,2021,"30",1059361,129,1,193,-64,128,0.0943965277181244,-6.04137777395996,-0.33160621761658
"United States","South Carolina","SC",2019-12-29,2020-01-04,7,2020,"1",5148714,1085,0,1114,-29,1085,0,-0.563247443924833,-0.026032315978456
"United States","South Carolina","SC",2020-01-05,2020-01-11,7,2020,"2",5148714,1081,0,1117,-36,1081,0,-0.699203723492896,-0.0322291853178156
"United States","South Carolina","SC",2020-01-12,2020-01-18,7,2020,"3",5148714,1048,0,1135,-87,1048,0,-1.6897423317745,-0.0766519823788546
"United States","South Carolina","SC",2020-01-19,2020-01-25,7,2020,"4",5148714,1033,0,1133,-100,1033,0,-1.94223256525804,-0.0882612533097969
"United States","South Carolina","SC",2020-01-26,2020-02-01,7,2020,"5",5148714,1032,0,1126,-94,1032,0,-1.82569861134256,-0.0834813499111901
"United States","South Carolina","SC",2020-02-02,2020-02-08,7,2020,"6",5148714,1096,0,1090,6,1096,0,0.116533953915483,0.00550458715596336
"United States","South Carolina","SC",2020-02-09,2020-02-15,7,2020,"7",5148714,1003,0,1071,-68,1003,0,-1.32071814437547,-0.0634920634920635
"United States","South Carolina","SC",2020-02-16,2020-02-22,7,2020,"8",5148714,1035,0,1068,-33,1035,0,-0.640936746535154,-0.0308988764044944
"United States","South Carolina","SC",2020-02-23,2020-02-29,7,2020,"9",5148714,1044,0,1052,-8,1044,0,-0.155378605220643,-0.00760456273764254
"United States","South Carolina","SC",2020-03-01,2020-03-07,7,2020,"10",5148714,1133,0,1040,93,1133,0,1.80627628568998,0.0894230769230768
"United States","South Carolina","SC",2020-03-08,2020-03-14,7,2020,"11",5148714,1103,0,1035,68,1103,0,1.32071814437547,0.0657004830917873
"United States","South Carolina","SC",2020-03-15,2020-03-21,7,2020,"12",5148714,1067,3,1028,39,1064,0.0582669769577413,0.757470700450637,0.0379377431906616
"United States","South Carolina","SC",2020-03-22,2020-03-28,7,2020,"13",5148714,1039,12,1040,-1,1027,0.233067907830965,-0.0194223256525804,-0.000961538461538458
"United States","South Carolina","SC",2020-03-29,2020-04-04,7,2020,"14",5148714,1048,25,1033,15,1023,0.485558141314511,0.291334884788706,0.0145208131655372
"United States","South Carolina","SC",2020-04-05,2020-04-11,7,2020,"15",5148714,1138,32,1025,113,1106,0.621514420882574,2.19472279874159,0.110243902439024
"United States","South Carolina","SC",2020-04-12,2020-04-18,7,2020,"16",5148714,1049,47,1007,42,1002,0.91284930567128,0.815737677408378,0.0417080436941411
"United States","South Carolina","SC",2020-04-19,2020-04-25,7,2020,"17",5148714,1023,47,984,39,976,0.91284930567128,0.757470700450637,0.0396341463414633
"United States","South Carolina","SC",2020-04-26,2020-05-02,7,2020,"18",5148714,1033,101,970,63,932,1.96165489091062,1.22360651611257,0.0649484536082474
"United States","South Carolina","SC",2020-05-03,2020-05-09,7,2020,"19",5148714,1060,62,961,99,998,1.20418419045999,1.92281023960546,0.103017689906348
"United States","South Carolina","SC",2020-05-10,2020-05-16,7,2020,"20",5148714,1110,51,957,153,1059,0.990538608281602,2.97161582484481,0.15987460815047
"United States","South Carolina","SC",2020-05-17,2020-05-23,7,2020,"21",5148714,1046,45,954,92,1001,0.874004654366119,1.7868539600374,0.0964360587002095
"United States","South Carolina","SC",2020-05-24,2020-05-30,7,2020,"22",5148714,1048,58,955,93,990,1.12649488784967,1.80627628568998,0.0973821989528796
"United States","South Carolina","SC",2020-05-31,2020-06-06,7,2020,"23",5148714,1037,62,956,81,975,1.20418419045999,1.57320837785901,0.0847280334728033
"United States","South Carolina","SC",2020-06-07,2020-06-13,7,2020,"24",5148714,1079,53,951,128,1026,1.02938325958676,2.4860576835303,0.13459516298633
"United States","South Carolina","SC",2020-06-14,2020-06-20,7,2020,"25",5148714,1052,45,940,112,1007,0.874004654366119,2.17530047308901,0.119148936170213
"United States","South Carolina","SC",2020-06-21,2020-06-27,7,2020,"26",5148714,1099,64,945,154,1035,1.24302884176515,2.99103815049739,0.162962962962963
"United States","South Carolina","SC",2020-06-28,2020-07-04,7,2020,"27",5148714,1197,99,939,258,1098,1.92281023960546,5.01096001836575,0.274760383386581
"United States","South Carolina","SC",2020-07-05,2020-07-11,7,2020,"28",5148714,1218,134,945,273,1084,2.60259163744578,5.30229490315446,0.288888888888889
"United States","South Carolina","SC",2020-07-12,2020-07-18,7,2020,"29",5148714,1335,177,948,387,1158,3.43775164050674,7.51644002754863,0.408227848101266
"United States","South Carolina","SC",2020-07-19,2020-07-25,7,2020,"30",5148714,1352,295,954,398,1057,5.72958606751123,7.73008560972701,0.417190775681342
"United States","South Carolina","SC",2020-07-26,2020-08-01,7,2020,"31",5148714,1329,271,956,373,1058,5.2634502518493,7.2445274684125,0.390167364016736
"United States","South Carolina","SC",2020-08-02,2020-08-08,7,2020,"32",5148714,1368,233,951,417,1135,4.52540187705124,8.09910979712604,0.438485804416404
"United States","South Carolina","SC",2020-08-09,2020-08-15,7,2020,"33",5148714,1319,344,948,371,975,6.68128002448767,7.20568281710734,0.391350210970464
"United States","South Carolina","SC",2020-08-16,2020-08-22,7,2020,"34",5148714,1181,233,934,247,948,4.52540187705124,4.79731443618737,0.264453961456103
"United States","South Carolina","SC",2020-08-23,2020-08-29,7,2020,"35",5148714,1240,205,929,311,1035,3.98157675877899,6.04034327795251,0.334768568353068
"United States","South Carolina","SC",2020-08-30,2020-09-05,7,2020,"36",5148714,1243,179,927,316,1064,3.4765962918119,6.13745490621542,0.340884573894283
"United States","South Carolina","SC",2020-09-06,2020-09-12,7,2020,"37",5148714,1186,163,937,249,1023,3.16583908137061,4.83615908749253,0.265741728922092
"United States","South Carolina","SC",2020-09-13,2020-09-19,7,2020,"38",5148714,1142,148,945,197,994,2.8745041965819,3.82619815355834,0.208465608465608
"United States","South Carolina","SC",2020-09-20,2020-09-26,7,2020,"39",5148714,1152,135,949,203,1017,2.62201396309836,3.94273210747383,0.21390937829294
"United States","South Carolina","SC",2020-09-27,2020-10-03,7,2020,"40",5148714,1142,119,952,190,1023,2.31125675265707,3.69024187399028,0.199579831932773
"United States","South Carolina","SC",2020-10-04,2020-10-10,7,2020,"41",5148714,1133,109,947,186,1024,2.11703349613127,3.61255257137996,0.196409714889124
"United States","South Carolina","SC",2020-10-11,2020-10-17,7,2020,"42",5148714,1062,86,949,113,976,1.67032000612192,2.19472279874159,0.119072708113804
"United States","South Carolina","SC",2020-10-18,2020-10-24,7,2020,"43",5148714,1147,156,951,196,991,3.02988280180255,3.80677582790576,0.206098843322818
"United States","South Carolina","SC",2020-10-25,2020-10-31,7,2020,"44",5148714,1225,139,962,263,1086,2.69970326570868,5.10807164662865,0.273388773388773
"United States","South Carolina","SC",2020-11-01,2020-11-07,7,2020,"45",5148714,1185,83,970,215,1102,1.61205302916418,4.17580001530479,0.221649484536083
"United States","South Carolina","SC",2020-11-08,2020-11-14,7,2020,"46",5148714,1138,95,988,150,1043,1.84512093699514,2.91334884788706,0.151821862348178
"United States","South Carolina","SC",2020-11-15,2020-11-21,7,2020,"47",5148714,1192,90,990,202,1102,1.74800930873224,3.92330978182125,0.204040404040404
"United States","South Carolina","SC",2020-11-22,2020-11-28,7,2020,"48",5148714,1214,153,994,220,1061,2.97161582484481,4.27291164356769,0.221327967806841
"United States","South Carolina","SC",2020-11-29,2020-12-05,7,2020,"49",5148714,1287,164,995,292,1123,3.18526140702319,5.67131909055349,0.293467336683417
"United States","South Carolina","SC",2020-12-06,2020-12-12,7,2020,"50",5148714,1281,168,1004,277,1113,3.26295070963351,5.37998420576478,0.275896414342629
"United States","South Carolina","SC",2020-12-13,2020-12-19,7,2020,"51",5148714,1367,210,1017,350,1157,4.07868838704189,6.79781397840315,0.344149459193707
"United States","South Carolina","SC",2020-12-20,2020-12-26,7,2020,"52",5148714,1420,229,1034,386,1191,4.44771257444092,7.49701770189605,0.373307543520309
"United States","South Carolina","SC",2020-12-27,2021-01-02,7,2020,"53",5148714,1511,260,1040,471,1251,5.04980466967091,9.14791538236538,0.452884615384615
"United States","South Carolina","SC",2021-01-03,2021-01-09,7,2021,"1",5148714,1589,374,1065,524,1215,7.26394979406508,10.1772986419521,0.492018779342723
"United States","South Carolina","SC",2021-01-10,2021-01-16,7,2021,"2",5148714,1641,350,1073,568,1291,6.79781397840315,11.0318809706657,0.529356943150047
"United States","South Carolina","SC",2021-01-17,2021-01-23,7,2021,"3",5148714,1699,371,1078,621,1328,7.20568281710734,12.0612642302524,0.576066790352505
"United States","South Carolina","SC",2021-01-24,2021-01-30,7,2021,"4",5148714,1581,535,1078,503,1046,10.3909442241305,9.76942980324796,0.466604823747681
"United States","South Carolina","SC",2021-01-31,2021-02-06,7,2021,"5",5148714,1501,597,1076,425,904,11.5951284145905,8.25448840234668,0.394981412639405
"United States","South Carolina","SC",2021-02-07,2021-02-13,7,2021,"6",5148714,1367,302,1043,324,1065,5.86554234707929,6.29283351143606,0.310642377756472
"United States","South Carolina","SC",2021-02-14,2021-02-20,7,2021,"7",5148714,1250,344,1030,220,906,6.68128002448767,4.27291164356769,0.213592233009709
"United States","South Carolina","SC",2021-02-21,2021-02-27,7,2021,"8",5148714,1243,241,1022,221,1002,4.68078048227188,4.29233396922028,0.216242661448141
"United States","South Carolina","SC",2021-02-28,2021-03-06,7,2021,"9",5148714,1199,221,1012,187,978,4.29233396922028,3.63197489703254,0.184782608695652
"United States","South Carolina","SC",2021-03-07,2021-03-13,7,2021,"10",5148714,1171,152,999,172,1019,2.95219349919223,3.34064001224383,0.172172172172172
"United States","South Carolina","SC",2021-03-14,2021-03-20,7,2021,"11",5148714,1057,108,1005,52,949,2.09761117047869,1.00996093393418,0.0517412935323383
"United States","South Carolina","SC",2021-03-21,2021-03-27,7,2021,"12",5148714,1107,129,997,110,978,2.50548000918288,2.13645582178385,0.110330992978937
"United States","South Carolina","SC",2021-03-28,2021-04-03,7,2021,"13",5148714,1002,92,987,15,910,1.7868539600374,0.291334884788706,0.0151975683890577
"United States","South Carolina","SC",2021-04-04,2021-04-10,7,2021,"14",5148714,1134,73,971,163,1061,1.41782977263837,3.16583908137061,0.167868177136972
"United States","South Carolina","SC",2021-04-11,2021-04-17,7,2021,"15",5148714,1101,48,972,129,1053,0.932271631323861,2.50548000918288,0.132716049382716
"United States","South Carolina","SC",2021-04-18,2021-04-24,7,2021,"16",5148714,1067,93,958,109,974,1.80627628568998,2.11703349613127,0.113778705636743
"United States","South Carolina","SC",2021-04-25,2021-05-01,7,2021,"17",5148714,1155,92,958,197,1063,1.7868539600374,3.82619815355834,0.205636743215031
"United States","South Carolina","SC",2021-05-02,2021-05-08,7,2021,"18",5148714,1074,80,954,120,994,1.55378605220643,2.33067907830965,0.125786163522013
"United States","South Carolina","SC",2021-05-09,2021-05-15,7,2021,"19",5148714,1089,52,949,140,1037,1.00996093393418,2.71912559136126,0.147523709167545
"United States","South Carolina","SC",2021-05-16,2021-05-22,7,2021,"20",5148714,1022,36,949,73,986,0.699203723492896,1.41782977263837,0.0769230769230769
"United States","South Carolina","SC",2021-05-23,2021-05-29,7,2021,"21",5148714,1019,54,952,67,965,1.04880558523934,1.30129581872289,0.0703781512605042
"United States","South Carolina","SC",2021-05-30,2021-06-05,7,2021,"22",5148714,1036,24,943,93,1012,0.46613581566193,1.80627628568998,0.0986214209968186
"United States","South Carolina","SC",2021-06-06,2021-06-12,7,2021,"23",5148714,1033,24,930,103,1009,0.46613581566193,2.00049954221578,0.110752688172043
"United States","South Carolina","SC",2021-06-13,2021-06-19,7,2021,"24",5148714,1083,16,931,152,1067,0.310757210441287,2.95219349919223,0.163265306122449
"United States","South Carolina","SC",2021-06-20,2021-06-26,7,2021,"25",5148714,1033,27,922,111,1006,0.524402792619672,2.15587814743643,0.120390455531453
"United States","South Carolina","SC",2021-06-27,2021-07-03,7,2021,"26",5148714,1028,11,914,114,1017,0.213645582178385,2.21414512439417,0.12472647702407
"United States","South Carolina","SC",2021-07-04,2021-07-10,7,2021,"27",5148714,1031,16,915,116,1015,0.310757210441287,2.25298977569933,0.126775956284153
"United States","South Carolina","SC",2021-07-11,2021-07-17,7,2021,"28",5148714,1012,16,909,103,996,0.310757210441287,2.00049954221578,0.113311331133113
"United States","South Carolina","SC",2021-07-18,2021-07-24,7,2021,"29",5148714,1040,16,919,121,1024,0.310757210441287,2.35010140396223,0.131664853101197
"United States","South Carolina","SC",2021-07-25,2021-07-31,7,2021,"30",5148714,1039,26,936,103,1013,0.504980466967091,2.00049954221578,0.110042735042735
"United States","South Carolina","SC",2021-08-01,2021-08-07,7,2021,"31",5148714,847,46,941,-94,801,0.8934269800187,-1.82569861134256,-0.099893730074389
"United States","South Dakota","SD",2019-12-29,2020-01-04,7,2020,"1",884659,170,0,165,5,170,0,0.565189525003419,0.0303030303030303
"United States","South Dakota","SD",2020-01-05,2020-01-11,7,2020,"2",884659,170,0,167,3,170,0,0.339113715002052,0.0179640718562875
"United States","South Dakota","SD",2020-01-12,2020-01-18,7,2020,"3",884659,168,0,169,-1,168,0,-0.113037905000684,-0.00591715976331364
"United States","South Dakota","SD",2020-01-19,2020-01-25,7,2020,"4",884659,151,0,168,-17,151,0,-1.92164438501163,-0.101190476190476
"United States","South Dakota","SD",2020-01-26,2020-02-01,7,2020,"5",884659,162,0,168,-6,162,0,-0.678227430004103,-0.0357142857142857
"United States","South Dakota","SD",2020-02-02,2020-02-08,7,2020,"6",884659,150,0,168,-18,150,0,-2.03468229001231,-0.107142857142857
"United States","South Dakota","SD",2020-02-09,2020-02-15,7,2020,"7",884659,178,0,166,12,178,0,1.35645486000821,0.072289156626506
"United States","South Dakota","SD",2020-02-16,2020-02-22,7,2020,"8",884659,177,0,164,13,177,0,1.46949276500889,0.0792682926829269
"United States","South Dakota","SD",2020-02-23,2020-02-29,7,2020,"9",884659,163,0,162,1,163,0,0.113037905000684,0.00617283950617287
"United States","South Dakota","SD",2020-03-01,2020-03-07,7,2020,"10",884659,194,0,160,34,194,0,3.84328877002325,0.2125
"United States","South Dakota","SD",2020-03-08,2020-03-14,7,2020,"11",884659,166,1,162,4,165,0.113037905000684,0.452151620002736,0.0246913580246915
"United States","South Dakota","SD",2020-03-15,2020-03-21,7,2020,"12",884659,162,0,160,2,162,0,0.226075810001368,0.0125
"United States","South Dakota","SD",2020-03-22,2020-03-28,7,2020,"13",884659,149,0,159,-10,149,0,-1.13037905000684,-0.0628930817610063
"United States","South Dakota","SD",2020-03-29,2020-04-04,7,2020,"14",884659,170,1,159,11,169,0.113037905000684,1.24341695500752,0.0691823899371069
"United States","South Dakota","SD",2020-04-05,2020-04-11,7,2020,"15",884659,150,3,159,-9,147,0.339113715002052,-1.01734114500615,-0.0566037735849056
"United States","South Dakota","SD",2020-04-12,2020-04-18,7,2020,"16",884659,154,2,154,0,152,0.226075810001368,0,0
"United States","South Dakota","SD",2020-04-19,2020-04-25,7,2020,"17",884659,176,3,152,24,173,0.339113715002052,2.71290972001641,0.157894736842105
"United States","South Dakota","SD",2020-04-26,2020-05-02,7,2020,"18",884659,159,11,151,8,148,1.24341695500752,0.904303240005471,0.0529801324503312
"United States","South Dakota","SD",2020-05-03,2020-05-09,7,2020,"19",884659,181,13,148,33,168,1.46949276500889,3.73025086502257,0.222972972972973
"United States","South Dakota","SD",2020-05-10,2020-05-16,7,2020,"20",884659,147,10,145,2,137,1.13037905000684,0.226075810001368,0.0137931034482759
"United States","South Dakota","SD",2020-05-17,2020-05-23,7,2020,"21",884659,162,6,146,16,156,0.678227430004103,1.80860648001094,0.10958904109589
"United States","South Dakota","SD",2020-05-24,2020-05-30,7,2020,"22",884659,157,10,148,9,147,1.13037905000684,1.01734114500615,0.0608108108108107
"United States","South Dakota","SD",2020-05-31,2020-06-06,7,2020,"23",884659,147,5,146,1,142,0.565189525003419,0.113037905000684,0.00684931506849318
"United States","South Dakota","SD",2020-06-07,2020-06-13,7,2020,"24",884659,159,10,148,11,149,1.13037905000684,1.24341695500752,0.0743243243243243
"United States","South Dakota","SD",2020-06-14,2020-06-20,7,2020,"25",884659,176,6,149,27,170,0.678227430004103,3.05202343501846,0.181208053691275
"United States","South Dakota","SD",2020-06-21,2020-06-27,7,2020,"26",884659,163,10,146,17,153,1.13037905000684,1.92164438501163,0.116438356164384
"United States","South Dakota","SD",2020-06-28,2020-07-04,7,2020,"27",884659,160,6,147,13,154,0.678227430004103,1.46949276500889,0.08843537414966
"United States","South Dakota","SD",2020-07-05,2020-07-11,7,2020,"28",884659,172,12,144,28,160,1.35645486000821,3.16506134001915,0.194444444444444
"United States","South Dakota","SD",2020-07-12,2020-07-18,7,2020,"29",884659,158,7,147,11,151,0.791265335004787,1.24341695500752,0.0748299319727892
"United States","South Dakota","SD",2020-07-19,2020-07-25,7,2020,"30",884659,173,6,144,29,167,0.678227430004103,3.27809924501983,0.201388888888889
"United States","South Dakota","SD",2020-07-26,2020-08-01,7,2020,"31",884659,151,12,144,7,139,1.35645486000821,0.791265335004787,0.0486111111111112
"United States","South Dakota","SD",2020-08-02,2020-08-08,7,2020,"32",884659,187,12,138,49,175,1.35645486000821,5.53885734503351,0.355072463768116
"United States","South Dakota","SD",2020-08-09,2020-08-15,7,2020,"33",884659,162,6,140,22,156,0.678227430004103,2.48683391001505,0.157142857142857
"United States","South Dakota","SD",2020-08-16,2020-08-22,7,2020,"34",884659,169,7,141,28,162,0.791265335004787,3.16506134001915,0.198581560283688
"United States","South Dakota","SD",2020-08-23,2020-08-29,7,2020,"35",884659,189,8,140,49,181,0.904303240005471,5.53885734503351,0.35
"United States","South Dakota","SD",2020-08-30,2020-09-05,7,2020,"36",884659,209,6,137,72,203,0.678227430004103,8.13872916004924,0.525547445255474
"United States","South Dakota","SD",2020-09-06,2020-09-12,7,2020,"37",884659,182,10,139,43,172,1.13037905000684,4.86062991502941,0.309352517985612
"United States","South Dakota","SD",2020-09-13,2020-09-19,7,2020,"38",884659,181,17,139,42,164,1.92164438501163,4.74759201002872,0.302158273381295
"United States","South Dakota","SD",2020-09-20,2020-09-26,7,2020,"39",884659,191,18,145,46,173,2.03468229001231,5.19974363003146,0.317241379310345
"United States","South Dakota","SD",2020-09-27,2020-10-03,7,2020,"40",884659,206,30,150,56,176,3.39113715002052,6.3301226800383,0.373333333333333
"United States","South Dakota","SD",2020-10-04,2020-10-10,7,2020,"41",884659,215,38,153,62,177,4.29544039002599,7.0083501100424,0.405228758169935
"United States","South Dakota","SD",2020-10-11,2020-10-17,7,2020,"42",884659,201,29,157,44,172,3.27809924501983,4.97366782003009,0.280254777070064
"United States","South Dakota","SD",2020-10-18,2020-10-24,7,2020,"43",884659,243,51,158,85,192,5.76493315503488,9.60822192505813,0.537974683544304
"United States","South Dakota","SD",2020-10-25,2020-10-31,7,2020,"44",884659,243,59,156,87,184,6.66923639504035,9.8342977350595,0.557692307692308
"United States","South Dakota","SD",2020-11-01,2020-11-07,7,2020,"45",884659,356,98,152,204,258,11.077714690067,23.0597326201395,1.34210526315789
"United States","South Dakota","SD",2020-11-08,2020-11-14,7,2020,"46",884659,343,98,154,189,245,11.077714690067,21.3641640451293,1.22727272727273
"United States","South Dakota","SD",2020-11-15,2020-11-21,7,2020,"47",884659,335,120,151,184,215,13.5645486000821,20.7989745201258,1.21854304635762
"United States","South Dakota","SD",2020-11-22,2020-11-28,7,2020,"48",884659,335,201,150,185,134,22.7206189051375,20.9120124251265,1.23333333333333
"United States","South Dakota","SD",2020-11-29,2020-12-05,7,2020,"49",884659,305,148,155,150,157,16.7296099401012,16.9556857501026,0.967741935483871
"United States","South Dakota","SD",2020-12-06,2020-12-12,7,2020,"50",884659,283,153,157,126,130,17.2947994651046,14.2427760300862,0.802547770700637
"United States","South Dakota","SD",2020-12-13,2020-12-19,7,2020,"51",884659,236,107,155,81,129,12.0950558350732,9.15607030505539,0.52258064516129
"United States","South Dakota","SD",2020-12-20,2020-12-26,7,2020,"52",884659,206,31,159,47,175,3.5041750550212,5.31278153503214,0.295597484276729
"United States","South Dakota","SD",2020-12-27,2021-01-02,7,2020,"53",884659,211,120,162,49,91,13.5645486000821,5.53885734503351,0.302469135802469
"United States","South Dakota","SD",2021-01-03,2021-01-09,7,2021,"1",884659,219,69,163,56,150,7.79961544504719,6.3301226800383,0.343558282208589
"United States","South Dakota","SD",2021-01-10,2021-01-16,7,2021,"2",884659,188,63,168,20,125,7.12138801504308,2.26075810001368,0.119047619047619
"United States","South Dakota","SD",2021-01-17,2021-01-23,7,2021,"3",884659,189,63,169,20,126,7.12138801504308,2.26075810001368,0.118343195266272
"United States","South Dakota","SD",2021-01-24,2021-01-30,7,2021,"4",884659,204,79,172,32,125,8.92999449505403,3.61721296002188,0.186046511627907
"United States","South Dakota","SD",2021-01-31,2021-02-06,7,2021,"5",884659,189,29,172,17,160,3.27809924501983,1.92164438501163,0.0988372093023255
"United States","South Dakota","SD",2021-02-07,2021-02-13,7,2021,"6",884659,180,34,174,6,146,3.84328877002325,0.678227430004103,0.0344827586206897
"United States","South Dakota","SD",2021-02-14,2021-02-20,7,2021,"7",884659,167,21,172,-5,146,2.37379600501436,-0.565189525003419,-0.0290697674418605
"United States","South Dakota","SD",2021-02-21,2021-02-27,7,2021,"8",884659,183,29,176,7,154,3.27809924501983,0.791265335004787,0.0397727272727273
"United States","South Dakota","SD",2021-02-28,2021-03-06,7,2021,"9",884659,171,8,174,-3,163,0.904303240005471,-0.339113715002052,-0.0172413793103449
"United States","South Dakota","SD",2021-03-07,2021-03-13,7,2021,"10",884659,188,12,172,16,176,1.35645486000821,1.80860648001094,0.0930232558139534
"United States","South Dakota","SD",2021-03-14,2021-03-20,7,2021,"11",884659,157,11,173,-16,146,1.24341695500752,-1.80860648001094,-0.0924855491329479
"United States","South Dakota","SD",2021-03-21,2021-03-27,7,2021,"12",884659,170,14,170,0,156,1.58253067000957,0,0
"United States","South Dakota","SD",2021-03-28,2021-04-03,7,2021,"13",884659,155,14,168,-13,141,1.58253067000957,-1.46949276500889,-0.0773809523809523
"United States","South Dakota","SD",2021-04-04,2021-04-10,7,2021,"14",884659,144,-1,166,-22,145,-0.113037905000684,-2.48683391001505,-0.132530120481928
"United States","South Dakota","SD",2021-04-11,2021-04-17,7,2021,"15",884659,176,7,170,6,169,0.791265335004787,0.678227430004103,0.0352941176470589
"United States","South Dakota","SD",2021-04-18,2021-04-24,7,2021,"16",884659,172,0,172,0,172,0,0,0
"United States","South Dakota","SD",2021-04-25,2021-05-01,7,2021,"17",884659,160,14,171,-11,146,1.58253067000957,-1.24341695500752,-0.064327485380117
"United States","South Dakota","SD",2021-05-02,2021-05-08,7,2021,"18",884659,180,12,167,13,168,1.35645486000821,1.46949276500889,0.0778443113772456
"United States","South Dakota","SD",2021-05-09,2021-05-15,7,2021,"19",884659,164,12,167,-3,152,1.35645486000821,-0.339113715002052,-0.0179640718562875
"United States","South Dakota","SD",2021-05-16,2021-05-22,7,2021,"20",884659,158,10,164,-6,148,1.13037905000684,-0.678227430004103,-0.0365853658536586
"United States","South Dakota","SD",2021-05-23,2021-05-29,7,2021,"21",884659,138,9,165,-27,129,1.01734114500615,-3.05202343501846,-0.163636363636364
"United States","South Dakota","SD",2021-05-30,2021-06-05,7,2021,"22",884659,153,12,167,-14,141,1.35645486000821,-1.58253067000957,-0.0838323353293413
"United States","South Dakota","SD",2021-06-06,2021-06-12,7,2021,"23",884659,162,4,165,-3,158,0.452151620002736,-0.339113715002052,-0.0181818181818182
"United States","South Dakota","SD",2021-06-13,2021-06-19,7,2021,"24",884659,147,1,164,-17,146,0.113037905000684,-1.92164438501163,-0.103658536585366
"United States","South Dakota","SD",2021-06-20,2021-06-26,7,2021,"25",884659,154,3,167,-13,151,0.339113715002052,-1.46949276500889,-0.0778443113772455
"United States","South Dakota","SD",2021-06-27,2021-07-03,7,2021,"26",884659,169,8,162,7,161,0.904303240005471,0.791265335004787,0.0432098765432098
"United States","South Dakota","SD",2021-07-04,2021-07-10,7,2021,"27",884659,147,1,162,-15,146,0.113037905000684,-1.69556857501026,-0.0925925925925926
"United States","South Dakota","SD",2021-07-11,2021-07-17,7,2021,"28",884659,160,1,164,-4,159,0.113037905000684,-0.452151620002736,-0.024390243902439
"United States","South Dakota","SD",2021-07-18,2021-07-24,7,2021,"29",884659,155,1,164,-9,154,0.113037905000684,-1.01734114500615,-0.0548780487804879
"United States","South Dakota","SD",2021-07-25,2021-07-31,7,2021,"30",884659,127,2,165,-38,125,0.226075810001368,-4.29544039002599,-0.23030303030303
"United States","South Dakota","SD",2021-08-01,2021-08-07,7,2021,"31",884659,123,7,168,-45,116,0.791265335004787,-5.08670572503077,-0.267857142857143
"United States","Tennessee","TN",2019-12-29,2020-01-04,7,2020,"1",6833174,1614,0,1656,-42,1614,0,-0.614648478145003,-0.0253623188405797
"United States","Tennessee","TN",2020-01-05,2020-01-11,7,2020,"2",6833174,1687,0,1672,15,1687,0,0.219517313623215,0.00897129186602874
"United States","Tennessee","TN",2020-01-12,2020-01-18,7,2020,"3",6833174,1597,0,1647,-50,1597,0,-0.731724378744051,-0.0303582270795385
"United States","Tennessee","TN",2020-01-19,2020-01-25,7,2020,"4",6833174,1532,0,1637,-105,1532,0,-1.53662119536251,-0.0641417226634087
"United States","Tennessee","TN",2020-01-26,2020-02-01,7,2020,"5",6833174,1591,0,1631,-40,1591,0,-0.585379502995241,-0.0245248313917842
"United States","Tennessee","TN",2020-02-02,2020-02-08,7,2020,"6",6833174,1612,0,1600,12,1612,0,0.175613850898572,0.00750000000000006
"United States","Tennessee","TN",2020-02-09,2020-02-15,7,2020,"7",6833174,1454,0,1583,-129,1454,0,-1.88784889715965,-0.0814908401768794
"United States","Tennessee","TN",2020-02-16,2020-02-22,7,2020,"8",6833174,1516,0,1558,-42,1516,0,-0.614648478145003,-0.0269576379974326
"United States","Tennessee","TN",2020-02-23,2020-02-29,7,2020,"9",6833174,1504,0,1557,-53,1504,0,-0.775627841468694,-0.0340398201669878
"United States","Tennessee","TN",2020-03-01,2020-03-07,7,2020,"10",6833174,1611,0,1542,69,1611,0,1.00977964266679,0.0447470817120623
"United States","Tennessee","TN",2020-03-08,2020-03-14,7,2020,"11",6833174,1601,0,1541,60,1601,0,0.878069254492861,0.0389357560025958
"United States","Tennessee","TN",2020-03-15,2020-03-21,7,2020,"12",6833174,1526,1,1545,-19,1525,0.014634487574881,-0.278055263922739,-0.0122977346278317
"United States","Tennessee","TN",2020-03-22,2020-03-28,7,2020,"13",6833174,1528,5,1534,-6,1523,0.0731724378744051,-0.0878069254492861,-0.00391134289439377
"United States","Tennessee","TN",2020-03-29,2020-04-04,7,2020,"14",6833174,1593,37,1514,79,1556,0.541476040270597,1.1561245184156,0.0521796565389696
"United States","Tennessee","TN",2020-04-05,2020-04-11,7,2020,"15",6833174,1514,58,1510,4,1456,0.848800279343099,0.0585379502995241,0.00264900662251666
"United States","Tennessee","TN",2020-04-12,2020-04-18,7,2020,"16",6833174,1541,44,1501,40,1497,0.643917453294765,0.585379502995241,0.0266489007328448
"United States","Tennessee","TN",2020-04-19,2020-04-25,7,2020,"17",6833174,1483,33,1475,8,1450,0.482938089971073,0.117075900599048,0.00542372881355924
"United States","Tennessee","TN",2020-04-26,2020-05-02,7,2020,"18",6833174,1495,31,1457,38,1464,0.453669114821311,0.556110527845479,0.0260809883321895
"United States","Tennessee","TN",2020-05-03,2020-05-09,7,2020,"19",6833174,1492,33,1450,42,1459,0.482938089971073,0.614648478145003,0.0289655172413794
"United States","Tennessee","TN",2020-05-10,2020-05-16,7,2020,"20",6833174,1544,53,1427,117,1491,0.775627841468694,1.71223504626108,0.0819901892081289
"United States","Tennessee","TN",2020-05-17,2020-05-23,7,2020,"21",6833174,1557,30,1420,137,1527,0.43903462724643,2.0049247977587,0.0964788732394366
"United States","Tennessee","TN",2020-05-24,2020-05-30,7,2020,"22",6833174,1467,39,1416,51,1428,0.57074501542036,0.746358866318932,0.0360169491525424
"United States","Tennessee","TN",2020-05-31,2020-06-06,7,2020,"23",6833174,1485,49,1411,74,1436,0.71708989116917,1.08295208054119,0.0524450744153082
"United States","Tennessee","TN",2020-06-07,2020-06-13,7,2020,"24",6833174,1500,52,1400,100,1448,0.760993353893813,1.4634487574881,0.0714285714285714
"United States","Tennessee","TN",2020-06-14,2020-06-20,7,2020,"25",6833174,1570,51,1409,161,1519,0.746358866318932,2.35615249955584,0.114265436479773
"United States","Tennessee","TN",2020-06-21,2020-06-27,7,2020,"26",6833174,1562,61,1417,145,1501,0.892703742067742,2.12200069835775,0.102328863796754
"United States","Tennessee","TN",2020-06-28,2020-07-04,7,2020,"27",6833174,1533,52,1406,127,1481,0.760993353893813,1.85857992200989,0.0903271692745378
"United States","Tennessee","TN",2020-07-05,2020-07-11,7,2020,"28",6833174,1634,99,1410,224,1535,1.44881426991322,3.27812521677335,0.15886524822695
"United States","Tennessee","TN",2020-07-12,2020-07-18,7,2020,"29",6833174,1650,100,1428,222,1550,1.4634487574881,3.24885624162359,0.155462184873949
"United States","Tennessee","TN",2020-07-19,2020-07-25,7,2020,"30",6833174,1710,136,1426,284,1574,1.99029031018382,4.15619447126621,0.199158485273492
"United States","Tennessee","TN",2020-07-26,2020-08-01,7,2020,"31",6833174,1713,103,1414,299,1610,1.50735222021274,4.37571178488942,0.211456859971711
"United States","Tennessee","TN",2020-08-02,2020-08-08,7,2020,"32",6833174,1707,148,1413,294,1559,2.16590416108239,4.30253934701502,0.208067940552017
"United States","Tennessee","TN",2020-08-09,2020-08-15,7,2020,"33",6833174,1678,130,1401,277,1548,1.90248338473453,4.05375305824204,0.197715917201999
"United States","Tennessee","TN",2020-08-16,2020-08-22,7,2020,"34",6833174,1687,218,1385,302,1469,3.19031829132406,4.41961524761407,0.218050541516245
"United States","Tennessee","TN",2020-08-23,2020-08-29,7,2020,"35",6833174,1709,162,1386,323,1547,2.37078698713072,4.72693948668657,0.233044733044733
"United States","Tennessee","TN",2020-08-30,2020-09-05,7,2020,"36",6833174,1624,137,1393,231,1487,2.0049247977587,3.38056662979751,0.165829145728643
"United States","Tennessee","TN",2020-09-06,2020-09-12,7,2020,"37",6833174,1727,202,1378,349,1525,2.95616649012596,5.10743616363347,0.253265602322206
"United States","Tennessee","TN",2020-09-13,2020-09-19,7,2020,"38",6833174,1620,152,1380,240,1468,2.22444211138191,3.51227701797144,0.173913043478261
"United States","Tennessee","TN",2020-09-20,2020-09-26,7,2020,"39",6833174,1743,158,1393,350,1585,2.3122490368312,5.12207065120836,0.251256281407035
"United States","Tennessee","TN",2020-09-27,2020-10-03,7,2020,"40",6833174,1732,186,1381,351,1546,2.72201468892787,5.13670513878324,0.254163649529327
"United States","Tennessee","TN",2020-10-04,2020-10-10,7,2020,"41",6833174,1769,198,1391,378,1571,2.89762853982644,5.53183630330502,0.271746944644141
"United States","Tennessee","TN",2020-10-11,2020-10-17,7,2020,"42",6833174,1784,145,1405,379,1639,2.12200069835775,5.5464707908799,0.269750889679715
"United States","Tennessee","TN",2020-10-18,2020-10-24,7,2020,"43",6833174,1788,197,1410,378,1591,2.88299405225156,5.53183630330502,0.268085106382979
"United States","Tennessee","TN",2020-10-25,2020-10-31,7,2020,"44",6833174,1841,251,1405,436,1590,3.67325638129513,6.38063658264812,0.310320284697509
"United States","Tennessee","TN",2020-11-01,2020-11-07,7,2020,"45",6833174,1815,236,1430,385,1579,3.45373906767192,5.63427771632919,0.269230769230769
"United States","Tennessee","TN",2020-11-08,2020-11-14,7,2020,"46",6833174,1935,290,1438,497,1645,4.24400139671549,7.27334032471586,0.345618915159944
"United States","Tennessee","TN",2020-11-15,2020-11-21,7,2020,"47",6833174,2001,324,1451,550,1677,4.74157397426145,8.04896816618456,0.379048931771192
"United States","Tennessee","TN",2020-11-22,2020-11-28,7,2020,"48",6833174,1919,333,1487,432,1586,4.87328436243538,6.3220986323486,0.290517821116342
"United States","Tennessee","TN",2020-11-29,2020-12-05,7,2020,"49",6833174,2200,365,1514,686,1835,5.34158796483157,10.0392584763684,0.453104359313078
"United States","Tennessee","TN",2020-12-06,2020-12-12,7,2020,"50",6833174,2188,499,1518,670,1689,7.30260929986563,9.80510667517028,0.44137022397892
"United States","Tennessee","TN",2020-12-13,2020-12-19,7,2020,"51",6833174,2174,562,1542,632,1612,8.22458201708313,9.2489961473248,0.409857328145266
"United States","Tennessee","TN",2020-12-20,2020-12-26,7,2020,"52",6833174,2361,481,1560,801,1880,7.03918852351777,11.7222245474797,0.513461538461538
"United States","Tennessee","TN",2020-12-27,2021-01-02,7,2020,"53",6833174,2365,529,1559,806,1836,7.74164392711206,11.7953969853541,0.516998075689544
"United States","Tennessee","TN",2021-01-03,2021-01-09,7,2021,"1",6833174,2426,734,1579,847,1692,10.7417138799627,12.3954109759242,0.536415452818239
"United States","Tennessee","TN",2021-01-10,2021-01-16,7,2021,"2",6833174,2306,651,1595,711,1655,9.52705141124754,10.4051206657404,0.44576802507837
"United States","Tennessee","TN",2021-01-17,2021-01-23,7,2021,"3",6833174,2286,463,1594,692,1823,6.77576774716991,10.1270654018177,0.434127979924718
"United States","Tennessee","TN",2021-01-24,2021-01-30,7,2021,"4",6833174,2080,756,1600,480,1324,11.06367260661,7.02455403594289,0.3
"United States","Tennessee","TN",2021-01-31,2021-02-06,7,2021,"5",6833174,1951,889,1609,342,1062,13.0100594540692,5.00499475060931,0.212554381603481
"United States","Tennessee","TN",2021-02-07,2021-02-13,7,2021,"6",6833174,1772,468,1588,184,1304,6.84894018504431,2.69274571377811,0.115869017632242
"United States","Tennessee","TN",2021-02-14,2021-02-20,7,2021,"7",6833174,1791,199,1562,229,1592,2.91226302740132,3.35129765464775,0.146606914212548
"United States","Tennessee","TN",2021-02-21,2021-02-27,7,2021,"8",6833174,1759,274,1542,217,1485,4.0098495955174,3.17568380374918,0.140726329442283
"United States","Tennessee","TN",2021-02-28,2021-03-06,7,2021,"9",6833174,1668,146,1531,137,1522,2.13663518593263,2.0049247977587,0.0894839973873285
"United States","Tennessee","TN",2021-03-07,2021-03-13,7,2021,"10",6833174,1603,96,1515,88,1507,1.40491080718858,1.28783490658953,0.058085808580858
"United States","Tennessee","TN",2021-03-14,2021-03-20,7,2021,"11",6833174,1580,73,1509,71,1507,1.06831759296631,1.03904861781655,0.0470510271703115
"United States","Tennessee","TN",2021-03-21,2021-03-27,7,2021,"12",6833174,1658,102,1512,146,1556,1.49271773263786,2.13663518593263,0.0965608465608465
"United States","Tennessee","TN",2021-03-28,2021-04-03,7,2021,"13",6833174,1573,94,1517,56,1479,1.37564183203882,0.819531304193337,0.0369149637442321
"United States","Tennessee","TN",2021-04-04,2021-04-10,7,2021,"14",6833174,1694,86,1502,192,1608,1.25856593143977,2.80982161437715,0.127829560585885
"United States","Tennessee","TN",2021-04-11,2021-04-17,7,2021,"15",6833174,1621,65,1508,113,1556,0.951241692367266,1.65369709596155,0.0749336870026525
"United States","Tennessee","TN",2021-04-18,2021-04-24,7,2021,"16",6833174,1676,80,1485,191,1596,1.17075900599048,2.79518712680227,0.128619528619529
"United States","Tennessee","TN",2021-04-25,2021-05-01,7,2021,"17",6833174,1648,58,1469,179,1590,0.848800279343099,2.6195732759037,0.121851599727706
"United States","Tennessee","TN",2021-05-02,2021-05-08,7,2021,"18",6833174,1649,53,1464,185,1596,0.775627841468694,2.70738020135299,0.126366120218579
"United States","Tennessee","TN",2021-05-09,2021-05-15,7,2021,"19",6833174,1637,55,1462,175,1582,0.804896816618456,2.56103532560418,0.119699042407661
"United States","Tennessee","TN",2021-05-16,2021-05-22,7,2021,"20",6833174,1562,68,1456,106,1494,0.995145155091909,1.55125568293739,0.0728021978021978
"United States","Tennessee","TN",2021-05-23,2021-05-29,7,2021,"21",6833174,1533,61,1446,87,1472,0.892703742067742,1.27320041901465,0.0601659751037344
"United States","Tennessee","TN",2021-05-30,2021-06-05,7,2021,"22",6833174,1547,35,1429,118,1512,0.512207065120835,1.72686953383596,0.0825752274317704
"United States","Tennessee","TN",2021-06-06,2021-06-12,7,2021,"23",6833174,1656,22,1429,227,1634,0.321958726647382,3.32202867949799,0.158852344296711
"United States","Tennessee","TN",2021-06-13,2021-06-19,7,2021,"24",6833174,1562,18,1430,132,1544,0.263420776347858,1.93175235988429,0.0923076923076922
"United States","Tennessee","TN",2021-06-20,2021-06-26,7,2021,"25",6833174,1534,34,1420,114,1500,0.497572577545954,1.66833158353644,0.080281690140845
"United States","Tennessee","TN",2021-06-27,2021-07-03,7,2021,"26",6833174,1496,21,1415,81,1475,0.307324239072501,1.18539349356536,0.0572438162544169
"United States","Tennessee","TN",2021-07-04,2021-07-10,7,2021,"27",6833174,1435,25,1414,21,1410,0.365862189372025,0.307324239072501,0.0148514851485149
"United States","Tennessee","TN",2021-07-11,2021-07-17,7,2021,"28",6833174,1483,32,1414,69,1451,0.468303602396192,1.00977964266679,0.0487977369165489
"United States","Tennessee","TN",2021-07-18,2021-07-24,7,2021,"29",6833174,1474,45,1424,50,1429,0.658551940869646,0.731724378744051,0.0351123595505618
"United States","Tennessee","TN",2021-07-25,2021-07-31,7,2021,"30",6833174,1411,59,1422,-11,1352,0.86343476691798,-0.160979363323691,-0.00773558368495075
"United States","Tennessee","TN",2021-08-01,2021-08-07,7,2021,"31",6833174,1273,95,1405,-132,1178,1.3902763196137,-1.93175235988429,-0.0939501779359431
"United States","Texas","TX",2019-12-29,2020-01-04,7,2020,"1",28995881,4325,0,4557,-232,4325,0,-0.800113643727535,-0.0509106868553874
"United States","Texas","TX",2020-01-05,2020-01-11,7,2020,"2",28995881,4564,0,4521,43,4564,0,0.148296925346052,0.0095111700951116
"United States","Texas","TX",2020-01-12,2020-01-18,7,2020,"3",28995881,4250,0,4519,-269,4250,0,-0.927717974839254,-0.0595264439035185
"United States","Texas","TX",2020-01-19,2020-01-25,7,2020,"4",28995881,4128,0,4543,-415,4128,0,-1.43123776787469,-0.0913493286374643
"United States","Texas","TX",2020-01-26,2020-02-01,7,2020,"5",28995881,4174,0,4517,-343,4174,0,-1.18292663706269,-0.0759353553243303
"United States","Texas","TX",2020-02-02,2020-02-08,7,2020,"6",28995881,4322,0,4452,-130,4322,0,-0.448339541743877,-0.0292003593890386
"United States","Texas","TX",2020-02-09,2020-02-15,7,2020,"7",28995881,4343,0,4422,-79,4343,0,-0.272452490752049,-0.0178652193577566
"United States","Texas","TX",2020-02-16,2020-02-22,7,2020,"8",28995881,4221,0,4384,-163,4221,0,-0.562148810032708,-0.0371806569343066
"United States","Texas","TX",2020-02-23,2020-02-29,7,2020,"9",28995881,4146,0,4307,-161,4146,0,-0.555251278621264,-0.0373810076619456
"United States","Texas","TX",2020-03-01,2020-03-07,7,2020,"10",28995881,4173,0,4262,-89,4173,0,-0.30694014780927,-0.0208822149225716
"United States","Texas","TX",2020-03-08,2020-03-14,7,2020,"11",28995881,4169,0,4216,-47,4169,0,-0.16209198816894,-0.0111480075901328
"United States","Texas","TX",2020-03-15,2020-03-21,7,2020,"12",28995881,4256,5,4147,109,4251,0.0172438285286107,0.375915461923713,0.0262840607668193
"United States","Texas","TX",2020-03-22,2020-03-28,7,2020,"13",28995881,4259,25,4104,155,4234,0.0862191426430533,0.534558684386931,0.0377680311890838
"United States","Texas","TX",2020-03-29,2020-04-04,7,2020,"14",28995881,4186,77,4058,128,4109,0.265554959340604,0.441442010332433,0.031542631838344
"United States","Texas","TX",2020-04-05,2020-04-11,7,2020,"15",28995881,4266,147,4019,247,4119,0.506968558741154,0.851845129313367,0.0614580741477979
"United States","Texas","TX",2020-04-12,2020-04-18,7,2020,"16",28995881,4294,199,4019,275,4095,0.686304375438704,0.948410569073587,0.0684249813386415
"United States","Texas","TX",2020-04-19,2020-04-25,7,2020,"17",28995881,4464,169,3970,494,4295,0.582841404267041,1.70369025862673,0.124433249370277
"United States","Texas","TX",2020-04-26,2020-05-02,7,2020,"18",28995881,4263,224,3948,315,4039,0.772523518081758,1.08636119730247,0.0797872340425532
"United States","Texas","TX",2020-05-03,2020-05-09,7,2020,"19",28995881,4278,202,3934,344,4076,0.696650672555871,1.18637540276841,0.0874428063040162
"United States","Texas","TX",2020-05-10,2020-05-16,7,2020,"20",28995881,4280,256,3928,352,4024,0.882884020664866,1.21396552841419,0.089613034623218
"United States","Texas","TX",2020-05-17,2020-05-23,7,2020,"21",28995881,4255,199,3892,363,4056,0.686304375438704,1.25190195117713,0.093268242548818
"United States","Texas","TX",2020-05-24,2020-05-30,7,2020,"22",28995881,4156,142,3868,288,4014,0.489724730212543,0.993244523247974,0.0744570837642193
"United States","Texas","TX",2020-05-31,2020-06-06,7,2020,"23",28995881,4229,169,3864,365,4060,0.582841404267041,1.25879948258858,0.0944616977225672
"United States","Texas","TX",2020-06-07,2020-06-13,7,2020,"24",28995881,4396,141,3873,523,4255,0.486275964506821,1.80370446409268,0.135037438678027
"United States","Texas","TX",2020-06-14,2020-06-20,7,2020,"25",28995881,4509,207,3837,672,4302,0.713894501084482,2.31757055424527,0.175136825645035
"United States","Texas","TX",2020-06-21,2020-06-27,7,2020,"26",28995881,4566,204,3839,727,4362,0.703548203967315,2.50725266805999,0.189372232352175
"United States","Texas","TX",2020-06-28,2020-07-04,7,2020,"27",28995881,5036,242,3812,1224,4794,0.834601300784756,4.22128922380389,0.32109129066107
"United States","Texas","TX",2020-07-05,2020-07-11,7,2020,"28",28995881,5772,504,3811,1961,5268,1.73817791568396,6.7630295489211,0.514563106796116
"United States","Texas","TX",2020-07-12,2020-07-18,7,2020,"29",28995881,6264,753,3826,2438,5511,2.59692057640877,8.40809079055056,0.637219027705175
"United States","Texas","TX",2020-07-19,2020-07-25,7,2020,"30",28995881,6310,1020,3844,2466,5290,3.51774101983658,8.50465623031078,0.641519250780437
"United States","Texas","TX",2020-07-26,2020-08-01,7,2020,"31",28995881,5953,1950,3843,2110,4003,6.72509312615816,7.2768956390737,0.549050221181369
"United States","Texas","TX",2020-08-02,2020-08-08,7,2020,"32",28995881,5712,1506,3856,1856,4206,5.19384115281753,6.40090914982028,0.481327800829876
"United States","Texas","TX",2020-08-09,2020-08-15,7,2020,"33",28995881,5782,1498,3865,1917,4284,5.16625102717176,6.61128385786933,0.495989650711514
"United States","Texas","TX",2020-08-16,2020-08-22,7,2020,"34",28995881,5033,1423,3848,1185,3610,4.9075935992426,4.08678736128073,0.307952182952183
"United States","Texas","TX",2020-08-23,2020-08-29,7,2020,"35",28995881,5137,1154,3852,1285,3983,3.97987562440334,4.43166393185294,0.333592938733126
"United States","Texas","TX",2020-08-30,2020-09-05,7,2020,"36",28995881,4942,987,3853,1089,3955,3.40393175154775,3.7557058535314,0.282636906306774
"United States","Texas","TX",2020-09-06,2020-09-12,7,2020,"37",28995881,4654,735,3830,824,3919,2.53484279370577,2.84178294151504,0.215143603133159
"United States","Texas","TX",2020-09-13,2020-09-19,7,2020,"38",28995881,4601,705,3815,786,3896,2.4313798225341,2.7107298446976,0.206028833551769
"United States","Texas","TX",2020-09-20,2020-09-26,7,2020,"39",28995881,4544,634,3834,710,3910,2.18651745742783,2.44862365106271,0.185185185185185
"United States","Texas","TX",2020-09-27,2020-10-03,7,2020,"40",28995881,4589,507,3840,749,4082,1.74852421280112,2.58312551358588,0.195052083333333
"United States","Texas","TX",2020-10-04,2020-10-10,7,2020,"41",28995881,4720,534,3852,868,4186,1.84164088685562,2.99352863256681,0.22533748701973
"United States","Texas","TX",2020-10-11,2020-10-17,7,2020,"42",28995881,4535,457,3884,651,4078,1.57608592751501,2.24514647442511,0.167610710607621
"United States","Texas","TX",2020-10-18,2020-10-24,7,2020,"43",28995881,4813,472,3918,895,4341,1.62781741310085,3.08664530662131,0.228432873915263
"United States","Texas","TX",2020-10-25,2020-10-31,7,2020,"44",28995881,5165,566,3958,1207,4599,1.95200138943873,4.16266020680662,0.304951995957554
"United States","Texas","TX",2020-11-01,2020-11-07,7,2020,"45",28995881,5402,674,3989,1413,4728,2.32446808565672,4.87310594218537,0.35422411631988
"United States","Texas","TX",2020-11-08,2020-11-14,7,2020,"46",28995881,5444,767,4026,1418,4677,2.64520329628888,4.89034977071399,0.352210630899155
"United States","Texas","TX",2020-11-15,2020-11-21,7,2020,"47",28995881,5431,827,4051,1380,4604,2.8521292386322,4.75929667389654,0.340656627993088
"United States","Texas","TX",2020-11-22,2020-11-28,7,2020,"48",28995881,5595,1013,4052,1543,4582,3.49359965989652,5.32144548392925,0.380799605133268
"United States","Texas","TX",2020-11-29,2020-12-05,7,2020,"49",28995881,5636,1194,4095,1541,4442,4.11782625263223,5.31454795251781,0.376312576312576
"United States","Texas","TX",2020-12-06,2020-12-12,7,2020,"50",28995881,6057,1297,4142,1915,4760,4.47304912032161,6.60438632645789,0.462337035248672
"United States","Texas","TX",2020-12-13,2020-12-19,7,2020,"51",28995881,6185,861,4211,1974,5324,2.96938727262676,6.80786350309549,0.468772263120399
"United States","Texas","TX",2020-12-20,2020-12-26,7,2020,"52",28995881,6134,1775,4284,1850,4359,6.12155912765679,6.38021655558595,0.431839402427638
"United States","Texas","TX",2020-12-27,2021-01-02,7,2020,"53",28995881,6544,1431,4331,2213,5113,4.93518372488837,7.63211850676308,0.510967444008312
"United States","Texas","TX",2021-01-03,2021-01-09,7,2021,"1",28995881,6969,1825,4340,2629,5144,6.29399741294289,9.06680504034349,0.605760368663594
"United States","Texas","TX",2021-01-10,2021-01-16,7,2021,"2",28995881,7202,2140,4356,2846,5062,7.38035861024536,9.81518719848519,0.653351698806244
"United States","Texas","TX",2021-01-17,2021-01-23,7,2021,"3",28995881,6995,2282,4350,2645,4713,7.87008334045791,9.12198529163504,0.608045977011494
"United States","Texas","TX",2021-01-24,2021-01-30,7,2021,"4",28995881,6637,2204,4357,2280,4433,7.60107961541158,7.86318580904646,0.523295845765435
"United States","Texas","TX",2021-01-31,2021-02-06,7,2021,"5",28995881,6240,2156,4347,1893,4084,7.43553886153692,6.528513480932,0.435472739820566
"United States","Texas","TX",2021-02-07,2021-02-13,7,2021,"6",28995881,5891,1902,4299,1592,3989,6.5595523722835,5.49043500350964,0.370318678762503
"United States","Texas","TX",2021-02-14,2021-02-20,7,2021,"7",28995881,6404,834,4300,2104,5570,2.87627059857226,7.25620304483937,0.489302325581395
"United States","Texas","TX",2021-02-21,2021-02-27,7,2021,"8",28995881,5681,1526,4277,1404,4155,5.26281646693198,4.84206705083388,0.328267477203647
"United States","Texas","TX",2021-02-28,2021-03-06,7,2021,"9",28995881,5209,1627,4223,986,3582,5.61114180320991,3.40048298584202,0.233483305706844
"United States","Texas","TX",2021-03-07,2021-03-13,7,2021,"10",28995881,4950,1104,4160,790,3846,3.80743733911724,2.72452490752049,0.189903846153846
"United States","Texas","TX",2021-03-14,2021-03-20,7,2021,"11",28995881,4628,881,4128,500,3747,3.0383625867412,1.72438285286107,0.121124031007752
"United States","Texas","TX",2021-03-21,2021-03-27,7,2021,"12",28995881,4581,740,4068,513,3841,2.55208662223438,1.76921680703545,0.126106194690266
"United States","Texas","TX",2021-03-28,2021-04-03,7,2021,"13",28995881,4438,629,4010,428,3809,2.16927362889922,1.47607172204907,0.106733167082294
"United States","Texas","TX",2021-04-04,2021-04-10,7,2021,"14",28995881,4586,460,3950,636,4126,1.58643222463218,2.19341498883928,0.161012658227848
"United States","Texas","TX",2021-04-11,2021-04-17,7,2021,"15",28995881,4307,388,3929,378,3919,1.33812109382019,1.30363343676297,0.0962076864342072
"United States","Texas","TX",2021-04-18,2021-04-24,7,2021,"16",28995881,4567,372,3926,641,4195,1.28294084252863,2.21065881736789,0.163270504330107
"United States","Texas","TX",2021-04-25,2021-05-01,7,2021,"17",28995881,4446,341,3909,537,4105,1.17602910565125,1.85198718397279,0.137375287797391
"United States","Texas","TX",2021-05-02,2021-05-08,7,2021,"18",28995881,4355,293,3891,464,4062,1.01048835177659,1.60022728745507,0.119249550244153
"United States","Texas","TX",2021-05-09,2021-05-15,7,2021,"19",28995881,4381,305,3852,529,4076,1.05187354024525,1.82439705832701,0.137331256490135
"United States","Texas","TX",2021-05-16,2021-05-22,7,2021,"20",28995881,4273,261,3853,420,4012,0.900127849193477,1.4484815964033,0.109005969374513
"United States","Texas","TX",2021-05-23,2021-05-29,7,2021,"21",28995881,4272,263,3845,427,4009,0.907025380604921,1.47262295634335,0.111053315994798
"United States","Texas","TX",2021-05-30,2021-06-05,7,2021,"22",28995881,4214,218,3850,364,3996,0.751830923847425,1.25535071688286,0.0945454545454545
"United States","Texas","TX",2021-06-06,2021-06-12,7,2021,"23",28995881,4298,223,3845,453,4075,0.769074752376036,1.56229086469213,0.117815344603381
"United States","Texas","TX",2021-06-13,2021-06-19,7,2021,"24",28995881,4329,173,3845,484,4156,0.596636467089929,1.66920260156951,0.125877763328999
"United States","Texas","TX",2021-06-20,2021-06-26,7,2021,"25",28995881,4310,171,3815,495,4139,0.589738935678485,1.70713902433246,0.129750982961992
"United States","Texas","TX",2021-06-27,2021-07-03,7,2021,"26",28995881,4328,150,3804,524,4178,0.51731485585832,1.8071532297984,0.137749737118822
"United States","Texas","TX",2021-07-04,2021-07-10,7,2021,"27",28995881,4221,140,3793,428,4081,0.482827198801099,1.47607172204907,0.112839441075666
"United States","Texas","TX",2021-07-11,2021-07-17,7,2021,"28",28995881,4380,162,3818,562,4218,0.558700044326986,1.93820632661584,0.147197485594552
"United States","Texas","TX",2021-07-18,2021-07-24,7,2021,"29",28995881,4278,189,3814,464,4089,0.651816718381483,1.60022728745507,0.121657052962769
"United States","Texas","TX",2021-07-25,2021-07-31,7,2021,"30",28995881,4039,255,3821,218,3784,0.879435254959144,0.751830923847425,0.0570531274535462
"United States","Texas","TX",2021-08-01,2021-08-07,7,2021,"31",28995881,3266,350,3834,-568,2916,1.20706799700275,-1.95889892085017,-0.148148148148148
"United States","Utah","UT",2019-12-29,2020-01-04,7,2020,"1",3205958,392,0,388,4,392,0,0.124767698142022,0.0103092783505154
"United States","Utah","UT",2020-01-05,2020-01-11,7,2020,"2",3205958,438,0,397,41,438,0,1.27886890595572,0.103274559193955
"United States","Utah","UT",2020-01-12,2020-01-18,7,2020,"3",3205958,409,0,393,16,409,0,0.499070792568087,0.0407124681933841
"United States","Utah","UT",2020-01-19,2020-01-25,7,2020,"4",3205958,390,0,392,-2,390,0,-0.0623838490710109,-0.00510204081632648
"United States","Utah","UT",2020-01-26,2020-02-01,7,2020,"5",3205958,364,0,388,-24,364,0,-0.748606188852131,-0.0618556701030928
"United States","Utah","UT",2020-02-02,2020-02-08,7,2020,"6",3205958,395,0,391,4,395,0,0.124767698142022,0.0102301790281329
"United States","Utah","UT",2020-02-09,2020-02-15,7,2020,"7",3205958,414,0,390,24,414,0,0.748606188852131,0.0615384615384615
"United States","Utah","UT",2020-02-16,2020-02-22,7,2020,"8",3205958,368,0,393,-25,368,0,-0.779798113387636,-0.0636132315521628
"United States","Utah","UT",2020-02-23,2020-02-29,7,2020,"9",3205958,417,0,392,25,417,0,0.779798113387636,0.0637755102040816
"United States","Utah","UT",2020-03-01,2020-03-07,7,2020,"10",3205958,427,0,388,39,427,0,1.21648505688471,0.100515463917526
"United States","Utah","UT",2020-03-08,2020-03-14,7,2020,"11",3205958,406,0,389,17,406,0,0.530262717103593,0.0437017994858613
"United States","Utah","UT",2020-03-15,2020-03-21,7,2020,"12",3205958,412,0,381,31,412,0,0.966949660600669,0.0813648293963254
"United States","Utah","UT",2020-03-22,2020-03-28,7,2020,"13",3205958,395,3,380,15,392,0.0935757736065164,0.467878868032582,0.0394736842105263
"United States","Utah","UT",2020-03-29,2020-04-04,7,2020,"14",3205958,408,5,379,29,403,0.155959622677527,0.904565811529658,0.0765171503957784
"United States","Utah","UT",2020-04-05,2020-04-11,7,2020,"15",3205958,382,10,387,-5,372,0.311919245355055,-0.155959622677527,-0.0129198966408268
"United States","Utah","UT",2020-04-12,2020-04-18,7,2020,"16",3205958,388,7,380,8,381,0.218343471748538,0.249535396284044,0.0210526315789474
"United States","Utah","UT",2020-04-19,2020-04-25,7,2020,"17",3205958,410,16,378,32,394,0.499070792568087,0.998141585136175,0.0846560846560847
"United States","Utah","UT",2020-04-26,2020-05-02,7,2020,"18",3205958,381,8,376,5,373,0.249535396284044,0.155959622677527,0.0132978723404256
"United States","Utah","UT",2020-05-03,2020-05-09,7,2020,"19",3205958,372,19,373,-1,353,0.592646566174604,-0.0311919245355055,-0.00268096514745308
"United States","Utah","UT",2020-05-10,2020-05-16,7,2020,"20",3205958,403,10,368,35,393,0.311919245355055,1.09171735874269,0.0951086956521738
"United States","Utah","UT",2020-05-17,2020-05-23,7,2020,"21",3205958,374,19,374,0,355,0.592646566174604,0,0
"United States","Utah","UT",2020-05-24,2020-05-30,7,2020,"22",3205958,390,11,375,15,379,0.34311116989056,0.467878868032582,0.04
"United States","Utah","UT",2020-05-31,2020-06-06,7,2020,"23",3205958,410,13,379,31,397,0.405495018961571,0.966949660600669,0.0817941952506596
"United States","Utah","UT",2020-06-07,2020-06-13,7,2020,"24",3205958,388,18,378,10,370,0.561454641639098,0.311919245355055,0.0264550264550265
"United States","Utah","UT",2020-06-14,2020-06-20,7,2020,"25",3205958,402,16,379,23,386,0.499070792568087,0.717414264316625,0.0606860158311346
"United States","Utah","UT",2020-06-21,2020-06-27,7,2020,"26",3205958,388,12,374,14,376,0.374303094426065,0.436686943497076,0.0374331550802138
"United States","Utah","UT",2020-06-28,2020-07-04,7,2020,"27",3205958,438,14,374,64,424,0.436686943497076,1.99628317027235,0.171122994652406
"United States","Utah","UT",2020-07-05,2020-07-11,7,2020,"28",3205958,407,31,370,37,376,0.966949660600669,1.1541012078137,0.1
"United States","Utah","UT",2020-07-12,2020-07-18,7,2020,"29",3205958,435,31,375,60,404,0.966949660600669,1.87151547213033,0.16
"United States","Utah","UT",2020-07-19,2020-07-25,7,2020,"30",3205958,437,31,374,63,406,0.966949660600669,1.96509124573684,0.168449197860963
"United States","Utah","UT",2020-07-26,2020-08-01,7,2020,"31",3205958,435,36,377,58,399,1.1229092832782,1.80913162305932,0.153846153846154
"United States","Utah","UT",2020-08-02,2020-08-08,7,2020,"32",3205958,449,25,369,80,424,0.779798113387636,2.49535396284044,0.21680216802168
"United States","Utah","UT",2020-08-09,2020-08-15,7,2020,"33",3205958,450,28,370,80,422,0.873373886994153,2.49535396284044,0.216216216216216
"United States","Utah","UT",2020-08-16,2020-08-22,7,2020,"34",3205958,422,23,366,56,399,0.717414264316625,1.74674777398831,0.153005464480874
"United States","Utah","UT",2020-08-23,2020-08-29,7,2020,"35",3205958,377,21,365,12,356,0.655030415245615,0.374303094426065,0.0328767123287672
"United States","Utah","UT",2020-08-30,2020-09-05,7,2020,"36",3205958,367,13,367,0,354,0.405495018961571,0,0
"United States","Utah","UT",2020-09-06,2020-09-12,7,2020,"37",3205958,382,13,371,11,369,0.405495018961571,0.34311116989056,0.0296495956873315
"United States","Utah","UT",2020-09-13,2020-09-19,7,2020,"38",3205958,400,7,370,30,393,0.218343471748538,0.935757736065164,0.0810810810810811
"United States","Utah","UT",2020-09-20,2020-09-26,7,2020,"39",3205958,440,8,377,63,432,0.249535396284044,1.96509124573684,0.16710875331565
"United States","Utah","UT",2020-09-27,2020-10-03,7,2020,"40",3205958,393,28,380,13,365,0.873373886994153,0.405495018961571,0.0342105263157895
"United States","Utah","UT",2020-10-04,2020-10-10,7,2020,"41",3205958,443,37,380,63,406,1.1541012078137,1.96509124573684,0.16578947368421
"United States","Utah","UT",2020-10-11,2020-10-17,7,2020,"42",3205958,424,28,377,47,396,0.873373886994153,1.46602045316876,0.124668435013263
"United States","Utah","UT",2020-10-18,2020-10-24,7,2020,"43",3205958,442,27,374,68,415,0.842181962458647,2.12105086841437,0.181818181818182
"United States","Utah","UT",2020-10-25,2020-10-31,7,2020,"44",3205958,460,36,373,87,424,1.1229092832782,2.71369743458897,0.233243967828418
"United States","Utah","UT",2020-11-01,2020-11-07,7,2020,"45",3205958,453,54,374,79,399,1.68436392491729,2.46416203830493,0.211229946524064
"United States","Utah","UT",2020-11-08,2020-11-14,7,2020,"46",3205958,482,53,376,106,429,1.65317200038179,3.30634400076358,0.281914893617021
"United States","Utah","UT",2020-11-15,2020-11-21,7,2020,"47",3205958,544,64,379,165,480,1.99628317027235,5.1466675483584,0.435356200527705
"United States","Utah","UT",2020-11-22,2020-11-28,7,2020,"48",3205958,487,88,379,108,399,2.74488935912448,3.36872784983459,0.284960422163588
"United States","Utah","UT",2020-11-29,2020-12-05,7,2020,"49",3205958,538,76,385,153,462,2.37058626469841,4.77236445393233,0.397402597402597
"United States","Utah","UT",2020-12-06,2020-12-12,7,2020,"50",3205958,552,101,382,170,451,3.15038437808605,5.30262717103593,0.445026178010471
"United States","Utah","UT",2020-12-13,2020-12-19,7,2020,"51",3205958,545,109,385,160,436,3.39991977437009,4.99070792568087,0.415584415584416
"United States","Utah","UT",2020-12-20,2020-12-26,7,2020,"52",3205958,502,7,397,105,495,0.218343471748538,3.27515207622807,0.26448362720403
"United States","Utah","UT",2020-12-27,2021-01-02,7,2020,"53",3205958,486,140,410,76,346,4.36686943497076,2.37058626469841,0.185365853658537
"United States","Utah","UT",2021-01-03,2021-01-09,7,2021,"1",3205958,533,97,414,119,436,3.02561667994403,3.71183901972515,0.28743961352657
"United States","Utah","UT",2021-01-10,2021-01-16,7,2021,"2",3205958,484,94,421,63,390,2.93204090633751,1.96509124573684,0.149643705463183
"United States","Utah","UT",2021-01-17,2021-01-23,7,2021,"3",3205958,496,97,416,80,399,3.02561667994403,2.49535396284044,0.192307692307692
"United States","Utah","UT",2021-01-24,2021-01-30,7,2021,"4",3205958,502,81,410,92,421,2.52654588737594,2.8696570572665,0.224390243902439
"United States","Utah","UT",2021-01-31,2021-02-06,7,2021,"5",3205958,466,71,405,61,395,2.21462664202089,1.90270739666583,0.150617283950617
"United States","Utah","UT",2021-02-07,2021-02-13,7,2021,"6",3205958,450,57,406,44,393,1.77793969852381,1.37244467956224,0.108374384236453
"United States","Utah","UT",2021-02-14,2021-02-20,7,2021,"7",3205958,428,50,408,20,378,1.55959622677527,0.623838490710109,0.0490196078431373
"United States","Utah","UT",2021-02-21,2021-02-27,7,2021,"8",3205958,382,65,411,-29,317,2.02747509480785,-0.904565811529658,-0.0705596107055961
"United States","Utah","UT",2021-02-28,2021-03-06,7,2021,"9",3205958,418,62,407,11,356,1.93389932120134,0.34311116989056,0.027027027027027
"United States","Utah","UT",2021-03-07,2021-03-13,7,2021,"10",3205958,414,49,408,6,365,1.52840430223977,0.187151547213033,0.0147058823529411
"United States","Utah","UT",2021-03-14,2021-03-20,7,2021,"11",3205958,398,41,400,-2,357,1.27886890595572,-0.0623838490710109,-0.005
"United States","Utah","UT",2021-03-21,2021-03-27,7,2021,"12",3205958,394,60,391,3,334,1.87151547213033,0.0935757736065164,0.00767263427109977
"United States","Utah","UT",2021-03-28,2021-04-03,7,2021,"13",3205958,406,15,386,20,391,0.467878868032582,0.623838490710109,0.0518134715025906
"United States","Utah","UT",2021-04-04,2021-04-10,7,2021,"14",3205958,382,27,382,0,355,0.842181962458647,0,0
"United States","Utah","UT",2021-04-11,2021-04-17,7,2021,"15",3205958,373,4,384,-11,369,0.124767698142022,-0.34311116989056,-0.0286458333333334
"United States","Utah","UT",2021-04-18,2021-04-24,7,2021,"16",3205958,394,14,387,7,380,0.436686943497076,0.218343471748538,0.0180878552971577
"United States","Utah","UT",2021-04-25,2021-05-01,7,2021,"17",3205958,431,23,386,45,408,0.717414264316625,1.40363660409775,0.116580310880829
"United States","Utah","UT",2021-05-02,2021-05-08,7,2021,"18",3205958,388,20,381,7,368,0.623838490710109,0.218343471748538,0.0183727034120735
"United States","Utah","UT",2021-05-09,2021-05-15,7,2021,"19",3205958,383,35,381,2,348,1.09171735874269,0.0623838490710109,0.00524934383202091
"United States","Utah","UT",2021-05-16,2021-05-22,7,2021,"20",3205958,408,32,375,33,376,0.998141585136175,1.02933350967168,0.0880000000000001
"United States","Utah","UT",2021-05-23,2021-05-29,7,2021,"21",3205958,438,11,374,64,427,0.34311116989056,1.99628317027235,0.171122994652406
"United States","Utah","UT",2021-05-30,2021-06-05,7,2021,"22",3205958,394,10,374,20,384,0.311919245355055,0.623838490710109,0.053475935828877
"United States","Utah","UT",2021-06-06,2021-06-12,7,2021,"23",3205958,390,8,371,19,382,0.249535396284044,0.592646566174604,0.0512129380053907
"United States","Utah","UT",2021-06-13,2021-06-19,7,2021,"24",3205958,418,7,367,51,411,0.218343471748538,1.59078815131078,0.138964577656676
"United States","Utah","UT",2021-06-20,2021-06-26,7,2021,"25",3205958,426,25,365,61,401,0.779798113387636,1.90270739666583,0.167123287671233
"United States","Utah","UT",2021-06-27,2021-07-03,7,2021,"26",3205958,426,27,362,64,399,0.842181962458647,1.99628317027235,0.176795580110497
"United States","Utah","UT",2021-07-04,2021-07-10,7,2021,"27",3205958,439,15,361,78,424,0.467878868032582,2.43297011376943,0.21606648199446
"United States","Utah","UT",2021-07-11,2021-07-17,7,2021,"28",3205958,388,20,361,27,368,0.623838490710109,0.842181962458647,0.074792243767313
"United States","Utah","UT",2021-07-18,2021-07-24,7,2021,"29",3205958,449,12,360,89,437,0.374303094426065,2.77608128365999,0.247222222222222
"United States","Utah","UT",2021-07-25,2021-07-31,7,2021,"30",3205958,428,26,362,66,402,0.810990037923142,2.05866701934336,0.18232044198895
"United States","Utah","UT",2021-08-01,2021-08-07,7,2021,"31",3205958,418,43,363,55,375,1.34125275502673,1.7155558494528,0.151515151515152
"United States","Vermont","VT",2019-12-29,2020-01-04,7,2020,"1",623989,92,0,123,-31,92,0,-4.96803629551162,-0.252032520325203
"United States","Vermont","VT",2020-01-05,2020-01-11,7,2020,"2",623989,102,0,126,-24,102,0,-3.84622164813803,-0.19047619047619
"United States","Vermont","VT",2020-01-12,2020-01-18,7,2020,"3",623989,134,0,121,13,134,0,2.0833700594081,0.107438016528926
"United States","Vermont","VT",2020-01-19,2020-01-25,7,2020,"4",623989,119,0,122,-3,119,0,-0.480777706017254,-0.0245901639344263
"United States","Vermont","VT",2020-01-26,2020-02-01,7,2020,"5",623989,105,0,120,-15,105,0,-2.40388853008627,-0.125
"United States","Vermont","VT",2020-02-02,2020-02-08,7,2020,"6",623989,121,0,121,0,121,0,0,0
"United States","Vermont","VT",2020-02-09,2020-02-15,7,2020,"7",623989,126,0,115,11,126,0,1.76285158872993,0.0956521739130434
"United States","Vermont","VT",2020-02-16,2020-02-22,7,2020,"8",623989,107,0,117,-10,107,0,-1.60259235339085,-0.0854700854700855
"United States","Vermont","VT",2020-02-23,2020-02-29,7,2020,"9",623989,137,0,114,23,137,0,3.68596241279894,0.201754385964912
"United States","Vermont","VT",2020-03-01,2020-03-07,7,2020,"10",623989,115,0,117,-2,115,0,-0.320518470678169,-0.0170940170940171
"United States","Vermont","VT",2020-03-08,2020-03-14,7,2020,"11",623989,162,0,115,47,162,0,7.53218406093697,0.408695652173913
"United States","Vermont","VT",2020-03-15,2020-03-21,7,2020,"12",623989,135,2,115,20,133,0.320518470678169,3.20518470678169,0.173913043478261
"United States","Vermont","VT",2020-03-22,2020-03-28,7,2020,"13",623989,106,10,115,-9,96,1.60259235339085,-1.44233311805176,-0.0782608695652174
"United States","Vermont","VT",2020-03-29,2020-04-04,7,2020,"14",623989,152,4,114,38,148,0.641036941356338,6.08985094288521,0.333333333333333
"United States","Vermont","VT",2020-04-05,2020-04-11,7,2020,"15",623989,127,8,111,16,119,1.28207388271268,2.56414776542535,0.144144144144144
"United States","Vermont","VT",2020-04-12,2020-04-18,7,2020,"16",623989,147,12,111,36,135,1.92311082406901,5.76933247220704,0.324324324324324
"United States","Vermont","VT",2020-04-19,2020-04-25,7,2020,"17",623989,120,9,109,11,111,1.44233311805176,1.76285158872993,0.100917431192661
"United States","Vermont","VT",2020-04-26,2020-05-02,7,2020,"18",623989,109,5,108,1,104,0.801296176695423,0.160259235339084,0.0092592592592593
"United States","Vermont","VT",2020-05-03,2020-05-09,7,2020,"19",623989,124,3,104,20,121,0.480777706017254,3.20518470678169,0.192307692307692
"United States","Vermont","VT",2020-05-10,2020-05-16,7,2020,"20",623989,103,0,103,0,103,0,0,0
"United States","Vermont","VT",2020-05-17,2020-05-23,7,2020,"21",623989,103,1,101,2,102,0.160259235339084,0.320518470678169,0.0198019801980198
"United States","Vermont","VT",2020-05-24,2020-05-30,7,2020,"22",623989,143,1,106,37,142,0.160259235339084,5.92959170754613,0.349056603773585
"United States","Vermont","VT",2020-05-31,2020-06-06,7,2020,"23",623989,116,0,107,9,116,0,1.44233311805176,0.0841121495327102
"United States","Vermont","VT",2020-06-07,2020-06-13,7,2020,"24",623989,103,0,107,-4,103,0,-0.641036941356338,-0.0373831775700935
"United States","Vermont","VT",2020-06-14,2020-06-20,7,2020,"25",623989,102,1,105,-3,101,0.160259235339084,-0.480777706017254,-0.0285714285714286
"United States","Vermont","VT",2020-06-21,2020-06-27,7,2020,"26",623989,124,0,110,14,124,0,2.24362929474718,0.127272727272727
"United States","Vermont","VT",2020-06-28,2020-07-04,7,2020,"27",623989,91,0,107,-16,91,0,-2.56414776542535,-0.149532710280374
"United States","Vermont","VT",2020-07-05,2020-07-11,7,2020,"28",623989,129,0,107,22,129,0,3.52570317745986,0.205607476635514
"United States","Vermont","VT",2020-07-12,2020-07-18,7,2020,"29",623989,104,0,106,-2,104,0,-0.320518470678169,-0.0188679245283019
"United States","Vermont","VT",2020-07-19,2020-07-25,7,2020,"30",623989,115,0,109,6,115,0,0.961555412034507,0.0550458715596329
"United States","Vermont","VT",2020-07-26,2020-08-01,7,2020,"31",623989,103,1,104,-1,102,0.160259235339084,-0.160259235339084,-0.00961538461538458
"United States","Vermont","VT",2020-08-02,2020-08-08,7,2020,"32",623989,123,1,103,20,122,0.160259235339084,3.20518470678169,0.194174757281553
"United States","Vermont","VT",2020-08-09,2020-08-15,7,2020,"33",623989,104,0,102,2,104,0,0.320518470678169,0.0196078431372548
"United States","Vermont","VT",2020-08-16,2020-08-22,7,2020,"34",623989,117,0,104,13,117,0,2.0833700594081,0.125
"United States","Vermont","VT",2020-08-23,2020-08-29,7,2020,"35",623989,121,0,102,19,121,0,3.04492547144261,0.186274509803922
"United States","Vermont","VT",2020-08-30,2020-09-05,7,2020,"36",623989,113,0,101,12,113,0,1.92311082406901,0.118811881188119
"United States","Vermont","VT",2020-09-06,2020-09-12,7,2020,"37",623989,126,0,101,25,126,0,4.00648088347711,0.247524752475248
"United States","Vermont","VT",2020-09-13,2020-09-19,7,2020,"38",623989,124,0,101,23,124,0,3.68596241279894,0.227722772277228
"United States","Vermont","VT",2020-09-20,2020-09-26,7,2020,"39",623989,120,0,101,19,120,0,3.04492547144261,0.188118811881188
"United States","Vermont","VT",2020-09-27,2020-10-03,7,2020,"40",623989,106,0,105,1,106,0,0.160259235339084,0.00952380952380949
"United States","Vermont","VT",2020-10-04,2020-10-10,7,2020,"41",623989,118,0,106,12,118,0,1.92311082406901,0.113207547169811
"United States","Vermont","VT",2020-10-11,2020-10-17,7,2020,"42",623989,100,0,107,-7,100,0,-1.12181464737359,-0.0654205607476636
"United States","Vermont","VT",2020-10-18,2020-10-24,7,2020,"43",623989,122,0,110,12,122,0,1.92311082406901,0.109090909090909
"United States","Vermont","VT",2020-10-25,2020-10-31,7,2020,"44",623989,137,0,112,25,137,0,4.00648088347711,0.223214285714286
"United States","Vermont","VT",2020-11-01,2020-11-07,7,2020,"45",623989,112,1,108,4,111,0.160259235339084,0.641036941356338,0.037037037037037
"United States","Vermont","VT",2020-11-08,2020-11-14,7,2020,"46",623989,122,0,107,15,122,0,2.40388853008627,0.14018691588785
"United States","Vermont","VT",2020-11-15,2020-11-21,7,2020,"47",623989,128,3,107,21,125,0.480777706017254,3.36544394212077,0.196261682242991
"United States","Vermont","VT",2020-11-22,2020-11-28,7,2020,"48",623989,145,5,106,39,140,0.801296176695423,6.2501101782243,0.367924528301887
"United States","Vermont","VT",2020-11-29,2020-12-05,7,2020,"49",623989,127,12,105,22,115,1.92311082406901,3.52570317745986,0.209523809523809
"United States","Vermont","VT",2020-12-06,2020-12-12,7,2020,"50",623989,132,16,108,24,116,2.56414776542535,3.84622164813803,0.222222222222222
"United States","Vermont","VT",2020-12-13,2020-12-19,7,2020,"51",623989,124,13,114,10,111,2.0833700594081,1.60259235339085,0.0877192982456141
"United States","Vermont","VT",2020-12-20,2020-12-26,7,2020,"52",623989,150,13,118,32,137,2.0833700594081,5.1282955308507,0.271186440677966
"United States","Vermont","VT",2020-12-27,2021-01-02,7,2020,"53",623989,156,18,123,33,138,2.88466623610352,5.28855476618979,0.268292682926829
"United States","Vermont","VT",2021-01-03,2021-01-09,7,2021,"1",623989,108,17,121,-13,91,2.72440700076444,-2.0833700594081,-0.107438016528926
"United States","Vermont","VT",2021-01-10,2021-01-16,7,2021,"2",623989,149,7,125,24,142,1.12181464737359,3.84622164813803,0.192
"United States","Vermont","VT",2021-01-17,2021-01-23,7,2021,"3",623989,124,7,124,0,117,1.12181464737359,0,0
"United States","Vermont","VT",2021-01-24,2021-01-30,7,2021,"4",623989,135,3,122,13,132,0.480777706017254,2.0833700594081,0.10655737704918
"United States","Vermont","VT",2021-01-31,2021-02-06,7,2021,"5",623989,137,9,120,17,128,1.44233311805176,2.72440700076444,0.141666666666667
"United States","Vermont","VT",2021-02-07,2021-02-13,7,2021,"6",623989,113,7,120,-7,106,1.12181464737359,-1.12181464737359,-0.0583333333333333
"United States","Vermont","VT",2021-02-14,2021-02-20,7,2021,"7",623989,167,7,116,51,160,1.12181464737359,8.17322100229331,0.439655172413793
"United States","Vermont","VT",2021-02-21,2021-02-27,7,2021,"8",623989,158,9,123,35,149,1.44233311805176,5.60907323686796,0.284552845528455
"United States","Vermont","VT",2021-02-28,2021-03-06,7,2021,"9",623989,122,3,116,6,119,0.480777706017254,0.961555412034507,0.0517241379310345
"United States","Vermont","VT",2021-03-07,2021-03-13,7,2021,"10",623989,156,6,117,39,150,0.961555412034507,6.2501101782243,0.333333333333333
"United States","Vermont","VT",2021-03-14,2021-03-20,7,2021,"11",623989,128,5,117,11,123,0.801296176695423,1.76285158872993,0.0940170940170941
"United States","Vermont","VT",2021-03-21,2021-03-27,7,2021,"12",623989,101,5,114,-13,96,0.801296176695423,-2.0833700594081,-0.114035087719298
"United States","Vermont","VT",2021-03-28,2021-04-03,7,2021,"13",623989,104,5,114,-10,99,0.801296176695423,-1.60259235339085,-0.0877192982456141
"United States","Vermont","VT",2021-04-04,2021-04-10,7,2021,"14",623989,130,2,116,14,128,0.320518470678169,2.24362929474718,0.120689655172414
"United States","Vermont","VT",2021-04-11,2021-04-17,7,2021,"15",623989,111,11,112,-1,100,1.76285158872993,-0.160259235339084,-0.0089285714285714
"United States","Vermont","VT",2021-04-18,2021-04-24,7,2021,"16",623989,141,2,111,30,139,0.320518470678169,4.80777706017254,0.27027027027027
"United States","Vermont","VT",2021-04-25,2021-05-01,7,2021,"17",623989,139,3,110,29,136,0.480777706017254,4.64751782483345,0.263636363636364
"United States","Vermont","VT",2021-05-02,2021-05-08,7,2021,"18",623989,105,2,104,1,103,0.320518470678169,0.160259235339084,0.00961538461538458
"United States","Vermont","VT",2021-05-09,2021-05-15,7,2021,"19",623989,130,3,103,27,127,0.480777706017254,4.32699935415528,0.262135922330097
"United States","Vermont","VT",2021-05-16,2021-05-22,7,2021,"20",623989,125,3,102,23,122,0.480777706017254,3.68596241279894,0.225490196078431
"United States","Vermont","VT",2021-05-23,2021-05-29,7,2021,"21",623989,99,0,103,-4,99,0,-0.641036941356338,-0.0388349514563107
"United States","Vermont","VT",2021-05-30,2021-06-05,7,2021,"22",623989,101,1,107,-6,100,0.160259235339084,-0.961555412034507,-0.0560747663551402
"United States","Vermont","VT",2021-06-06,2021-06-12,7,2021,"23",623989,96,0,108,-12,96,0,-1.92311082406901,-0.111111111111111
"United States","Vermont","VT",2021-06-13,2021-06-19,7,2021,"24",623989,117,0,106,11,117,0,1.76285158872993,0.10377358490566
"United States","Vermont","VT",2021-06-20,2021-06-26,7,2021,"25",623989,133,0,106,27,133,0,4.32699935415528,0.254716981132076
"United States","Vermont","VT",2021-06-27,2021-07-03,7,2021,"26",623989,151,2,106,45,149,0.320518470678169,7.2116655902588,0.424528301886792
"United States","Vermont","VT",2021-07-04,2021-07-10,7,2021,"27",623989,123,0,103,20,123,0,3.20518470678169,0.194174757281553
"United States","Vermont","VT",2021-07-11,2021-07-17,7,2021,"28",623989,105,0,102,3,105,0,0.480777706017254,0.0294117647058822
"United States","Vermont","VT",2021-07-18,2021-07-24,7,2021,"29",623989,141,1,103,38,140,0.160259235339084,6.08985094288521,0.368932038834952
"United States","Vermont","VT",2021-07-25,2021-07-31,7,2021,"30",623989,115,1,105,10,114,0.160259235339084,1.60259235339085,0.0952380952380953
"United States","Vermont","VT",2021-08-01,2021-08-07,7,2021,"31",623989,135,0,104,31,135,0,4.96803629551162,0.298076923076923
"United States","Virginia","VA",2019-12-29,2020-01-04,7,2020,"1",8535519,1438,0,1512,-74,1438,0,-0.866965441703076,-0.048941798941799
"United States","Virginia","VA",2020-01-05,2020-01-11,7,2020,"2",8535519,1562,0,1515,47,1562,0,0.550640212973575,0.031023102310231
"United States","Virginia","VA",2020-01-12,2020-01-18,7,2020,"3",8535519,1466,0,1499,-33,1466,0,-0.386619724002723,-0.0220146764509673
"United States","Virginia","VA",2020-01-19,2020-01-25,7,2020,"4",8535519,1459,0,1499,-40,1459,0,-0.468629968488149,-0.0266844563042028
"United States","Virginia","VA",2020-01-26,2020-02-01,7,2020,"5",8535519,1479,0,1474,5,1479,0,0.0585787460610187,0.00339213025780194
"United States","Virginia","VA",2020-02-02,2020-02-08,7,2020,"6",8535519,1524,0,1468,56,1524,0,0.656081955883409,0.0381471389645776
"United States","Virginia","VA",2020-02-09,2020-02-15,7,2020,"7",8535519,1377,0,1460,-83,1377,0,-0.97240718461291,-0.0568493150684931
"United States","Virginia","VA",2020-02-16,2020-02-22,7,2020,"8",8535519,1444,0,1448,-4,1444,0,-0.0468629968488149,-0.00276243093922657
"United States","Virginia","VA",2020-02-23,2020-02-29,7,2020,"9",8535519,1388,0,1421,-33,1388,0,-0.386619724002723,-0.0232230823363828
"United States","Virginia","VA",2020-03-01,2020-03-07,7,2020,"10",8535519,1480,0,1422,58,1480,0,0.679513454307817,0.0407876230661042
"United States","Virginia","VA",2020-03-08,2020-03-14,7,2020,"11",8535519,1435,1,1418,17,1434,0.0117157492122037,0.199167736607463,0.0119887165021157
"United States","Virginia","VA",2020-03-15,2020-03-21,7,2020,"12",8535519,1455,1,1400,55,1454,0.0117157492122037,0.644366206671205,0.0392857142857144
"United States","Virginia","VA",2020-03-22,2020-03-28,7,2020,"13",8535519,1517,15,1387,130,1502,0.175736238183056,1.52304739758649,0.0937274693583274
"United States","Virginia","VA",2020-03-29,2020-04-04,7,2020,"14",8535519,1467,32,1376,91,1435,0.374903974790519,1.06613317831054,0.0661337209302326
"United States","Virginia","VA",2020-04-05,2020-04-11,7,2020,"15",8535519,1619,80,1357,262,1539,0.937259936976299,3.06952629359738,0.1930729550479
"United States","Virginia","VA",2020-04-12,2020-04-18,7,2020,"16",8535519,1602,128,1338,264,1474,1.49961589916208,3.09295779202179,0.197309417040359
"United States","Virginia","VA",2020-04-19,2020-04-25,7,2020,"17",8535519,1633,179,1329,304,1454,2.09711910898447,3.56158776050993,0.228743416102333
"United States","Virginia","VA",2020-04-26,2020-05-02,7,2020,"18",8535519,1669,181,1318,351,1488,2.12055060740888,4.11222797348351,0.266312594840668
"United States","Virginia","VA",2020-05-03,2020-05-09,7,2020,"19",8535519,1593,211,1297,296,1382,2.47202308377499,3.46786176681231,0.228218966846569
"United States","Virginia","VA",2020-05-10,2020-05-16,7,2020,"20",8535519,1565,174,1285,280,1391,2.03854036292345,3.28040977941705,0.217898832684825
"United States","Virginia","VA",2020-05-17,2020-05-23,7,2020,"21",8535519,1464,156,1289,175,1308,1.82765687710378,2.05025611213565,0.135764158262219
"United States","Virginia","VA",2020-05-24,2020-05-30,7,2020,"22",8535519,1443,206,1286,157,1237,2.41344433771397,1.83937262631599,0.122083981337481
"United States","Virginia","VA",2020-05-31,2020-06-06,7,2020,"23",8535519,1410,89,1281,129,1321,1.04270167988613,1.51133164837428,0.100702576112412
"United States","Virginia","VA",2020-06-07,2020-06-13,7,2020,"24",8535519,1422,83,1279,143,1339,0.97240718461291,1.67535213734513,0.111806098514464
"United States","Virginia","VA",2020-06-14,2020-06-20,7,2020,"25",8535519,1292,68,1274,18,1224,0.796670946429854,0.210883485819667,0.0141287284144427
"United States","Virginia","VA",2020-06-21,2020-06-27,7,2020,"26",8535519,1456,120,1277,179,1336,1.40588990546445,2.09711910898447,0.140172278778387
"United States","Virginia","VA",2020-06-28,2020-07-04,7,2020,"27",8535519,1394,124,1272,122,1270,1.45275290231326,1.42932140388886,0.0959119496855345
"United States","Virginia","VA",2020-07-05,2020-07-11,7,2020,"28",8535519,1488,118,1267,221,1370,1.38245840704004,2.58918057589702,0.174427782162589
"United States","Virginia","VA",2020-07-12,2020-07-18,7,2020,"29",8535519,1390,61,1264,126,1329,0.714660701944428,1.47618440073767,0.0996835443037976
"United States","Virginia","VA",2020-07-19,2020-07-25,7,2020,"30",8535519,1463,48,1263,200,1415,0.562355962185779,2.34314984244075,0.158353127474268
"United States","Virginia","VA",2020-07-26,2020-08-01,7,2020,"31",8535519,1455,140,1270,185,1315,1.64020488970852,2.16741360425769,0.145669291338583
"United States","Virginia","VA",2020-08-02,2020-08-08,7,2020,"32",8535519,1513,107,1266,247,1406,1.2535851657058,2.89379005541432,0.195102685624013
"United States","Virginia","VA",2020-08-09,2020-08-15,7,2020,"33",8535519,1457,59,1271,186,1398,0.69122920352002,2.17912935346989,0.146341463414634
"United States","Virginia","VA",2020-08-16,2020-08-22,7,2020,"34",8535519,1454,62,1275,179,1392,0.726376451156632,2.09711910898447,0.140392156862745
"United States","Virginia","VA",2020-08-23,2020-08-29,7,2020,"35",8535519,1458,125,1258,200,1333,1.46446865152547,2.34314984244075,0.158982511923688
"United States","Virginia","VA",2020-08-30,2020-09-05,7,2020,"36",8535519,1486,109,1257,229,1377,1.27701666413021,2.68290656959466,0.182179793158313
"United States","Virginia","VA",2020-09-06,2020-09-12,7,2020,"37",8535519,1469,45,1261,208,1424,0.527208714549168,2.43687583613838,0.164948453608248
"United States","Virginia","VA",2020-09-13,2020-09-19,7,2020,"38",8535519,1459,268,1265,194,1191,3.1398207888706,2.27285534716752,0.153359683794466
"United States","Virginia","VA",2020-09-20,2020-09-26,7,2020,"39",8535519,1484,154,1267,217,1330,1.80422537867937,2.54231757904821,0.171270718232044
"United States","Virginia","VA",2020-09-27,2020-10-03,7,2020,"40",8535519,1516,126,1286,230,1390,1.47618440073767,2.69462231880686,0.178849144634526
"United States","Virginia","VA",2020-10-04,2020-10-10,7,2020,"41",8535519,1478,84,1298,180,1394,0.984122933825114,2.10883485819667,0.138674884437596
"United States","Virginia","VA",2020-10-11,2020-10-17,7,2020,"42",8535519,1448,68,1307,141,1380,0.796670946429854,1.65192063892073,0.10788064269319
"United States","Virginia","VA",2020-10-18,2020-10-24,7,2020,"43",8535519,1496,156,1315,181,1340,1.82765687710378,2.12055060740888,0.137642585551331
"United States","Virginia","VA",2020-10-25,2020-10-31,7,2020,"44",8535519,1546,60,1328,218,1486,0.702944952732224,2.55403332826041,0.164156626506024
"United States","Virginia","VA",2020-11-01,2020-11-07,7,2020,"45",8535519,1652,59,1328,324,1593,0.69122920352002,3.79590274475401,0.243975903614458
"United States","Virginia","VA",2020-11-08,2020-11-14,7,2020,"46",8535519,1513,90,1333,180,1423,1.05441742909834,2.10883485819667,0.13503375843961
"United States","Virginia","VA",2020-11-15,2020-11-21,7,2020,"47",8535519,1614,120,1338,276,1494,1.40588990546445,3.23354678256823,0.20627802690583
"United States","Virginia","VA",2020-11-22,2020-11-28,7,2020,"48",8535519,1595,144,1358,237,1451,1.68706788655734,2.77663256329229,0.174521354933726
"United States","Virginia","VA",2020-11-29,2020-12-05,7,2020,"49",8535519,1629,143,1370,259,1486,1.67535213734513,3.03437904596077,0.189051094890511
"United States","Virginia","VA",2020-12-06,2020-12-12,7,2020,"50",8535519,1795,215,1385,410,1580,2.5188860806238,4.80345717700353,0.296028880866426
"United States","Virginia","VA",2020-12-13,2020-12-19,7,2020,"51",8535519,1868,233,1394,474,1635,2.72976956644347,5.55326512658457,0.340028694404591
"United States","Virginia","VA",2020-12-20,2020-12-26,7,2020,"52",8535519,1901,193,1407,494,1708,2.26113959795532,5.78758011082864,0.351101634683724
"United States","Virginia","VA",2020-12-27,2021-01-02,7,2020,"53",8535519,2016,280,1412,604,1736,3.28040977941705,7.07631252417106,0.427762039660057
"United States","Virginia","VA",2021-01-03,2021-01-09,7,2021,"1",8535519,2015,266,1426,589,1749,3.11638929044619,6.900576285988,0.41304347826087
"United States","Virginia","VA",2021-01-10,2021-01-16,7,2021,"2",8535519,2067,323,1441,626,1744,3.78418699554181,7.33405900683954,0.43442054129077
"United States","Virginia","VA",2021-01-17,2021-01-23,7,2021,"3",8535519,2123,371,1457,666,1752,4.34654295772758,7.80268897532769,0.45710363761153
"United States","Virginia","VA",2021-01-24,2021-01-30,7,2021,"4",8535519,1957,374,1470,487,1583,4.3816902053642,5.70556986634322,0.331292517006803
"United States","Virginia","VA",2021-01-31,2021-02-06,7,2021,"5",8535519,2002,325,1466,536,1677,3.80761849396621,6.2796415777412,0.365620736698499
"United States","Virginia","VA",2021-02-07,2021-02-13,7,2021,"6",8535519,1799,228,1467,332,1571,2.67119082038245,3.88962873845164,0.226312201772324
"United States","Virginia","VA",2021-02-14,2021-02-20,7,2021,"7",8535519,1738,209,1459,279,1529,2.44859158535058,3.26869403020484,0.191226867717615
"United States","Virginia","VA",2021-02-21,2021-02-27,7,2021,"8",8535519,1715,1173,1445,270,542,13.742573825915,3.16325228729501,0.186851211072664
"United States","Virginia","VA",2021-02-28,2021-03-06,7,2021,"9",8535519,1594,1140,1437,157,454,13.3559541019123,1.83937262631599,0.109255393180237
"United States","Virginia","VA",2021-03-07,2021-03-13,7,2021,"10",8535519,1554,477,1439,115,1077,5.58841237422118,1.34731115940343,0.0799166087560805
"United States","Virginia","VA",2021-03-14,2021-03-20,7,2021,"11",8535519,1528,209,1434,94,1319,2.44859158535058,1.10128042594715,0.0655509065550905
"United States","Virginia","VA",2021-03-21,2021-03-27,7,2021,"12",8535519,1535,62,1423,112,1473,0.726376451156632,1.31216391176682,0.0787069571328181
"United States","Virginia","VA",2021-03-28,2021-04-03,7,2021,"13",8535519,1371,15,1424,-53,1356,0.175736238183056,-0.620934708246798,-0.0372191011235955
"United States","Virginia","VA",2021-04-04,2021-04-10,7,2021,"14",8535519,1578,171,1412,166,1407,2.00339311528684,1.94481436922582,0.117563739376771
"United States","Virginia","VA",2021-04-11,2021-04-17,7,2021,"15",8535519,1434,106,1403,31,1328,1.2418694164936,0.363188225578316,0.0220955096222382
"United States","Virginia","VA",2021-04-18,2021-04-24,7,2021,"16",8535519,1491,111,1387,104,1380,1.30044816255461,1.21843791806919,0.0749819754866619
"United States","Virginia","VA",2021-04-25,2021-05-01,7,2021,"17",8535519,1495,102,1368,127,1393,1.19500641964478,1.48790014994987,0.0928362573099415
"United States","Virginia","VA",2021-05-02,2021-05-08,7,2021,"18",8535519,1486,108,1342,144,1378,1.265300914918,1.68706788655734,0.107302533532042
"United States","Virginia","VA",2021-05-09,2021-05-15,7,2021,"19",8535519,1471,123,1340,131,1348,1.44103715310106,1.53476314679869,0.0977611940298508
"United States","Virginia","VA",2021-05-16,2021-05-22,7,2021,"20",8535519,1399,89,1343,56,1310,1.04270167988613,0.656081955883409,0.0416976917349219
"United States","Virginia","VA",2021-05-23,2021-05-29,7,2021,"21",8535519,1433,63,1338,95,1370,0.738092200368835,1.11299617515935,0.0710014947683109
"United States","Virginia","VA",2021-05-30,2021-06-05,7,2021,"22",8535519,1429,69,1339,90,1360,0.808386695642058,1.05441742909834,0.0672143390589992
"United States","Virginia","VA",2021-06-06,2021-06-12,7,2021,"23",8535519,1391,64,1328,63,1327,0.749807949581039,0.738092200368835,0.0474397590361446
"United States","Virginia","VA",2021-06-13,2021-06-19,7,2021,"24",8535519,1343,50,1320,23,1293,0.585787460610187,0.269462231880686,0.0174242424242423
"United States","Virginia","VA",2021-06-20,2021-06-26,7,2021,"25",8535519,1386,49,1325,61,1337,0.574071711397983,0.714660701944428,0.0460377358490567
"United States","Virginia","VA",2021-06-27,2021-07-03,7,2021,"26",8535519,1451,31,1322,129,1420,0.363188225578316,1.51133164837428,0.0975794251134645
"United States","Virginia","VA",2021-07-04,2021-07-10,7,2021,"27",8535519,1397,27,1308,89,1370,0.316325228729501,1.04270167988613,0.0680428134556574
"United States","Virginia","VA",2021-07-11,2021-07-17,7,2021,"28",8535519,1446,27,1295,151,1419,0.316325228729501,1.76907813104276,0.116602316602317
"United States","Virginia","VA",2021-07-18,2021-07-24,7,2021,"29",8535519,1373,23,1303,70,1350,0.269462231880686,0.820102444854261,0.0537221795855718
"United States","Virginia","VA",2021-07-25,2021-07-31,7,2021,"30",8535519,1386,32,1304,82,1354,0.374903974790519,0.960691435400706,0.0628834355828221
"United States","Virginia","VA",2021-08-01,2021-08-07,7,2021,"31",8535519,1254,26,1299,-45,1228,0.304609479517297,-0.527208714549168,-0.0346420323325635
"United States","Washington","WA",2019-12-29,2020-01-04,7,2020,"1",7614893,1183,0,1277,-94,1183,0,-1.23442312321394,-0.0736100234925607
"United States","Washington","WA",2020-01-05,2020-01-11,7,2020,"2",7614893,1246,0,1299,-53,1246,0,-0.6960045269185,-0.0408006158583526
"United States","Washington","WA",2020-01-12,2020-01-18,7,2020,"3",7614893,1221,0,1284,-63,1221,0,-0.827326135771048,-0.0490654205607477
"United States","Washington","WA",2020-01-19,2020-01-25,7,2020,"4",7614893,1192,0,1265,-73,1192,0,-0.958647744623595,-0.0577075098814229
"United States","Washington","WA",2020-01-26,2020-02-01,7,2020,"5",7614893,1200,0,1232,-32,1200,0,-0.420229148328151,-0.025974025974026
"United States","Washington","WA",2020-02-02,2020-02-08,7,2020,"6",7614893,1180,0,1222,-42,1180,0,-0.551550757180698,-0.0343698854337152
"United States","Washington","WA",2020-02-09,2020-02-15,7,2020,"7",7614893,1179,0,1215,-36,1179,0,-0.47275779186917,-0.0296296296296297
"United States","Washington","WA",2020-02-16,2020-02-22,7,2020,"8",7614893,1115,0,1198,-83,1115,0,-1.08996935347614,-0.0692821368948247
"United States","Washington","WA",2020-02-23,2020-02-29,7,2020,"9",7614893,1135,1,1200,-65,1134,0.0131321608852547,-0.853590457541557,-0.0541666666666667
"United States","Washington","WA",2020-03-01,2020-03-07,7,2020,"10",7614893,1208,15,1216,-8,1193,0.196982413278821,-0.105057287082038,-0.00657894736842102
"United States","Washington","WA",2020-03-08,2020-03-14,7,2020,"11",7614893,1165,24,1205,-40,1141,0.315171861246113,-0.525286435410189,-0.033195020746888
"United States","Washington","WA",2020-03-15,2020-03-21,7,2020,"12",7614893,1224,53,1185,39,1171,0.6960045269185,0.512154274524934,0.0329113924050632
"United States","Washington","WA",2020-03-22,2020-03-28,7,2020,"13",7614893,1294,91,1171,123,1203,1.19502664055818,1.61525578888633,0.105038428693425
"United States","Washington","WA",2020-03-29,2020-04-04,7,2020,"14",7614893,1305,126,1157,148,1179,1.6546522715421,1.9435598110177,0.127917026793431
"United States","Washington","WA",2020-04-05,2020-04-11,7,2020,"15",7614893,1304,181,1148,156,1123,2.3769211202311,2.04861709809974,0.13588850174216
"United States","Washington","WA",2020-04-12,2020-04-18,7,2020,"16",7614893,1251,133,1125,126,1118,1.74657739773888,1.6546522715421,0.112
"United States","Washington","WA",2020-04-19,2020-04-25,7,2020,"17",7614893,1231,114,1116,115,1117,1.49706634091904,1.51019850180429,0.103046594982079
"United States","Washington","WA",2020-04-26,2020-05-02,7,2020,"18",7614893,1157,91,1099,58,1066,1.19502664055818,0.761665331344774,0.0527752502274794
"United States","Washington","WA",2020-05-03,2020-05-09,7,2020,"19",7614893,1211,91,1092,119,1120,1.19502664055818,1.56272714534531,0.108974358974359
"United States","Washington","WA",2020-05-10,2020-05-16,7,2020,"20",7614893,1138,79,1088,50,1059,1.03744070993512,0.656608044262736,0.0459558823529411
"United States","Washington","WA",2020-05-17,2020-05-23,7,2020,"21",7614893,1114,51,1090,24,1063,0.669740205147991,0.315171861246113,0.0220183486238532
"United States","Washington","WA",2020-05-24,2020-05-30,7,2020,"22",7614893,1058,68,1079,-21,990,0.892986940197321,-0.275775378590349,-0.0194624652455978
"United States","Washington","WA",2020-05-31,2020-06-06,7,2020,"23",7614893,1055,35,1072,-17,1020,0.459625630983915,-0.22324673504933,-0.0158582089552238
"United States","Washington","WA",2020-06-07,2020-06-13,7,2020,"24",7614893,1101,59,1067,34,1042,0.774797492230029,0.446493470098661,0.0318650421743205
"United States","Washington","WA",2020-06-14,2020-06-20,7,2020,"25",7614893,1133,51,1086,47,1082,0.669740205147991,0.617211561606972,0.0432780847145489
"United States","Washington","WA",2020-06-21,2020-06-27,7,2020,"26",7614893,1084,47,1084,0,1037,0.617211561606972,0,0
"United States","Washington","WA",2020-06-28,2020-07-04,7,2020,"27",7614893,1126,44,1077,49,1082,0.577815078951208,0.643475883377482,0.0454967502321262
"United States","Washington","WA",2020-07-05,2020-07-11,7,2020,"28",7614893,1162,70,1073,89,1092,0.919251261967831,1.16876231878767,0.0829450139794967
"United States","Washington","WA",2020-07-12,2020-07-18,7,2020,"29",7614893,1180,20,1079,101,1160,0.262643217705094,1.32634824941073,0.0936051899907322
"United States","Washington","WA",2020-07-19,2020-07-25,7,2020,"30",7614893,1180,50,1072,108,1130,0.656608044262736,1.41827337560751,0.100746268656716
"United States","Washington","WA",2020-07-26,2020-08-01,7,2020,"31",7614893,1229,98,1059,170,1131,1.28695176675496,2.2324673504933,0.16052880075543
"United States","Washington","WA",2020-08-02,2020-08-08,7,2020,"32",7614893,1234,80,1054,180,1154,1.05057287082038,2.36378895934585,0.170777988614801
"United States","Washington","WA",2020-08-09,2020-08-15,7,2020,"33",7614893,1174,94,1048,126,1080,1.23442312321394,1.6546522715421,0.120229007633588
"United States","Washington","WA",2020-08-16,2020-08-22,7,2020,"34",7614893,1199,91,1049,150,1108,1.19502664055818,1.96982413278821,0.142993326978074
"United States","Washington","WA",2020-08-23,2020-08-29,7,2020,"35",7614893,1118,48,1048,70,1070,0.630343722492227,0.919251261967831,0.0667938931297709
"United States","Washington","WA",2020-08-30,2020-09-05,7,2020,"36",7614893,1240,48,1045,195,1192,0.630343722492227,2.56077137262467,0.186602870813397
"United States","Washington","WA",2020-09-06,2020-09-12,7,2020,"37",7614893,1146,38,1048,98,1108,0.499022113639679,1.28695176675496,0.0935114503816794
"United States","Washington","WA",2020-09-13,2020-09-19,7,2020,"38",7614893,1178,45,1040,138,1133,0.590947239836463,1.81223820216515,0.132692307692308
"United States","Washington","WA",2020-09-20,2020-09-26,7,2020,"39",7614893,1168,62,1032,136,1106,0.814193974885793,1.78597388039464,0.131782945736434
"United States","Washington","WA",2020-09-27,2020-10-03,7,2020,"40",7614893,1143,45,1062,81,1098,0.590947239836463,1.06370503170563,0.076271186440678
"United States","Washington","WA",2020-10-04,2020-10-10,7,2020,"41",7614893,1162,47,1070,92,1115,0.617211561606972,1.20815880144343,0.0859813084112149
"United States","Washington","WA",2020-10-11,2020-10-17,7,2020,"42",7614893,1149,49,1089,60,1100,0.643475883377482,0.787929653115284,0.0550964187327823
"United States","Washington","WA",2020-10-18,2020-10-24,7,2020,"43",7614893,1195,47,1082,113,1148,0.617211561606972,1.48393418003378,0.104436229205176
"United States","Washington","WA",2020-10-25,2020-10-31,7,2020,"44",7614893,1194,79,1078,116,1115,1.03744070993512,1.52333066268955,0.107606679035251
"United States","Washington","WA",2020-11-01,2020-11-07,7,2020,"45",7614893,1274,72,1077,197,1202,0.94551558373834,2.58703569439518,0.182915506035283
"United States","Washington","WA",2020-11-08,2020-11-14,7,2020,"46",7614893,1313,77,1105,208,1236,1.01117638816461,2.73148946413298,0.188235294117647
"United States","Washington","WA",2020-11-15,2020-11-21,7,2020,"47",7614893,1325,100,1096,229,1225,1.31321608852547,3.00726484272333,0.208941605839416
"United States","Washington","WA",2020-11-22,2020-11-28,7,2020,"48",7614893,1246,81,1110,136,1165,1.06370503170563,1.78597388039464,0.122522522522523
"United States","Washington","WA",2020-11-29,2020-12-05,7,2020,"49",7614893,1354,137,1110,244,1217,1.7991060412799,3.20424725600215,0.21981981981982
"United States","Washington","WA",2020-12-06,2020-12-12,7,2020,"50",7614893,1412,47,1128,284,1365,0.617211561606972,3.72953369141234,0.25177304964539
"United States","Washington","WA",2020-12-13,2020-12-19,7,2020,"51",7614893,1381,225,1146,235,1156,2.95473619918231,3.08605780803486,0.205061082024433
"United States","Washington","WA",2020-12-20,2020-12-26,7,2020,"52",7614893,1392,27,1187,205,1365,0.354568343901878,2.69209298147722,0.172704296545914
"United States","Washington","WA",2020-12-27,2021-01-02,7,2020,"53",7614893,1348,56,1225,123,1292,0.735401009574265,1.61525578888633,0.100408163265306
"United States","Washington","WA",2021-01-03,2021-01-09,7,2021,"1",7614893,1427,447,1251,176,980,5.87007591570886,2.31126031580483,0.140687450039968
"United States","Washington","WA",2021-01-10,2021-01-16,7,2021,"2",7614893,1393,209,1266,127,1184,2.74462162501824,1.66778443242735,0.100315955766193
"United States","Washington","WA",2021-01-17,2021-01-23,7,2021,"3",7614893,1306,269,1262,44,1037,3.53255127813352,0.577815078951208,0.0348652931854199
"United States","Washington","WA",2021-01-24,2021-01-30,7,2021,"4",7614893,1330,173,1259,71,1157,2.27186383314907,0.932383422853086,0.0563939634630659
"United States","Washington","WA",2021-01-31,2021-02-06,7,2021,"5",7614893,1343,164,1255,88,1179,2.15367438518177,1.15563015790242,0.0701195219123505
"United States","Washington","WA",2021-02-07,2021-02-13,7,2021,"6",7614893,1235,226,1253,-18,1009,2.96786836006757,-0.236378895934585,-0.014365522745411
"United States","Washington","WA",2021-02-14,2021-02-20,7,2021,"7",7614893,1253,148,1256,-3,1105,1.9435598110177,-0.0393964826557642,-0.00238853503184711
"United States","Washington","WA",2021-02-21,2021-02-27,7,2021,"8",7614893,1245,134,1249,-4,1111,1.75970955862413,-0.0525286435410189,-0.00320256204963976
"United States","Washington","WA",2021-02-28,2021-03-06,7,2021,"9",7614893,1253,89,1251,2,1164,1.16876231878767,0.0262643217705094,0.00159872102318137
"United States","Washington","WA",2021-03-07,2021-03-13,7,2021,"10",7614893,1204,85,1249,-45,1119,1.11623367524665,-0.590947239836463,-0.0360288230584468
"United States","Washington","WA",2021-03-14,2021-03-20,7,2021,"11",7614893,1177,47,1248,-71,1130,0.617211561606972,-0.932383422853086,-0.0568910256410257
"United States","Washington","WA",2021-03-21,2021-03-27,7,2021,"12",7614893,1223,43,1234,-11,1180,0.564682918065953,-0.144453769737802,-0.00891410048622365
"United States","Washington","WA",2021-03-28,2021-04-03,7,2021,"13",7614893,1190,58,1223,-33,1132,0.761665331344774,-0.433361309213406,-0.0269828291087489
"United States","Washington","WA",2021-04-04,2021-04-10,7,2021,"14",7614893,1225,43,1193,32,1182,0.564682918065953,0.420229148328151,0.0268231349538977
"United States","Washington","WA",2021-04-11,2021-04-17,7,2021,"15",7614893,1205,58,1171,34,1147,0.761665331344774,0.446493470098661,0.0290350128095644
"United States","Washington","WA",2021-04-18,2021-04-24,7,2021,"16",7614893,1212,54,1161,51,1158,0.709136687803755,0.669740205147991,0.0439276485788114
"United States","Washington","WA",2021-04-25,2021-05-01,7,2021,"17",7614893,1233,65,1144,89,1168,0.853590457541557,1.16876231878767,0.0777972027972027
"United States","Washington","WA",2021-05-02,2021-05-08,7,2021,"18",7614893,1216,65,1132,84,1151,0.853590457541557,1.1031015143614,0.0742049469964665
"United States","Washington","WA",2021-05-09,2021-05-15,7,2021,"19",7614893,1193,58,1125,68,1135,0.761665331344774,0.892986940197321,0.0604444444444445
"United States","Washington","WA",2021-05-16,2021-05-22,7,2021,"20",7614893,1157,80,1119,38,1077,1.05057287082038,0.499022113639679,0.0339588918677391
"United States","Washington","WA",2021-05-23,2021-05-29,7,2021,"21",7614893,1205,63,1111,94,1142,0.827326135771048,1.23442312321394,0.0846084608460846
"United States","Washington","WA",2021-05-30,2021-06-05,7,2021,"22",7614893,1251,71,1091,160,1180,0.932383422853086,2.10114574164076,0.146654445462878
"United States","Washington","WA",2021-06-06,2021-06-12,7,2021,"23",7614893,1265,-21,1089,176,1286,-0.275775378590349,2.31126031580483,0.161616161616162
"United States","Washington","WA",2021-06-13,2021-06-19,7,2021,"24",7614893,1163,5,1098,65,1158,0.0656608044262736,0.853590457541557,0.0591985428051003
"United States","Washington","WA",2021-06-20,2021-06-26,7,2021,"25",7614893,1276,82,1111,165,1194,1.07683719259089,2.16680654606703,0.148514851485148
"United States","Washington","WA",2021-06-27,2021-07-03,7,2021,"26",7614893,1595,37,1106,489,1558,0.485889952754425,6.42162667288956,0.442133815551537
"United States","Washington","WA",2021-07-04,2021-07-10,7,2021,"27",7614893,1300,58,1106,194,1242,0.761665331344774,2.54763921173942,0.175406871609403
"United States","Washington","WA",2021-07-11,2021-07-17,7,2021,"28",7614893,1227,45,1096,131,1182,0.590947239836463,1.72031307596837,0.119525547445255
"United States","Washington","WA",2021-07-18,2021-07-24,7,2021,"29",7614893,1222,36,1097,125,1186,0.47275779186917,1.64152011065684,0.113947128532361
"United States","Washington","WA",2021-07-25,2021-07-31,7,2021,"30",7614893,1167,44,1085,82,1123,0.577815078951208,1.07683719259089,0.0755760368663594
"United States","Washington","WA",2021-08-01,2021-08-07,7,2021,"31",7614893,1067,46,1072,-5,1021,0.604079400721717,-0.0656608044262736,-0.00466417910447758
"United States","West Virginia","WV",2019-12-29,2020-01-04,7,2020,"1",1792147,474,0,512,-38,474,0,-2.12036177835858,-0.07421875
"United States","West Virginia","WV",2020-01-05,2020-01-11,7,2020,"2",1792147,494,0,517,-23,494,0,-1.28337686584862,-0.0444874274661509
"United States","West Virginia","WV",2020-01-12,2020-01-18,7,2020,"3",1792147,520,0,514,6,520,0,0.334793965003987,0.0116731517509727
"United States","West Virginia","WV",2020-01-19,2020-01-25,7,2020,"4",1792147,442,0,500,-58,442,0,-3.23634166170521,-0.116
"United States","West Virginia","WV",2020-01-26,2020-02-01,7,2020,"5",1792147,482,0,489,-7,482,0,-0.390592959171318,-0.0143149284253579
"United States","West Virginia","WV",2020-02-02,2020-02-08,7,2020,"6",1792147,482,0,488,-6,482,0,-0.334793965003987,-0.0122950819672131
"United States","West Virginia","WV",2020-02-09,2020-02-15,7,2020,"7",1792147,478,0,484,-6,478,0,-0.334793965003987,-0.012396694214876
"United States","West Virginia","WV",2020-02-16,2020-02-22,7,2020,"8",1792147,467,0,473,-6,467,0,-0.334793965003987,-0.0126849894291755
"United States","West Virginia","WV",2020-02-23,2020-02-29,7,2020,"9",1792147,460,0,470,-10,460,0,-0.557989941673311,-0.0212765957446809
"United States","West Virginia","WV",2020-03-01,2020-03-07,7,2020,"10",1792147,483,0,471,12,483,0,0.669587930007974,0.0254777070063694
"United States","West Virginia","WV",2020-03-08,2020-03-14,7,2020,"11",1792147,475,0,474,1,475,0,0.0557989941673311,0.0021097046413503
"United States","West Virginia","WV",2020-03-15,2020-03-21,7,2020,"12",1792147,470,0,476,-6,470,0,-0.334793965003987,-0.0126050420168067
"United States","West Virginia","WV",2020-03-22,2020-03-28,7,2020,"13",1792147,491,0,478,13,491,0,0.725386924175305,0.0271966527196652
"United States","West Virginia","WV",2020-03-29,2020-04-04,7,2020,"14",1792147,467,2,478,-11,465,0.111597988334662,-0.613788935840643,-0.0230125523012552
"United States","West Virginia","WV",2020-04-05,2020-04-11,7,2020,"15",1792147,523,4,465,58,519,0.223195976669325,3.23634166170521,0.124731182795699
"United States","West Virginia","WV",2020-04-12,2020-04-18,7,2020,"16",1792147,419,12,459,-40,407,0.669587930007974,-2.23195976669325,-0.0871459694989106
"United States","West Virginia","WV",2020-04-19,2020-04-25,7,2020,"17",1792147,460,15,448,12,445,0.836984912509967,0.669587930007974,0.0267857142857142
"United States","West Virginia","WV",2020-04-26,2020-05-02,7,2020,"18",1792147,482,16,441,41,466,0.892783906677298,2.28775876086058,0.0929705215419501
"United States","West Virginia","WV",2020-05-03,2020-05-09,7,2020,"19",1792147,449,3,429,20,446,0.167396982501993,1.11597988334662,0.0466200466200466
"United States","West Virginia","WV",2020-05-10,2020-05-16,7,2020,"20",1792147,477,12,424,53,465,0.669587930007974,2.95734669086855,0.125
"United States","West Virginia","WV",2020-05-17,2020-05-23,7,2020,"21",1792147,440,7,425,15,433,0.390592959171318,0.836984912509967,0.0352941176470589
"United States","West Virginia","WV",2020-05-24,2020-05-30,7,2020,"22",1792147,412,2,425,-13,410,0.111597988334662,-0.725386924175305,-0.0305882352941177
"United States","West Virginia","WV",2020-05-31,2020-06-06,7,2020,"23",1792147,409,11,421,-12,398,0.613788935840643,-0.669587930007974,-0.0285035629453682
"United States","West Virginia","WV",2020-06-07,2020-06-13,7,2020,"24",1792147,458,4,423,35,454,0.223195976669325,1.95296479585659,0.08274231678487
"United States","West Virginia","WV",2020-06-14,2020-06-20,7,2020,"25",1792147,419,0,420,-1,419,0,-0.0557989941673311,-0.00238095238095237
"United States","West Virginia","WV",2020-06-21,2020-06-27,7,2020,"26",1792147,464,5,425,39,459,0.278994970836656,2.17616077252591,0.091764705882353
"United States","West Virginia","WV",2020-06-28,2020-07-04,7,2020,"27",1792147,425,1,422,3,424,0.0557989941673311,0.167396982501993,0.00710900473933651
"United States","West Virginia","WV",2020-07-05,2020-07-11,7,2020,"28",1792147,436,2,421,15,434,0.111597988334662,0.836984912509967,0.0356294536817101
"United States","West Virginia","WV",2020-07-12,2020-07-18,7,2020,"29",1792147,426,4,416,10,422,0.223195976669325,0.557989941673311,0.0240384615384615
"United States","West Virginia","WV",2020-07-19,2020-07-25,7,2020,"30",1792147,501,3,406,95,498,0.167396982501993,5.30090444589646,0.233990147783251
"United States","West Virginia","WV",2020-07-26,2020-08-01,7,2020,"31",1792147,474,13,402,72,461,0.725386924175305,4.01752758004784,0.17910447761194
"United States","West Virginia","WV",2020-08-02,2020-08-08,7,2020,"32",1792147,494,15,402,92,479,0.836984912509967,5.13350746339446,0.228855721393035
"United States","West Virginia","WV",2020-08-09,2020-08-15,7,2020,"33",1792147,462,29,404,58,433,1.6181708308526,3.23634166170521,0.143564356435643
"United States","West Virginia","WV",2020-08-16,2020-08-22,7,2020,"34",1792147,497,16,409,88,481,0.892783906677298,4.91031148672514,0.215158924205379
"United States","West Virginia","WV",2020-08-23,2020-08-29,7,2020,"35",1792147,442,36,413,29,406,2.00876379002392,1.6181708308526,0.0702179176755449
"United States","West Virginia","WV",2020-08-30,2020-09-05,7,2020,"36",1792147,460,31,418,42,429,1.72976881918727,2.34355775502791,0.100478468899522
"United States","West Virginia","WV",2020-09-06,2020-09-12,7,2020,"37",1792147,468,22,420,48,446,1.22757787168129,2.67835172003189,0.114285714285714
"United States","West Virginia","WV",2020-09-13,2020-09-19,7,2020,"38",1792147,484,43,419,65,441,2.39935674919524,3.62693462087652,0.155131264916468
"United States","West Virginia","WV",2020-09-20,2020-09-26,7,2020,"39",1792147,495,24,422,73,471,1.33917586001595,4.07332657421517,0.172985781990521
"United States","West Virginia","WV",2020-09-27,2020-10-03,7,2020,"40",1792147,424,25,423,1,399,1.39497485418328,0.0557989941673311,0.00236406619385332
"United States","West Virginia","WV",2020-10-04,2020-10-10,7,2020,"41",1792147,500,24,429,71,476,1.33917586001595,3.96172858588051,0.165501165501166
"United States","West Virginia","WV",2020-10-11,2020-10-17,7,2020,"42",1792147,455,18,434,21,437,1.00438189501196,1.17177887751395,0.0483870967741935
"United States","West Virginia","WV",2020-10-18,2020-10-24,7,2020,"43",1792147,471,23,441,30,448,1.28337686584862,1.67396982501993,0.0680272108843538
"United States","West Virginia","WV",2020-10-25,2020-10-31,7,2020,"44",1792147,485,31,442,43,454,1.72976881918727,2.39935674919524,0.0972850678733033
"United States","West Virginia","WV",2020-11-01,2020-11-07,7,2020,"45",1792147,531,48,442,89,483,2.67835172003189,4.96611048089247,0.201357466063348
"United States","West Virginia","WV",2020-11-08,2020-11-14,7,2020,"46",1792147,554,72,442,112,482,4.01752758004784,6.24948734674109,0.253393665158371
"United States","West Virginia","WV",2020-11-15,2020-11-21,7,2020,"47",1792147,524,65,443,81,459,3.62693462087652,4.51971852755382,0.182844243792325
"United States","West Virginia","WV",2020-11-22,2020-11-28,7,2020,"48",1792147,570,80,448,122,490,4.46391953338649,6.8074772884144,0.272321428571429
"United States","West Virginia","WV",2020-11-29,2020-12-05,7,2020,"49",1792147,637,111,452,185,526,6.19368835257376,10.3228139209563,0.40929203539823
"United States","West Virginia","WV",2020-12-06,2020-12-12,7,2020,"50",1792147,647,137,455,192,510,7.64446220092437,10.7134068801276,0.421978021978022
"United States","West Virginia","WV",2020-12-13,2020-12-19,7,2020,"51",1792147,695,156,464,231,539,8.70464309010366,12.8895676526535,0.497844827586207
"United States","West Virginia","WV",2020-12-20,2020-12-26,7,2020,"52",1792147,669,6,471,198,663,0.334793965003987,11.0482008451316,0.420382165605095
"United States","West Virginia","WV",2020-12-27,2021-01-02,7,2020,"53",1792147,729,245,480,249,484,13.6707535709961,13.8939495476655,0.51875
"United States","West Virginia","WV",2021-01-03,2021-01-09,7,2021,"1",1792147,719,197,488,231,522,10.9924018509642,12.8895676526535,0.473360655737705
"United States","West Virginia","WV",2021-01-10,2021-01-16,7,2021,"2",1792147,679,191,489,190,488,10.6576078859602,10.6018088917929,0.388548057259714
"United States","West Virginia","WV",2021-01-17,2021-01-23,7,2021,"3",1792147,607,111,487,120,496,6.19368835257376,6.69587930007974,0.246406570841889
"United States","West Virginia","WV",2021-01-24,2021-01-30,7,2021,"4",1792147,622,143,488,134,479,7.97925616592835,7.47706521842237,0.274590163934426
"United States","West Virginia","WV",2021-01-31,2021-02-06,7,2021,"5",1792147,586,104,479,107,482,5.80309539340244,5.97049237590443,0.223382045929019
"United States","West Virginia","WV",2021-02-07,2021-02-13,7,2021,"6",1792147,574,80,471,103,494,4.46391953338649,5.74729639923511,0.218683651804671
"United States","West Virginia","WV",2021-02-14,2021-02-20,7,2021,"7",1792147,511,17,468,43,494,0.948582900844629,2.39935674919524,0.0918803418803418
"United States","West Virginia","WV",2021-02-21,2021-02-27,7,2021,"8",1792147,493,75,466,27,418,4.18492456254984,1.50657284251794,0.0579399141630901
"United States","West Virginia","WV",2021-02-28,2021-03-06,7,2021,"9",1792147,509,27,464,45,482,1.50657284251794,2.5109547375299,0.0969827586206897
"United States","West Virginia","WV",2021-03-07,2021-03-13,7,2021,"10",1792147,489,212,473,16,277,11.8293867634742,0.892783906677298,0.0338266384778012
"United States","West Virginia","WV",2021-03-14,2021-03-20,7,2021,"11",1792147,505,75,475,30,430,4.18492456254984,1.67396982501993,0.0631578947368421
"United States","West Virginia","WV",2021-03-21,2021-03-27,7,2021,"12",1792147,516,34,478,38,482,1.89716580168926,2.12036177835858,0.0794979079497908
"United States","West Virginia","WV",2021-03-28,2021-04-03,7,2021,"13",1792147,477,59,480,-3,418,3.29214065587254,-0.167396982501993,-0.00624999999999998
"United States","West Virginia","WV",2021-04-04,2021-04-10,7,2021,"14",1792147,484,39,476,8,445,2.17616077252591,0.446391953338649,0.0168067226890756
"United States","West Virginia","WV",2021-04-11,2021-04-17,7,2021,"15",1792147,504,43,462,42,461,2.39935674919524,2.34355775502791,0.0909090909090908
"United States","West Virginia","WV",2021-04-18,2021-04-24,7,2021,"16",1792147,467,37,454,13,430,2.06456278419125,0.725386924175305,0.0286343612334801
"United States","West Virginia","WV",2021-04-25,2021-05-01,7,2021,"17",1792147,514,-138,446,68,652,-7.7002611950917,3.79433160337852,0.152466367713004
"United States","West Virginia","WV",2021-05-02,2021-05-08,7,2021,"18",1792147,487,47,442,45,440,2.62255272586456,2.5109547375299,0.101809954751131
"United States","West Virginia","WV",2021-05-09,2021-05-15,7,2021,"19",1792147,477,31,440,37,446,1.72976881918727,2.06456278419125,0.084090909090909
"United States","West Virginia","WV",2021-05-16,2021-05-22,7,2021,"20",1792147,460,15,438,22,445,0.836984912509967,1.22757787168129,0.0502283105022832
"United States","West Virginia","WV",2021-05-23,2021-05-29,7,2021,"21",1792147,446,20,432,14,426,1.11597988334662,0.781185918342636,0.0324074074074074
"United States","West Virginia","WV",2021-05-30,2021-06-05,7,2021,"22",1792147,479,21,432,47,458,1.17177887751395,2.62255272586456,0.108796296296296
"United States","West Virginia","WV",2021-06-06,2021-06-12,7,2021,"23",1792147,446,36,431,15,410,2.00876379002392,0.836984912509967,0.0348027842227379
"United States","West Virginia","WV",2021-06-13,2021-06-19,7,2021,"24",1792147,463,14,428,35,449,0.781185918342636,1.95296479585659,0.0817757009345794
"United States","West Virginia","WV",2021-06-20,2021-06-26,7,2021,"25",1792147,404,13,427,-23,391,0.725386924175305,-1.28337686584862,-0.0538641686182669
"United States","West Virginia","WV",2021-06-27,2021-07-03,7,2021,"26",1792147,420,23,416,4,397,1.28337686584862,0.223195976669325,0.00961538461538458
"United States","Wisconsin","WI",2019-12-29,2020-01-04,7,2020,"1",5822434,1118,0,1170,-52,1118,0,-0.893097285430801,-0.0444444444444444
"United States","Wisconsin","WI",2020-01-05,2020-01-11,7,2020,"2",5822434,1060,0,1179,-119,1060,0,-2.04381878781279,-0.100932994062765
"United States","Wisconsin","WI",2020-01-12,2020-01-18,7,2020,"3",5822434,1133,0,1181,-48,1133,0,-0.824397494243816,-0.0406435224386114
"United States","Wisconsin","WI",2020-01-19,2020-01-25,7,2020,"4",5822434,1086,0,1169,-83,1086,0,-1.42552066712993,-0.0710008554319932
"United States","Wisconsin","WI",2020-01-26,2020-02-01,7,2020,"5",5822434,1176,0,1153,23,1176,0,0.395023799325162,0.0199479618386817
"United States","Wisconsin","WI",2020-02-02,2020-02-08,7,2020,"6",5822434,1056,0,1147,-91,1056,0,-1.5629202495039,-0.0793374019180471
"United States","Wisconsin","WI",2020-02-09,2020-02-15,7,2020,"7",5822434,1125,0,1128,-3,1125,0,-0.0515248433902385,-0.00265957446808507
"United States","Wisconsin","WI",2020-02-16,2020-02-22,7,2020,"8",5822434,1162,0,1123,39,1162,0,0.669822964073101,0.0347284060552093
"United States","Wisconsin","WI",2020-02-23,2020-02-29,7,2020,"9",5822434,1136,0,1103,33,1136,0,0.566773277292624,0.029918404351768
"United States","Wisconsin","WI",2020-03-01,2020-03-07,7,2020,"10",5822434,1116,0,1109,7,1116,0,0.120224634577223,0.00631199278629402
"United States","Wisconsin","WI",2020-03-08,2020-03-14,7,2020,"11",5822434,1105,0,1113,-8,1105,0,-0.137399582373969,-0.00718778077268645
"United States","Wisconsin","WI",2020-03-15,2020-03-21,7,2020,"12",5822434,1115,4,1115,0,1111,0.0686997911869847,0,0
"United States","Wisconsin","WI",2020-03-22,2020-03-28,7,2020,"13",5822434,1146,9,1118,28,1137,0.154574530170716,0.480898538308893,0.0250447227191413
"United States","Wisconsin","WI",2020-03-29,2020-04-04,7,2020,"14",5822434,1221,43,1121,100,1178,0.738522755260085,1.71749477967462,0.0892060660124889
"United States","Wisconsin","WI",2020-04-05,2020-04-11,7,2020,"15",5822434,1171,81,1098,73,1090,1.39117077153644,1.25377118916247,0.0664845173041895
"United States","Wisconsin","WI",2020-04-12,2020-04-18,7,2020,"16",5822434,1152,74,1087,65,1078,1.27094613695922,1.1163716067885,0.0597976080956761
"United States","Wisconsin","WI",2020-04-19,2020-04-25,7,2020,"17",5822434,1026,55,1086,-60,971,0.944622128821039,-1.03049686780477,-0.0552486187845304
"United States","Wisconsin","WI",2020-04-26,2020-05-02,7,2020,"18",5822434,1162,68,1063,99,1094,1.16789645017874,1.70031983187787,0.0931326434619002
"United States","Wisconsin","WI",2020-05-03,2020-05-09,7,2020,"19",5822434,1080,64,1044,36,1016,1.09919665899176,0.618298120682862,0.0344827586206897
"United States","Wisconsin","WI",2020-05-10,2020-05-16,7,2020,"20",5822434,1022,54,1039,-17,968,0.927447181024293,-0.291974112544685,-0.016361886429259
"United States","Wisconsin","WI",2020-05-17,2020-05-23,7,2020,"21",5822434,1078,55,1031,47,1023,0.944622128821039,0.80722254644707,0.0455868089233753
"United States","Wisconsin","WI",2020-05-24,2020-05-30,7,2020,"22",5822434,1139,81,1021,118,1058,1.39117077153644,2.02664384001605,0.115572967678746
"United States","Wisconsin","WI",2020-05-31,2020-06-06,7,2020,"23",5822434,1043,57,1010,33,986,0.978972024414532,0.566773277292624,0.0326732673267327
"United States","Wisconsin","WI",2020-06-07,2020-06-13,7,2020,"24",5822434,1026,46,1003,23,980,0.790047598650324,0.395023799325162,0.0229312063808573
"United States","Wisconsin","WI",2020-06-14,2020-06-20,7,2020,"25",5822434,1085,52,1007,78,1033,0.893097285430801,1.3396459281462,0.0774577954319762
"United States","Wisconsin","WI",2020-06-21,2020-06-27,7,2020,"26",5822434,1034,34,1017,17,1000,0.58394822508937,0.291974112544685,0.016715830875123
"United States","Wisconsin","WI",2020-06-28,2020-07-04,7,2020,"27",5822434,1066,19,1015,51,1047,0.326324008138177,0.875922337634055,0.0502463054187192
"United States","Wisconsin","WI",2020-07-05,2020-07-11,7,2020,"28",5822434,1049,25,1009,40,1024,0.429373694918654,0.686997911869847,0.0396432111000991
"United States","Wisconsin","WI",2020-07-12,2020-07-18,7,2020,"29",5822434,1039,22,1007,32,1017,0.377848851528416,0.549598329495878,0.0317775571002978
"United States","Wisconsin","WI",2020-07-19,2020-07-25,7,2020,"30",5822434,1101,48,1001,100,1053,0.824397494243816,1.71749477967462,0.0999000999000998
"United States","Wisconsin","WI",2020-07-26,2020-08-01,7,2020,"31",5822434,1057,56,994,63,1001,0.961797076617786,1.08202171119501,0.0633802816901408
"United States","Wisconsin","WI",2020-08-02,2020-08-08,7,2020,"32",5822434,1099,49,1002,97,1050,0.841572442040562,1.66596993628438,0.0968063872255489
"United States","Wisconsin","WI",2020-08-09,2020-08-15,7,2020,"33",5822434,1126,42,1001,125,1084,0.721347807463339,2.14686847459327,0.124875124875125
"United States","Wisconsin","WI",2020-08-16,2020-08-22,7,2020,"34",5822434,1061,43,988,73,1018,0.738522755260085,1.25377118916247,0.0738866396761133
"United States","Wisconsin","WI",2020-08-23,2020-08-29,7,2020,"35",5822434,1082,38,995,87,1044,0.652648016276354,1.49422045831692,0.0874371859296483
"United States","Wisconsin","WI",2020-08-30,2020-09-05,7,2020,"36",5822434,1039,49,1000,39,990,0.841572442040562,0.669822964073101,0.0389999999999999
"United States","Wisconsin","WI",2020-09-06,2020-09-12,7,2020,"37",5822434,1066,41,999,67,1025,0.704172859666593,1.15072150238199,0.067067067067067
"United States","Wisconsin","WI",2020-09-13,2020-09-19,7,2020,"38",5822434,1140,32,998,142,1108,0.549598329495878,2.43884258713796,0.142284569138277
"United States","Wisconsin","WI",2020-09-20,2020-09-26,7,2020,"39",5822434,1102,40,1014,88,1062,0.686997911869847,1.51139540611366,0.0867850098619329
"United States","Wisconsin","WI",2020-09-27,2020-10-03,7,2020,"40",5822434,1157,91,1016,141,1066,1.5629202495039,2.42166763934121,0.138779527559055
"United States","Wisconsin","WI",2020-10-04,2020-10-10,7,2020,"41",5822434,1163,86,1024,139,1077,1.47704551052017,2.38731774374772,0.1357421875
"United States","Wisconsin","WI",2020-10-11,2020-10-17,7,2020,"42",5822434,1244,116,1025,219,1128,1.99229394442256,3.76131356748741,0.213658536585366
"United States","Wisconsin","WI",2020-10-18,2020-10-24,7,2020,"43",5822434,1387,196,1026,361,1191,3.36628976816225,6.20015615462537,0.351851851851852
"United States","Wisconsin","WI",2020-10-25,2020-10-31,7,2020,"44",5822434,1454,259,1042,412,1195,4.44831147935726,7.07607849225942,0.395393474088292
"United States","Wisconsin","WI",2020-11-01,2020-11-07,7,2020,"45",5822434,1601,272,1047,554,1329,4.67158580071496,9.51492107939738,0.529130850047755
"United States","Wisconsin","WI",2020-11-08,2020-11-14,7,2020,"46",5822434,1716,323,1045,671,1393,5.54750813834901,11.5243899716167,0.642105263157895
"United States","Wisconsin","WI",2020-11-15,2020-11-21,7,2020,"47",5822434,1657,327,1030,627,1330,5.616207929536,10.7686922685598,0.60873786407767
"United States","Wisconsin","WI",2020-11-22,2020-11-28,7,2020,"48",5822434,1636,333,1040,596,1303,5.71925761631648,10.2362688868607,0.573076923076923
"United States","Wisconsin","WI",2020-11-29,2020-12-05,7,2020,"49",5822434,1652,415,1040,612,1237,7.12760333564966,10.5110680516087,0.588461538461538
"United States","Wisconsin","WI",2020-12-06,2020-12-12,7,2020,"50",5822434,1569,340,1042,527,1229,5.8394822508937,9.05119748888523,0.505758157389635
"United States","Wisconsin","WI",2020-12-13,2020-12-19,7,2020,"51",5822434,1500,360,1059,441,1140,6.18298120682862,7.57415197836506,0.41643059490085
"United States","Wisconsin","WI",2020-12-20,2020-12-26,7,2020,"52",5822434,1404,283,1074,330,1121,4.86051022647917,5.66773277292624,0.307262569832402
"United States","Wisconsin","WI",2020-12-27,2021-01-02,7,2020,"53",5822434,1403,187,1089,314,1216,3.21171523799153,5.3929336081783,0.288337924701561
"United States","Wisconsin","WI",2021-01-03,2021-01-09,7,2021,"1",5822434,1378,286,1100,278,1092,4.91203506986941,4.77463548749544,0.252727272727273
"United States","Wisconsin","WI",2021-01-10,2021-01-16,7,2021,"2",5822434,1257,294,1134,123,963,5.04943465224337,2.11251857899978,0.108465608465608
"United States","Wisconsin","WI",2021-01-17,2021-01-23,7,2021,"3",5822434,1276,235,1130,146,1041,4.03611273223535,2.50754237832494,0.129203539823009
"United States","Wisconsin","WI",2021-01-24,2021-01-30,7,2021,"4",5822434,1190,208,1135,55,982,3.5723891417232,0.944622128821039,0.0484581497797356
"United States","Wisconsin","WI",2021-01-31,2021-02-06,7,2021,"5",5822434,1157,162,1119,38,995,2.78234154307288,0.652648016276354,0.0339588918677391
"United States","Wisconsin","WI",2021-02-07,2021-02-13,7,2021,"6",5822434,1144,110,1105,39,1034,1.88924425764208,0.669822964073101,0.0352941176470589
"United States","Wisconsin","WI",2021-02-14,2021-02-20,7,2021,"7",5822434,1125,121,1085,40,1004,2.07816868340629,0.686997911869847,0.0368663594470047
"United States","Wisconsin","WI",2021-02-21,2021-02-27,7,2021,"8",5822434,1110,130,1076,34,980,2.232743213577,0.58394822508937,0.0315985130111525
"United States","Wisconsin","WI",2021-02-28,2021-03-06,7,2021,"9",5822434,1080,71,1067,13,1009,1.21942129356898,0.2232743213577,0.0121836925960637
"United States","Wisconsin","WI",2021-03-07,2021-03-13,7,2021,"10",5822434,1060,65,1070,-10,995,1.1163716067885,-0.171749477967462,-0.00934579439252337
"United States","Wisconsin","WI",2021-03-14,2021-03-20,7,2021,"11",5822434,1000,55,1076,-76,945,0.944622128821039,-1.30529603255271,-0.0706319702602231
"United States","Wisconsin","WI",2021-03-21,2021-03-27,7,2021,"12",5822434,1032,29,1071,-39,1003,0.498073486105639,-0.669822964073101,-0.0364145658263305
"United States","Wisconsin","WI",2021-03-28,2021-04-03,7,2021,"13",5822434,985,5,1066,-81,980,0.0858747389837309,-1.39117077153644,-0.075984990619137
"United States","Wisconsin","WI",2021-04-04,2021-04-10,7,2021,"14",5822434,1068,36,1065,3,1032,0.618298120682862,0.0515248433902385,0.0028169014084507
"United States","Wisconsin","WI",2021-04-11,2021-04-17,7,2021,"15",5822434,990,35,1052,-62,955,0.601123172886116,-1.06484676339826,-0.05893536121673
"United States","Wisconsin","WI",2021-04-18,2021-04-24,7,2021,"16",5822434,1077,46,1048,29,1031,0.790047598650324,0.498073486105639,0.0276717557251909
"United States","Wisconsin","WI",2021-04-25,2021-05-01,7,2021,"17",5822434,1027,84,1048,-21,943,1.44269561492668,-0.36067390373167,-0.0200381679389313
"United States","Wisconsin","WI",2021-05-02,2021-05-08,7,2021,"18",5822434,1030,63,1041,-11,967,1.08202171119501,-0.188924425764208,-0.0105667627281461
"United States","Wisconsin","WI",2021-05-09,2021-05-15,7,2021,"19",5822434,1006,54,1030,-24,952,0.927447181024293,-0.412198747121908,-0.0233009708737864
"United States","Wisconsin","WI",2021-05-16,2021-05-22,7,2021,"20",5822434,1030,31,1025,5,999,0.532423381699131,0.0858747389837309,0.00487804878048781
"United States","Wisconsin","WI",2021-05-23,2021-05-29,7,2021,"21",5822434,1020,64,999,21,956,1.09919665899176,0.36067390373167,0.0210210210210211
"United States","Wisconsin","WI",2021-05-30,2021-06-05,7,2021,"22",5822434,1047,97,988,59,950,1.66596993628438,1.01332192000802,0.0597165991902835
"United States","Wisconsin","WI",2021-06-06,2021-06-12,7,2021,"23",5822434,1055,56,984,71,999,0.961797076617786,1.21942129356898,0.0721544715447155
"United States","Wisconsin","WI",2021-06-13,2021-06-19,7,2021,"24",5822434,1036,29,992,44,1007,0.498073486105639,0.755697703056832,0.0443548387096775
"United States","Wisconsin","WI",2021-06-20,2021-06-26,7,2021,"25",5822434,953,45,1000,-47,908,0.772872650853578,-0.80722254644707,-0.047
"United States","Wisconsin","WI",2021-06-27,2021-07-03,7,2021,"26",5822434,1073,35,1009,64,1038,0.601123172886116,1.09919665899176,0.0634291377601586
"United States","Wisconsin","WI",2021-07-04,2021-07-10,7,2021,"27",5822434,995,41,1010,-15,954,0.704172859666593,-0.257624216951193,-0.0148514851485149
"United States","Wisconsin","WI",2021-07-11,2021-07-17,7,2021,"28",5822434,960,10,1010,-50,950,0.171749477967462,-0.858747389837309,-0.0495049504950495
"United States","Wisconsin","WI",2021-07-18,2021-07-24,7,2021,"29",5822434,1061,32,1015,46,1029,0.549598329495878,0.790047598650324,0.0453201970443349
"United States","Wisconsin","WI",2021-07-25,2021-07-31,7,2021,"30",5822434,1047,41,1019,28,1006,0.704172859666593,0.480898538308893,0.0274779195289498
"United States","Wisconsin","WI",2021-08-01,2021-08-07,7,2021,"31",5822434,915,9,1004,-89,906,0.154574530170716,-1.52857035391041,-0.0886454183266933
"United States","Wyoming","WY",2019-12-29,2020-01-04,7,2020,"1",578759,144,0,93,51,144,0,8.8119579997892,0.548387096774194
"United States","Wyoming","WY",2020-01-05,2020-01-11,7,2020,"2",578759,81,0,94,-13,81,0,-2.24618537249529,-0.138297872340426
"United States","Wyoming","WY",2020-01-12,2020-01-18,7,2020,"3",578759,103,0,95,8,103,0,1.38226792153556,0.0842105263157895
"United States","Wyoming","WY",2020-01-19,2020-01-25,7,2020,"4",578759,96,0,95,1,96,0,0.172783490191945,0.0105263157894737
"United States","Wyoming","WY",2020-01-26,2020-02-01,7,2020,"5",578759,94,0,96,-2,94,0,-0.34556698038389,-0.0208333333333334
"United States","Wyoming","WY",2020-02-02,2020-02-08,7,2020,"6",578759,97,0,94,3,97,0,0.518350470575835,0.0319148936170213
"United States","Wyoming","WY",2020-02-09,2020-02-15,7,2020,"7",578759,75,0,94,-19,75,0,-3.28288631364696,-0.202127659574468
"United States","Wyoming","WY",2020-02-16,2020-02-22,7,2020,"8",578759,101,0,93,8,101,0,1.38226792153556,0.086021505376344
"United States","Wyoming","WY",2020-02-23,2020-02-29,7,2020,"9",578759,100,0,92,8,100,0,1.38226792153556,0.0869565217391304
"United States","Wyoming","WY",2020-03-01,2020-03-07,7,2020,"10",578759,80,0,92,-12,80,0,-2.07340188230334,-0.130434782608696
"United States","Wyoming","WY",2020-03-08,2020-03-14,7,2020,"11",578759,85,0,94,-9,85,0,-1.55505141172751,-0.0957446808510638
"United States","Wyoming","WY",2020-03-15,2020-03-21,7,2020,"12",578759,117,0,95,22,117,0,3.80123678422279,0.231578947368421
"United States","Wyoming","WY",2020-03-22,2020-03-28,7,2020,"13",578759,88,0,92,-4,88,0,-0.691133960767781,-0.0434782608695652
"United States","Wyoming","WY",2020-03-29,2020-04-04,7,2020,"14",578759,123,0,93,30,123,0,5.18350470575835,0.32258064516129
"United States","Wyoming","WY",2020-04-05,2020-04-11,7,2020,"15",578759,102,0,91,11,102,0,1.9006183921114,0.120879120879121
"United States","Wyoming","WY",2020-04-12,2020-04-18,7,2020,"16",578759,89,2,88,1,87,0.34556698038389,0.172783490191945,0.0113636363636365
"United States","Wyoming","WY",2020-04-19,2020-04-25,7,2020,"17",578759,98,5,87,11,93,0.863917450959726,1.9006183921114,0.126436781609195
"United States","Wyoming","WY",2020-04-26,2020-05-02,7,2020,"18",578759,68,0,88,-20,68,0,-3.4556698038389,-0.227272727272727
"United States","Wyoming","WY",2020-05-03,2020-05-09,7,2020,"19",578759,83,0,91,-8,83,0,-1.38226792153556,-0.0879120879120879
"United States","Wyoming","WY",2020-05-10,2020-05-16,7,2020,"20",578759,101,0,90,11,101,0,1.9006183921114,0.122222222222222
"United States","Wyoming","WY",2020-05-17,2020-05-23,7,2020,"21",578759,96,5,91,5,91,0.863917450959726,0.863917450959726,0.054945054945055
"United States","Wyoming","WY",2020-05-24,2020-05-30,7,2020,"22",578759,84,3,88,-4,81,0.518350470575835,-0.691133960767781,-0.0454545454545454
"United States","Wyoming","WY",2020-05-31,2020-06-06,7,2020,"23",578759,105,2,89,16,103,0.34556698038389,2.76453584307112,0.179775280898876
"United States","Wyoming","WY",2020-06-07,2020-06-13,7,2020,"24",578759,96,1,89,7,95,0.172783490191945,1.20948443134362,0.0786516853932584
"United States","Wyoming","WY",2020-06-14,2020-06-20,7,2020,"25",578759,93,2,90,3,91,0.34556698038389,0.518350470575835,0.0333333333333334
"United States","Wyoming","WY",2020-06-21,2020-06-27,7,2020,"26",578759,89,0,92,-3,89,0,-0.518350470575835,-0.0326086956521739
"United States","Wyoming","WY",2020-06-28,2020-07-04,7,2020,"27",578759,102,0,94,8,102,0,1.38226792153556,0.0851063829787233
"United States","Wyoming","WY",2020-07-05,2020-07-11,7,2020,"28",578759,104,1,95,9,103,0.172783490191945,1.55505141172751,0.0947368421052632
"United States","Wyoming","WY",2020-07-12,2020-07-18,7,2020,"29",578759,101,3,95,6,98,0.518350470575835,1.03670094115167,0.0631578947368421
"United States","Wyoming","WY",2020-07-19,2020-07-25,7,2020,"30",578759,95,1,97,-2,94,0.172783490191945,-0.34556698038389,-0.020618556701031
"United States","Wyoming","WY",2020-07-26,2020-08-01,7,2020,"31",578759,90,0,97,-7,90,0,-1.20948443134362,-0.0721649484536082
"United States","Wyoming","WY",2020-08-02,2020-08-08,7,2020,"32",578759,106,2,98,8,104,0.34556698038389,1.38226792153556,0.0816326530612246
"United States","Wyoming","WY",2020-08-09,2020-08-15,7,2020,"33",578759,113,1,98,15,112,0.172783490191945,2.59175235287918,0.153061224489796
"United States","Wyoming","WY",2020-08-16,2020-08-22,7,2020,"34",578759,100,9,100,0,91,1.55505141172751,0,0
"United States","Wyoming","WY",2020-08-23,2020-08-29,7,2020,"35",578759,89,0,101,-12,89,0,-2.07340188230334,-0.118811881188119
"United States","Wyoming","WY",2020-08-30,2020-09-05,7,2020,"36",578759,107,5,98,9,102,0.863917450959726,1.55505141172751,0.0918367346938775
"United States","Wyoming","WY",2020-09-06,2020-09-12,7,2020,"37",578759,121,0,96,25,121,0,4.31958725479863,0.260416666666667
"United States","Wyoming","WY",2020-09-13,2020-09-19,7,2020,"38",578759,94,7,96,-2,87,1.20948443134362,-0.34556698038389,-0.0208333333333334
"United States","Wyoming","WY",2020-09-20,2020-09-26,7,2020,"39",578759,112,1,92,20,111,0.172783490191945,3.4556698038389,0.217391304347826
"United States","Wyoming","WY",2020-09-27,2020-10-03,7,2020,"40",578759,119,3,95,24,116,0.518350470575835,4.14680376460668,0.252631578947368
"United States","Wyoming","WY",2020-10-04,2020-10-10,7,2020,"41",578759,102,0,96,6,102,0,1.03670094115167,0.0625
"United States","Wyoming","WY",2020-10-11,2020-10-17,7,2020,"42",578759,107,4,96,11,103,0.691133960767781,1.9006183921114,0.114583333333333
"United States","Wyoming","WY",2020-10-18,2020-10-24,7,2020,"43",578759,131,11,96,35,120,1.9006183921114,6.04742215671808,0.364583333333333
"United States","Wyoming","WY",2020-10-25,2020-10-31,7,2020,"44",578759,114,19,98,16,95,3.28288631364696,2.76453584307112,0.163265306122449
"United States","Wyoming","WY",2020-11-01,2020-11-07,7,2020,"45",578759,136,17,97,39,119,2.93731933326307,6.73855611748586,0.402061855670103
"United States","Wyoming","WY",2020-11-08,2020-11-14,7,2020,"46",578759,132,19,100,32,113,3.28288631364696,5.52907168614225,0.32
"United States","Wyoming","WY",2020-11-15,2020-11-21,7,2020,"47",578759,135,41,101,34,94,7.08412309786975,5.87463866652614,0.336633663366337
"United States","Wyoming","WY",2020-11-22,2020-11-28,7,2020,"48",578759,138,51,102,36,87,8.8119579997892,6.22020564691003,0.352941176470588
"United States","Wyoming","WY",2020-11-29,2020-12-05,7,2020,"49",578759,123,42,103,20,81,7.2569065880617,3.4556698038389,0.194174757281553
"United States","Wyoming","WY",2020-12-06,2020-12-12,7,2020,"50",578759,143,64,103,40,79,11.0581433722845,6.91133960767781,0.388349514563107
"United States","Wyoming","WY",2020-12-13,2020-12-19,7,2020,"51",578759,165,30,102,63,135,5.18350470575835,10.8853598820925,0.617647058823529
"United States","Wyoming","WY",2020-12-20,2020-12-26,7,2020,"52",578759,130,0,102,28,130,0,4.83793772537446,0.274509803921569
"United States","Wyoming","WY",2020-12-27,2021-01-02,7,2020,"53",578759,129,87,102,27,42,15.0321636466992,4.66515423518252,0.264705882352941
"United States","Wyoming","WY",2021-01-03,2021-01-09,7,2021,"1",578759,127,51,102,25,76,8.8119579997892,4.31958725479863,0.245098039215686
"United States","Wyoming","WY",2021-01-10,2021-01-16,7,2021,"2",578759,110,33,102,8,77,5.70185517633419,1.38226792153556,0.0784313725490196
"United States","Wyoming","WY",2021-01-17,2021-01-23,7,2021,"3",578759,111,49,103,8,62,8.46639101940531,1.38226792153556,0.0776699029126213
"United States","Wyoming","WY",2021-01-24,2021-01-30,7,2021,"4",578759,118,25,101,17,93,4.31958725479863,2.93731933326307,0.168316831683168
"United States","Wyoming","WY",2021-01-31,2021-02-06,7,2021,"5",578759,112,28,101,11,84,4.83793772537446,1.9006183921114,0.108910891089109
"United States","Wyoming","WY",2021-02-07,2021-02-13,7,2021,"6",578759,102,23,100,2,79,3.97402027441474,0.34556698038389,0.02
"United States","Wyoming","WY",2021-02-14,2021-02-20,7,2021,"7",578759,110,15,102,8,95,2.59175235287918,1.38226792153556,0.0784313725490196
"United States","Wyoming","WY",2021-02-21,2021-02-27,7,2021,"8",578759,104,9,104,0,95,1.55505141172751,0,0
"United States","Wyoming","WY",2021-02-28,2021-03-06,7,2021,"9",578759,88,13,103,-15,75,2.24618537249529,-2.59175235287918,-0.145631067961165
"United States","Wyoming","WY",2021-03-07,2021-03-13,7,2021,"10",578759,106,9,102,4,97,1.55505141172751,0.691133960767781,0.0392156862745099
"United States","Wyoming","WY",2021-03-14,2021-03-20,7,2021,"11",578759,86,1,103,-17,85,0.172783490191945,-2.93731933326307,-0.16504854368932
"United States","Wyoming","WY",2021-03-21,2021-03-27,7,2021,"12",578759,111,2,100,11,109,0.34556698038389,1.9006183921114,0.11
"United States","Wyoming","WY",2021-03-28,2021-04-03,7,2021,"13",578759,88,4,96,-8,84,0.691133960767781,-1.38226792153556,-0.0833333333333334
"United States","Wyoming","WY",2021-04-04,2021-04-10,7,2021,"14",578759,93,1,95,-2,92,0.172783490191945,-0.34556698038389,-0.0210526315789473
"United States","Wyoming","WY",2021-04-11,2021-04-17,7,2021,"15",578759,78,2,91,-13,76,0.34556698038389,-2.24618537249529,-0.142857142857143
"United States","Wyoming","WY",2021-04-18,2021-04-24,7,2021,"16",578759,100,2,93,7,98,0.34556698038389,1.20948443134362,0.075268817204301
"United States","Wyoming","WY",2021-04-25,2021-05-01,7,2021,"17",578759,91,2,95,-4,89,0.34556698038389,-0.691133960767781,-0.0421052631578948
"United States","Wyoming","WY",2021-05-02,2021-05-08,7,2021,"18",578759,93,3,97,-4,90,0.518350470575835,-0.691133960767781,-0.0412371134020618
"United States","Wyoming","WY",2021-05-09,2021-05-15,7,2021,"19",578759,91,2,98,-7,89,0.34556698038389,-1.20948443134362,-0.0714285714285714
"United States","Wyoming","WY",2021-05-16,2021-05-22,7,2021,"20",578759,97,1,98,-1,96,0.172783490191945,-0.172783490191945,-0.0102040816326531
"United States","Wyoming","WY",2021-05-23,2021-05-29,7,2021,"21",578759,100,6,94,6,94,1.03670094115167,1.03670094115167,0.0638297872340425
"United States","Wyoming","WY",2021-05-30,2021-06-05,7,2021,"22",578759,106,1,93,13,105,0.172783490191945,2.24618537249529,0.139784946236559
"United States","Wyoming","WY",2021-06-06,2021-06-12,7,2021,"23",578759,113,5,91,22,108,0.863917450959726,3.80123678422279,0.241758241758242
"United States","Wyoming","WY",2021-06-13,2021-06-19,7,2021,"24",578759,109,9,92,17,100,1.55505141172751,2.93731933326307,0.184782608695652
"United States","Wyoming","WY",2021-06-20,2021-06-26,7,2021,"25",578759,97,6,93,4,91,1.03670094115167,0.691133960767781,0.043010752688172
"United States","Wyoming","WY",2021-06-27,2021-07-03,7,2021,"26",578759,101,7,93,8,94,1.20948443134362,1.38226792153556,0.086021505376344
"United States","Wyoming","WY",2021-07-04,2021-07-10,7,2021,"27",578759,86,4,95,-9,82,0.691133960767781,-1.55505141172751,-0.0947368421052631
"United States","Wyoming","WY",2021-07-11,2021-07-17,7,2021,"28",578759,106,9,94,12,97,1.55505141172751,2.07340188230334,0.127659574468085
"United States","Wyoming","WY",2021-07-18,2021-07-24,7,2021,"29",578759,93,6,94,-1,87,1.03670094115167,-0.172783490191945,-0.0106382978723404
"United States","Wyoming","WY",2021-07-25,2021-07-31,7,2021,"30",578759,79,10,93,-14,69,1.72783490191945,-2.41896886268723,-0.150537634408602
"United States","Wyoming","WY",2021-08-01,2021-08-07,7,2021,"31",578759,69,10,92,-23,59,1.72783490191945,-3.97402027441474,-0.25
"United States","United States","USA",2019-12-29,2020-01-04,7,2020,"1",328300544,60175,0,63380,-3205,60175,0,-0.976239625116186,-0.0505680025244557
"United States","United States","USA",2020-01-05,2020-01-11,7,2020,"2",328300544,60735,0,63649,-2914,60735,0,-0.887601331540894,-0.0457823375072665
"United States","United States","USA",2020-01-12,2020-01-18,7,2020,"3",328300544,59372,0,63434,-4062,59372,0,-1.23728092269016,-0.0640350600624271
"United States","United States","USA",2020-01-19,2020-01-25,7,2020,"4",328300544,59162,0,62788,-3626,59162,0,-1.10447578180071,-0.0577498885137288
"United States","United States","USA",2020-01-26,2020-02-01,7,2020,"5",328300544,58843,0,62188,-3345,58843,0,-1.01888347769536,-0.0537885122531678
"United States","United States","USA",2020-02-02,2020-02-08,7,2020,"6",328300544,59491,1,61493,-2002,59490,0.00030459894699413,-0.609807091882248,-0.0325565511521637
"United States","United States","USA",2020-02-09,2020-02-15,7,2020,"7",328300544,58815,0,60864,-2049,58815,0,-0.624123242390972,-0.0336652208201893
"United States","United States","USA",2020-02-16,2020-02-22,7,2020,"8",328300544,58912,1,60285,-1373,58911,0.00030459894699413,-0.41821435422294,-0.0227751513643527
"United States","United States","USA",2020-02-23,2020-02-29,7,2020,"9",328300544,59334,1,59631,-297,59333,0.00030459894699413,-0.0904658872572566,-0.00498063087991141
"United States","United States","USA",2020-03-01,2020-03-07,7,2020,"10",328300544,59696,19,59428,268,59677,0.00578737999288847,0.0816325177944268,0.00450965874671883
"United States","United States","USA",2020-03-08,2020-03-14,7,2020,"11",328300544,58695,39,59085,-390,58656,0.0118793589327711,-0.118793589327711,-0.00660066006600657
"United States","United States","USA",2020-03-15,2020-03-21,7,2020,"12",328300544,59219,284,58653,566,58935,0.0865061009463329,0.172403003998678,0.00964997527833189
"United States","United States","USA",2020-03-22,2020-03-28,7,2020,"13",328300544,63026,1988,58182,4844,61038,0.60554270662433,1.47547729923957,0.0832559898250318
"United States","United States","USA",2020-03-29,2020-04-04,7,2020,"14",328300544,72317,7056,57585,14732,65261,2.14925016999058,4.48735168711752,0.255830511417904
"United States","United States","USA",2020-04-05,2020-04-11,7,2020,"15",328300544,79114,13519,57029,22085,65595,4.11787316441364,6.72706774436536,0.387259113784215
"United States","United States","USA",2020-04-12,2020-04-18,7,2020,"16",328300544,76828,14155,56506,20322,62673,4.31159809470191,6.19005980081471,0.359643223728454
"United States","United States","USA",2020-04-19,2020-04-25,7,2020,"17",328300544,73912,15605,55814,18098,58307,4.7532665678434,5.51263174269976,0.324255563120364
"United States","United States","USA",2020-04-26,2020-05-02,7,2020,"18",328300544,69303,12860,54962,14341,56443,3.91714245834451,4.36825349884282,0.260925730504712
"United States","United States","USA",2020-05-03,2020-05-09,7,2020,"19",328300544,66826,12666,54271,12555,54160,3.85805026262765,3.8242397795113,0.231339020839859
"United States","United States","USA",2020-05-10,2020-05-16,7,2020,"20",328300544,64480,9576,53847,10633,54904,2.91683951641579,3.23880060338858,0.197466896948762
"United States","United States","USA",2020-05-17,2020-05-23,7,2020,"21",328300544,61630,8548,53448,8182,53082,2.60371179890582,2.49222858430597,0.153083370752881
"United States","United States","USA",2020-05-24,2020-05-30,7,2020,"22",328300544,59694,6656,53215,6479,53038,2.02741059119293,1.97349657757497,0.121751385887438
"United States","United States","USA",2020-05-31,2020-06-06,7,2020,"23",328300544,58908,6391,53047,5861,52517,1.94669187023948,1.7852544283326,0.110486926687654
"United States","United States","USA",2020-06-07,2020-06-13,7,2020,"24",328300544,58034,5207,52817,5217,52827,1.58604671699843,1.58909270646838,0.0987750156199709
"United States","United States","USA",2020-06-14,2020-06-20,7,2020,"25",328300544,58011,4306,52882,5129,53705,1.31160306575672,1.56228799913289,0.0969895238455429
"United States","United States","USA",2020-06-21,2020-06-27,7,2020,"26",328300544,58510,5858,52864,5646,52652,1.78434063149161,1.71976565472886,0.106802360774818
"United States","United States","USA",2020-06-28,2020-07-04,7,2020,"27",328300544,59825,4079,52634,7191,55746,1.24245910478906,2.19037102783479,0.136622715355094
"United States","United States","USA",2020-07-05,2020-07-11,7,2020,"28",328300544,61962,4858,52465,9497,57104,1.47974168449748,2.89277619960325,0.181015915372153
"United States","United States","USA",2020-07-12,2020-07-18,7,2020,"29",328300544,63194,5326,52236,10958,57868,1.62229399169074,3.33779526116167,0.209778696684279
"United States","United States","USA",2020-07-19,2020-07-25,7,2020,"30",328300544,64249,6221,52157,12092,58028,1.89491004925048,3.68321046705302,0.231838487643078
"United States","United States","USA",2020-07-26,2020-08-01,7,2020,"31",328300544,64235,8026,52062,12173,56209,2.44471114857489,3.70788298175954,0.233817371595405
"United States","United States","USA",2020-08-02,2020-08-08,7,2020,"32",328300544,63740,7128,52031,11709,56612,2.17118129417416,3.56654907035427,0.225038919105918
"United States","United States","USA",2020-08-09,2020-08-15,7,2020,"33",328300544,63644,7482,51892,11752,56162,2.27900932141008,3.57964682507501,0.22647036152008
"United States","United States","USA",2020-08-16,2020-08-22,7,2020,"34",328300544,62562,6875,51724,10838,55687,2.09411776058464,3.30124338752238,0.209535225427268
"United States","United States","USA",2020-08-23,2020-08-29,7,2020,"35",328300544,61125,6690,51691,9434,54435,2.03776695539073,2.87358646594262,0.182507593198042
"United States","United States","USA",2020-08-30,2020-09-05,7,2020,"36",328300544,60247,5713,51773,8474,54534,1.74017378417746,2.58117147682826,0.163676047360593
"United States","United States","USA",2020-09-06,2020-09-12,7,2020,"37",328300544,59678,5018,51746,7932,54660,1.52847751601654,2.41607884755744,0.153287210605651
"United States","United States","USA",2020-09-13,2020-09-19,7,2020,"38",328300544,59751,5484,51869,7882,54267,1.67042062531581,2.40084890020773,0.15195974474156
"United States","United States","USA",2020-09-20,2020-09-26,7,2020,"39",328300544,60613,5119,52071,8542,55494,1.55924200966295,2.60188420522386,0.164045245914233
"United States","United States","USA",2020-09-27,2020-10-03,7,2020,"40",328300544,59802,4872,52319,7483,54930,1.4840060697554,2.27931392035707,0.143026433991475
"United States","United States","USA",2020-10-04,2020-10-10,7,2020,"41",328300544,61779,4860,52508,9271,56919,1.48035088239147,2.82393683758258,0.176563571265331
"United States","United States","USA",2020-10-11,2020-10-17,7,2020,"42",328300544,60643,4696,52847,7796,55947,1.43039665508443,2.37465339076624,0.147520199822128
"United States","United States","USA",2020-10-18,2020-10-24,7,2020,"43",328300544,62191,5390,53093,9098,56801,1.64178832429836,2.77124121975259,0.171359689601266
"United States","United States","USA",2020-10-25,2020-10-31,7,2020,"44",328300544,63445,5607,53454,9991,57838,1.70788629579609,3.04324807941835,0.186908369813297
"United States","United States","USA",2020-11-01,2020-11-07,7,2020,"45",328300544,67590,6501,53867,13723,61089,1.98019775440884,4.18001134960044,0.254757086899215
"United States","United States","USA",2020-11-08,2020-11-14,7,2020,"46",328300544,68823,7640,54184,14639,61183,2.32713595503515,4.45902398504707,0.270172006496383
"United States","United States","USA",2020-11-15,2020-11-21,7,2020,"47",328300544,71699,9373,54662,17037,62326,2.85500593017598,5.18945225993899,0.3116790457722
"United States","United States","USA",2020-11-22,2020-11-28,7,2020,"48",328300544,73327,10520,55130,18197,62807,3.20438092237825,5.54278703845218,0.330074369671685
"United States","United States","USA",2020-11-29,2020-12-05,7,2020,"49",328300544,77429,14514,55685,21744,62915,4.4209491166728,6.62319950344036,0.390482176528688
"United States","United States","USA",2020-12-06,2020-12-12,7,2020,"50",328300544,82026,16360,56279,25747,65666,4.98323877282396,7.84250908825786,0.457488583663533
"United States","United States","USA",2020-12-13,2020-12-19,7,2020,"51",328300544,82938,17350,57068,25870,65588,5.28479173034815,7.87997475873814,0.453318847690475
"United States","United States","USA",2020-12-20,2020-12-26,7,2020,"52",328300544,84371,13916,57962,26409,70455,4.23879894637031,8.04415359116797,0.455626099858528
"United States","United States","USA",2020-12-27,2021-01-02,7,2020,"53",328300544,87015,19700,58961,28054,67315,6.00059925578436,8.54521885897332,0.475806041281525
"United States","United States","USA",2021-01-03,2021-01-09,7,2021,"1",328300544,86950,21036,59764,27186,65914,6.40754344896852,8.28082697298241,0.454889230975169
"United States","United States","USA",2021-01-10,2021-01-16,7,2021,"2",328300544,87297,23481,60348,26949,63816,7.15228787436916,8.20863702254481,0.446559952276795
"United States","United States","USA",2021-01-17,2021-01-23,7,2021,"3",328300544,83500,21264,60453,23047,62236,6.47699200888318,7.02009193137371,0.381238317370519
"United States","United States","USA",2021-01-24,2021-01-30,7,2021,"4",328300544,79042,21666,60333,18709,57376,6.59944078557482,5.69874169931318,0.310095635887491
"United States","United States","USA",2021-01-31,2021-02-06,7,2021,"5",328300544,76336,22297,60026,16310,54039,6.79164272112811,4.96800882547426,0.271715589911039
"United States","United States","USA",2021-02-07,2021-02-13,7,2021,"6",328300544,71330,21567,59556,11774,49763,6.5692854898224,3.58634800190888,0.197696285848613
"United States","United States","USA",2021-02-14,2021-02-20,7,2021,"7",328300544,69374,13294,59045,10329,56080,4.04933840133996,3.14620252350237,0.174934372089085
"United States","United States","USA",2021-02-21,2021-02-27,7,2021,"8",328300544,66968,14410,58755,8213,52558,4.38927082618541,2.50167115166279,0.139783848183133
"United States","United States","USA",2021-02-28,2021-03-06,7,2021,"9",328300544,62914,12196,58410,4504,50718,3.71488875754041,1.37191365726156,0.0771100838897449
"United States","United States","USA",2021-03-07,2021-03-13,7,2021,"10",317812460,60059,9271,56081,3978,50788,2.91712917737712,1.25168157346631,0.0709331146020935
"United States","United States","USA",2021-03-14,2021-03-20,7,2021,"11",317812460,58562,7022,55652,2910,51540,2.20947913747623,0.915634333531165,0.052289225903831
"United States","United States","USA",2021-03-21,2021-03-27,7,2021,"12",317812460,58983,6938,55223,3760,52045,2.18304845568358,1.18308766119491,0.0680875722072325
"United States","United States","USA",2021-03-28,2021-04-03,7,2021,"13",317812460,56907,9573,54852,2055,47334,3.01215377144118,0.646607750998812,0.0374644497921681
"United States","United States","USA",2021-04-04,2021-04-10,7,2021,"14",317812460,59086,6723,54277,4809,52363,2.11539849633334,1.51315653262934,0.0886010649077877
"United States","United States","USA",2021-04-11,2021-04-17,7,2021,"15",317812460,57331,5026,53841,3490,52305,1.58143579392702,1.09813189828995,0.0648204899611819
"United States","United States","USA",2021-04-18,2021-04-24,7,2021,"16",317812460,58446,4670,53315,5131,53776,1.46942004728197,1.61447414616784,0.096239332270468
"United States","United States","USA",2021-04-25,2021-05-01,7,2021,"17",317812460,57953,4644,52781,5172,53309,1.4612391219652,1.62737483609044,0.0979898069381027
"United States","United States","USA",2021-05-02,2021-05-08,7,2021,"18",317080915,57045,4438,52252,4793,52607,1.3996427378797,1.51160154183357,0.0917285462757407
"United States","United States","USA",2021-05-09,2021-05-15,7,2021,"19",317080915,56576,4064,51885,4691,52512,1.28169177258745,1.47943309675387,0.0904114869422763
"United States","United States","USA",2021-05-16,2021-05-22,7,2021,"20",317080915,56849,3919,51584,5265,52930,1.23596212026826,1.66045944455534,0.102066532258065
"United States","United States","USA",2021-05-23,2021-05-29,7,2021,"21",317080915,55335,4107,51230,4105,51228,1.29525297982693,1.29462222600184,0.0801288307632246
"United States","United States","USA",2021-05-30,2021-06-05,7,2021,"22",317080915,55352,2883,51004,4348,52469,0.909231638870476,1.37125881575055,0.0852482158262098
"United States","United States","USA",2021-06-06,2021-06-12,7,2021,"23",317080915,55034,2652,51009,4025,52382,0.836379572072321,1.26939207299815,0.0789076437491423
"United States","United States","USA",2021-06-13,2021-06-19,7,2021,"24",317080915,55091,2149,51009,4082,52942,0.677744985061621,1.28736855701328,0.0800250936109315
"United States","United States","USA",2021-06-20,2021-06-26,7,2021,"25",317080915,54808,2115,51008,3800,52693,0.667022170035052,1.19843226767527,0.0744981179422837
"United States","United States","USA",2021-06-27,2021-07-03,7,2021,"26",317080915,55143,1688,50782,4361,53455,0.532356228377857,1.37535871561365,0.085876885510614
"United States","United States","USA",2021-07-04,2021-07-10,7,2021,"27",315288768,54058,1570,50252,3806,52488,0.497956210098801,1.20714734753888,0.0757382790734697
"United States","United States","USA",2021-07-11,2021-07-17,7,2021,"28",311723481,53310,1780,49594,3716,51530,0.571018902486849,1.19208215822535,0.0749284187603338
"United States","United States","USA",2021-07-18,2021-07-24,7,2021,"29",309789073,53243,1791,49179,4064,51452,0.578135304339802,1.31186034440924,0.0826368978629091
"United States","United States","USA",2021-07-25,2021-07-31,7,2021,"30",309789073,51836,2259,49126,2710,49577,0.729205836127086,0.874788763127226,0.0551642714652119
"United States","United States","USA",2021-08-01,2021-08-07,7,2021,"31",319217796,46412,3548,50562,-4150,42864,1.11146685568871,-1.30005283289407,-0.0820774494679799
