"country","region","region_code","start_date","end_date","days","year","week","population","total_deaths","covid_deaths","expected_deaths","excess_deaths","non_covid_deaths","covid_deaths_per_100k","excess_deaths_per_100k","excess_deaths_pct_change"
"United States","Alabama","AL",2019-12-29,2020-01-04,7,2020,"1",4903185,1082,0,1200,-118,1082,0,-2.40659897597174,-0.0983333333333334
"United States","Alabama","AL",2020-01-05,2020-01-11,7,2020,"2",4903185,1127,0,1181,-54,1127,0,-1.10132495510571,-0.0457239627434378
"United States","Alabama","AL",2020-01-12,2020-01-18,7,2020,"3",4903185,1039,0,1160,-121,1039,0,-2.46778369569984,-0.104310344827586
"United States","Alabama","AL",2020-01-19,2020-01-25,7,2020,"4",4903185,1056,0,1141,-85,1056,0,-1.73356705896269,-0.0744960560911481
"United States","Alabama","AL",2020-01-26,2020-02-01,7,2020,"5",4903185,1026,0,1139,-113,1026,0,-2.30462444309158,-0.0992098331870062
"United States","Alabama","AL",2020-02-02,2020-02-08,7,2020,"6",4903185,1120,0,1151,-31,1120,0,-0.632242103856983,-0.0269331016507385
"United States","Alabama","AL",2020-02-09,2020-02-15,7,2020,"7",4903185,1095,0,1144,-49,1095,0,-0.999350422225553,-0.0428321678321678
"United States","Alabama","AL",2020-02-16,2020-02-22,7,2020,"8",4903185,1098,0,1134,-36,1098,0,-0.734216636737141,-0.0317460317460317
"United States","Alabama","AL",2020-02-23,2020-02-29,7,2020,"9",4903185,1164,0,1113,51,1164,0,1.04014023537762,0.045822102425876
"United States","Alabama","AL",2020-03-01,2020-03-07,7,2020,"10",4903185,1057,0,1106,-49,1057,0,-0.999350422225553,-0.0443037974683544
"United States","Alabama","AL",2020-03-08,2020-03-14,7,2020,"11",4903185,1091,0,1098,-7,1091,0,-0.142764346032222,-0.00637522768670307
"United States","Alabama","AL",2020-03-15,2020-03-21,7,2020,"12",4903185,1059,0,1095,-36,1059,0,-0.734216636737141,-0.0328767123287671
"United States","Alabama","AL",2020-03-22,2020-03-28,7,2020,"13",4903185,1073,3,1090,-17,1070,0.0611847197280951,-0.346713411792539,-0.0155963302752293
"United States","Alabama","AL",2020-03-29,2020-04-04,7,2020,"14",4903185,1156,23,1071,85,1133,0.469082851248729,1.73356705896269,0.0793650793650793
"United States","Alabama","AL",2020-04-05,2020-04-11,7,2020,"15",4903185,1135,34,1059,76,1101,0.693426823585078,1.55001289977841,0.0717658168083097
"United States","Alabama","AL",2020-04-12,2020-04-18,7,2020,"16",4903185,1149,50,1060,89,1099,1.01974532880158,1.81514668526682,0.0839622641509434
"United States","Alabama","AL",2020-04-19,2020-04-25,7,2020,"17",4903185,1139,102,1054,85,1037,2.08028047075523,1.73356705896269,0.0806451612903225
"United States","Alabama","AL",2020-04-26,2020-05-02,7,2020,"18",4903185,1147,75,1049,98,1072,1.52961799320238,1.99870084445111,0.0934223069590085
"United States","Alabama","AL",2020-05-03,2020-05-09,7,2020,"19",4903185,1171,101,1028,143,1070,2.0598855641792,2.91647164037253,0.139105058365759
"United States","Alabama","AL",2020-05-10,2020-05-16,7,2020,"20",4903185,1148,94,1025,123,1054,1.91712121814698,2.5085735088519,0.12
"United States","Alabama","AL",2020-05-17,2020-05-23,7,2020,"21",4903185,1153,69,1021,132,1084,1.40724855374619,2.69212766803618,0.129285014691479
"United States","Alabama","AL",2020-05-24,2020-05-30,7,2020,"22",4903185,1109,67,1030,79,1042,1.36645874059412,1.6111976195065,0.0766990291262135
"United States","Alabama","AL",2020-05-31,2020-06-06,7,2020,"23",4903185,1173,66,1011,162,1107,1.34606383401809,3.30397486531714,0.160237388724036
"United States","Alabama","AL",2020-06-07,2020-06-13,7,2020,"24",4903185,1138,84,998,140,1054,1.71317215238666,2.85528692064444,0.140280561122244
"United States","Alabama","AL",2020-06-14,2020-06-20,7,2020,"25",4903185,1090,70,984,106,1020,1.42764346032222,2.16186009705936,0.107723577235772
"United States","Alabama","AL",2020-06-21,2020-06-27,7,2020,"26",4903185,1151,81,985,166,1070,1.65198743265857,3.38555449162126,0.168527918781726
"United States","Alabama","AL",2020-06-28,2020-07-04,7,2020,"27",4903185,1201,88,990,211,1113,1.79475177869079,4.30332528754269,0.213131313131313
"United States","Alabama","AL",2020-07-05,2020-07-11,7,2020,"28",4903185,1265,107,990,275,1158,2.18225500363539,5.60859930840872,0.277777777777778
"United States","Alabama","AL",2020-07-12,2020-07-18,7,2020,"29",4903185,1289,172,973,316,1117,3.50792393107745,6.44479047802602,0.324768756423433
"United States","Alabama","AL",2020-07-19,2020-07-25,7,2020,"30",4903185,1333,170,971,362,1163,3.46713411792539,7.38295618052348,0.372811534500515
"United States","Alabama","AL",2020-07-26,2020-08-01,7,2020,"31",4903185,1364,147,973,391,1217,2.99805126667666,7.9744084712284,0.401849948612539
"United States","Alabama","AL",2020-08-02,2020-08-08,7,2020,"32",4903185,1379,165,974,405,1214,3.36515958504523,8.25993716329284,0.415811088295688
"United States","Alabama","AL",2020-08-09,2020-08-15,7,2020,"33",4903185,1305,128,972,333,1177,2.61054804173206,6.79150388981856,0.342592592592593
"United States","Alabama","AL",2020-08-16,2020-08-22,7,2020,"34",4903185,1303,115,966,337,1188,2.34541425624365,6.87308351612268,0.348861283643892
"United States","Alabama","AL",2020-08-23,2020-08-29,7,2020,"35",4903185,1216,141,953,263,1075,2.87568182722047,5.36386042949634,0.275970619097587
"United States","Alabama","AL",2020-08-30,2020-09-05,7,2020,"36",4903185,1216,123,966,250,1093,2.5085735088519,5.09872664400793,0.25879917184265
"United States","Alabama","AL",2020-09-06,2020-09-12,7,2020,"37",4903185,1232,75,978,254,1157,1.52961799320238,5.18030627031205,0.259713701431493
"United States","Alabama","AL",2020-09-13,2020-09-19,7,2020,"38",4903185,1200,87,985,215,1113,1.77435687211476,4.38490491384682,0.218274111675127
"United States","Alabama","AL",2020-09-20,2020-09-26,7,2020,"39",4903185,1183,64,984,199,1119,1.30527402086603,4.05858640863031,0.202235772357723
"United States","Alabama","AL",2020-09-27,2020-10-03,7,2020,"40",4903185,1103,57,988,115,1046,1.16250967483381,2.34541425624365,0.116396761133603
"United States","Alabama","AL",2020-10-04,2020-10-10,7,2020,"41",4903185,1204,106,979,225,1098,2.16186009705936,4.58885397960713,0.229826353421859
"United States","Alabama","AL",2020-10-11,2020-10-17,7,2020,"42",4903185,1190,124,972,218,1066,2.52896841542793,4.44608963357491,0.224279835390947
"United States","Alabama","AL",2020-10-18,2020-10-24,7,2020,"43",4903185,1142,78,971,171,1064,1.59080271293047,3.48752902450142,0.17610710607621
"United States","Alabama","AL",2020-10-25,2020-10-31,7,2020,"44",4903185,1169,98,989,180,1071,1.99870084445111,3.67108318368571,0.182002022244692
"United States","Alabama","AL",2020-11-01,2020-11-07,7,2020,"45",4903185,1277,115,991,286,1162,2.34541425624365,5.83294328074507,0.288597376387487
"United States","Alabama","AL",2020-11-08,2020-11-14,7,2020,"46",4903185,1269,165,1002,267,1104,3.36515958504523,5.44544005580046,0.266467065868264
"United States","Alabama","AL",2020-11-15,2020-11-21,7,2020,"47",4903185,1275,211,1024,251,1064,4.30332528754269,5.11912155058396,0.2451171875
"United States","Alabama","AL",2020-11-22,2020-11-28,7,2020,"48",4903185,1326,115,1044,282,1211,2.34541425624365,5.75136365444094,0.270114942528736
"United States","Alabama","AL",2020-11-29,2020-12-05,7,2020,"49",4903185,1355,304,1054,301,1051,6.20005159911364,6.13886687938554,0.285578747628084
"United States","Alabama","AL",2020-12-06,2020-12-12,7,2020,"50",4903185,1598,205,1080,518,1393,4.1809558480865,10.5645616063844,0.47962962962963
"United States","Alabama","AL",2020-12-13,2020-12-19,7,2020,"51",4903185,1584,310,1093,491,1274,6.32242103856983,10.0138991288316,0.449222323879231
"United States","Alabama","AL",2020-12-20,2020-12-26,7,2020,"52",4903185,1626,294,1106,520,1332,5.99610253335332,10.6053514195365,0.470162748643761
"United States","Alabama","AL",2020-12-27,2021-01-02,7,2020,"53",4903185,1801,188,1114,687,1613,3.83424243629396,14.0113008177338,0.616696588868941
"United States","Alabama","AL",2021-01-03,2021-01-09,7,2021,"1",4903185,1807,428,1119,688,1379,8.72902001454157,14.0316957243098,0.614834673815907
"United States","Alabama","AL",2021-01-10,2021-01-16,7,2021,"2",4903185,1825,819,1118,707,1006,16.70342848577,14.4191989492544,0.632379248658318
"United States","Alabama","AL",2021-01-17,2021-01-23,7,2021,"3",4903185,1782,539,1122,660,1243,10.9928546444811,13.4606383401809,0.588235294117647
"United States","Alabama","AL",2021-01-24,2021-01-30,7,2021,"4",4903185,1635,909,1116,519,726,18.5389700776128,10.5849565129605,0.46505376344086
"United States","Alabama","AL",2021-01-31,2021-02-06,7,2021,"5",4903185,1504,956,1100,404,548,19.4975306866863,8.23954225671681,0.367272727272727
"United States","Alabama","AL",2021-02-07,2021-02-13,7,2021,"6",4903185,1425,722,1103,322,703,14.7251225478949,6.56715991748221,0.29193109700816
"United States","Alabama","AL",2021-02-14,2021-02-20,7,2021,"7",4903185,1329,347,1089,240,982,7.077032581883,4.89477757824761,0.220385674931129
"United States","Alabama","AL",2021-02-21,2021-02-27,7,2021,"8",4903185,1310,343,1077,233,967,6.99545295557887,4.75201323221539,0.216341689879294
"United States","Alabama","AL",2021-02-28,2021-03-06,7,2021,"9",4903185,1156,218,1066,90,938,4.44608963357491,1.83554159184285,0.0844277673545966
"United States","Alabama","AL",2021-03-07,2021-03-13,7,2021,"10",4903185,1188,181,1064,124,1007,3.69147809026174,2.52896841542793,0.116541353383459
"United States","Alabama","AL",2021-03-14,2021-03-20,7,2021,"11",4903185,1063,108,1053,10,955,2.20264991021142,0.203949065760317,0.00949667616334282
"United States","Alabama","AL",2021-03-21,2021-03-27,7,2021,"12",4903185,1192,89,1051,141,1103,1.81514668526682,2.87568182722047,0.134157944814463
"United States","Alabama","AL",2021-03-28,2021-04-03,7,2021,"13",4903185,1108,110,1035,73,998,2.24343972336349,1.48882818005031,0.0705314009661835
"United States","Alabama","AL",2021-04-04,2021-04-10,7,2021,"14",4903185,1209,72,1034,175,1137,1.46843327347428,3.56910865080555,0.169245647969052
"United States","Alabama","AL",2021-04-11,2021-04-17,7,2021,"15",4903185,1170,78,1036,134,1092,1.59080271293047,2.73291748118825,0.129343629343629
"United States","Alabama","AL",2021-04-18,2021-04-24,7,2021,"16",4903185,1110,61,1028,82,1049,1.24408930113793,1.6723823392346,0.0797665369649805
"United States","Alabama","AL",2021-04-25,2021-05-01,7,2021,"17",4903185,1196,62,1019,177,1134,1.26448420771397,3.60989846395761,0.173699705593719
"United States","Alabama","AL",2021-05-02,2021-05-08,7,2021,"18",4903185,1154,65,1017,137,1089,1.32566892744206,2.79410220091634,0.134709931170108
"United States","Alabama","AL",2021-05-09,2021-05-15,7,2021,"19",4903185,1101,60,1022,79,1041,1.2236943945619,1.6111976195065,0.0772994129158513
"United States","Alabama","AL",2021-05-16,2021-05-22,7,2021,"20",4903185,1099,74,1023,76,1025,1.50922308662635,1.55001289977841,0.0742913000977516
"United States","Alabama","AL",2021-05-23,2021-05-29,7,2021,"21",4903185,1076,34,1017,59,1042,0.693426823585078,1.20329948798587,0.0580137659783677
"United States","Alabama","AL",2021-05-30,2021-06-05,7,2021,"22",4903185,1083,52,997,86,1031,1.06053514195365,1.75396196553873,0.086258776328987
"United States","Alabama","AL",2021-06-06,2021-06-12,7,2021,"23",4903185,1107,68,993,114,1039,1.38685364717016,2.32501934966761,0.114803625377643
"United States","Alabama","AL",2021-06-13,2021-06-19,7,2021,"24",4903185,1127,40,994,133,1087,0.815796263041268,2.71252257461222,0.133802816901408
"United States","Alabama","AL",2021-06-20,2021-06-26,7,2021,"25",4903185,1081,30,987,94,1051,0.611847197280951,1.91712121814698,0.0952380952380953
"United States","Alabama","AL",2021-06-27,2021-07-03,7,2021,"26",4903185,1059,22,982,77,1037,0.448687944672697,1.57040780635444,0.0784114052953158
"United States","Alabama","AL",2021-07-04,2021-07-10,7,2021,"27",4903185,1136,44,977,159,1092,0.897375889345395,3.24279014558904,0.162743091095189
"United States","Alabama","AL",2021-07-11,2021-07-17,7,2021,"28",4903185,1043,41,967,76,1002,0.8361911696173,1.55001289977841,0.0785935884177871
"United States","Alabama","AL",2021-07-18,2021-07-24,7,2021,"29",4903185,1107,40,975,132,1067,0.815796263041268,2.69212766803618,0.135384615384615
"United States","Alabama","AL",2021-07-25,2021-07-31,7,2021,"30",4903185,1154,59,980,174,1095,1.20329948798587,3.54871374422952,0.177551020408163
"United States","Alabama","AL",2021-08-01,2021-08-07,7,2021,"31",4903185,1291,58,970,321,1233,1.18290458140984,6.54676501090618,0.330927835051546
"United States","Alabama","AL",2021-08-08,2021-08-14,7,2021,"32",4903185,1390,165,957,433,1225,3.36515958504523,8.83099454742173,0.452455590386625
"United States","Alabama","AL",2021-08-15,2021-08-21,7,2021,"33",4903185,1398,34,962,436,1364,0.693426823585078,8.89217926714982,0.453222453222453
"United States","Alaska","AK",2019-12-29,2020-01-04,7,2020,"1",731545,89,0,89,0,89,0,0,0
"United States","Alaska","AK",2020-01-05,2020-01-11,7,2020,"2",731545,105,0,86,19,105,0,2.59724282169928,0.220930232558139
"United States","Alaska","AK",2020-01-12,2020-01-18,7,2020,"3",731545,99,0,89,10,99,0,1.36696990615752,0.112359550561798
"United States","Alaska","AK",2020-01-19,2020-01-25,7,2020,"4",731545,97,0,84,13,97,0,1.77706087800477,0.154761904761905
"United States","Alaska","AK",2020-01-26,2020-02-01,7,2020,"5",731545,85,0,82,3,85,0,0.410090971847255,0.0365853658536586
"United States","Alaska","AK",2020-02-02,2020-02-08,7,2020,"6",731545,92,0,79,13,92,0,1.77706087800477,0.164556962025316
"United States","Alaska","AK",2020-02-09,2020-02-15,7,2020,"7",731545,89,0,76,13,89,0,1.77706087800477,0.171052631578947
"United States","Alaska","AK",2020-02-16,2020-02-22,7,2020,"8",731545,83,0,76,7,83,0,0.956878934310261,0.0921052631578947
"United States","Alaska","AK",2020-02-23,2020-02-29,7,2020,"9",731545,84,0,79,5,84,0,0.683484953078758,0.0632911392405062
"United States","Alaska","AK",2020-03-01,2020-03-07,7,2020,"10",731545,79,0,79,0,79,0,0,0
"United States","Alaska","AK",2020-03-08,2020-03-14,7,2020,"11",731545,92,0,76,16,92,0,2.18715184985203,0.210526315789474
"United States","Alaska","AK",2020-03-15,2020-03-21,7,2020,"12",731545,69,0,78,-9,69,0,-1.23027291554176,-0.115384615384615
"United States","Alaska","AK",2020-03-22,2020-03-28,7,2020,"13",731545,86,2,80,6,84,0.273393981231503,0.82018194369451,0.075
"United States","Alaska","AK",2020-03-29,2020-04-04,7,2020,"14",731545,98,3,83,15,95,0.410090971847255,2.05045485923627,0.180722891566265
"United States","Alaska","AK",2020-04-05,2020-04-11,7,2020,"15",731545,84,3,81,3,81,0.410090971847255,0.410090971847255,0.037037037037037
"United States","Alaska","AK",2020-04-12,2020-04-18,7,2020,"16",731545,80,1,82,-2,79,0.136696990615752,-0.273393981231503,-0.024390243902439
"United States","Alaska","AK",2020-04-19,2020-04-25,7,2020,"17",731545,61,0,78,-17,61,0,-2.32384884046778,-0.217948717948718
"United States","Alaska","AK",2020-04-26,2020-05-02,7,2020,"18",731545,87,0,78,9,87,0,1.23027291554176,0.115384615384615
"United States","Alaska","AK",2020-05-03,2020-05-09,7,2020,"19",731545,89,1,77,12,88,0.136696990615752,1.64036388738902,0.155844155844156
"United States","Alaska","AK",2020-05-10,2020-05-16,7,2020,"20",731545,84,0,77,7,84,0,0.956878934310261,0.0909090909090908
"United States","Alaska","AK",2020-05-17,2020-05-23,7,2020,"21",731545,82,0,76,6,82,0,0.82018194369451,0.0789473684210527
"United States","Alaska","AK",2020-05-24,2020-05-30,7,2020,"22",731545,97,0,78,19,97,0,2.59724282169928,0.243589743589744
"United States","Alaska","AK",2020-05-31,2020-06-06,7,2020,"23",731545,79,0,81,-2,79,0,-0.273393981231503,-0.0246913580246914
"United States","Alaska","AK",2020-06-07,2020-06-13,7,2020,"24",731545,88,2,79,9,86,0.273393981231503,1.23027291554176,0.113924050632911
"United States","Alaska","AK",2020-06-14,2020-06-20,7,2020,"25",731545,92,0,84,8,92,0,1.09357592492601,0.0952380952380953
"United States","Alaska","AK",2020-06-21,2020-06-27,7,2020,"26",731545,90,0,87,3,90,0,0.410090971847255,0.0344827586206897
"United States","Alaska","AK",2020-06-28,2020-07-04,7,2020,"27",731545,84,2,85,-1,82,0.273393981231503,-0.136696990615752,-0.0117647058823529
"United States","Alaska","AK",2020-07-05,2020-07-11,7,2020,"28",731545,101,0,85,16,101,0,2.18715184985203,0.188235294117647
"United States","Alaska","AK",2020-07-12,2020-07-18,7,2020,"29",731545,89,4,86,3,85,0.546787962463006,0.410090971847255,0.0348837209302326
"United States","Alaska","AK",2020-07-19,2020-07-25,7,2020,"30",731545,93,2,85,8,91,0.273393981231503,1.09357592492601,0.0941176470588236
"United States","Alaska","AK",2020-07-26,2020-08-01,7,2020,"31",731545,114,4,83,31,110,0.546787962463006,4.2376067090883,0.373493975903614
"United States","Alaska","AK",2020-08-02,2020-08-08,7,2020,"32",731545,101,2,86,15,99,0.273393981231503,2.05045485923627,0.174418604651163
"United States","Alaska","AK",2020-08-09,2020-08-15,7,2020,"33",731545,74,2,86,-12,72,0.273393981231503,-1.64036388738902,-0.13953488372093
"United States","Alaska","AK",2020-08-16,2020-08-22,7,2020,"34",731545,116,3,85,31,113,0.410090971847255,4.2376067090883,0.364705882352941
"United States","Alaska","AK",2020-08-23,2020-08-29,7,2020,"35",731545,93,6,87,6,87,0.82018194369451,0.82018194369451,0.0689655172413792
"United States","Alaska","AK",2020-08-30,2020-09-05,7,2020,"36",731545,105,5,89,16,100,0.683484953078758,2.18715184985203,0.179775280898876
"United States","Alaska","AK",2020-09-06,2020-09-12,7,2020,"37",731545,87,2,85,2,85,0.273393981231503,0.273393981231503,0.0235294117647058
"United States","Alaska","AK",2020-09-13,2020-09-19,7,2020,"38",731545,104,1,86,18,103,0.136696990615752,2.46054583108353,0.209302325581395
"United States","Alaska","AK",2020-09-20,2020-09-26,7,2020,"39",731545,114,7,86,28,107,0.956878934310261,3.82751573724104,0.325581395348837
"United States","Alaska","AK",2020-09-27,2020-10-03,7,2020,"40",731545,78,6,88,-10,72,0.82018194369451,-1.36696990615752,-0.113636363636364
"United States","Alaska","AK",2020-10-04,2020-10-10,7,2020,"41",731545,117,2,89,28,115,0.273393981231503,3.82751573724104,0.314606741573034
"United States","Alaska","AK",2020-10-11,2020-10-17,7,2020,"42",731545,101,7,90,11,94,0.956878934310261,1.50366689677327,0.122222222222222
"United States","Alaska","AK",2020-10-18,2020-10-24,7,2020,"43",731545,102,1,88,14,101,0.136696990615752,1.91375786862052,0.159090909090909
"United States","Alaska","AK",2020-10-25,2020-10-31,7,2020,"44",731545,107,14,89,18,93,1.91375786862052,2.46054583108353,0.202247191011236
"United States","Alaska","AK",2020-11-01,2020-11-07,7,2020,"45",731545,114,1,89,25,113,0.136696990615752,3.41742476539379,0.280898876404494
"United States","Alaska","AK",2020-11-08,2020-11-14,7,2020,"46",731545,114,13,89,25,101,1.77706087800477,3.41742476539379,0.280898876404494
"United States","Alaska","AK",2020-11-15,2020-11-21,7,2020,"47",731545,122,0,90,32,122,0,4.37430369970405,0.355555555555556
"United States","Alaska","AK",2020-11-22,2020-11-28,7,2020,"48",731545,114,0,95,19,114,0,2.59724282169928,0.2
"United States","Alaska","AK",2020-11-29,2020-12-05,7,2020,"49",731545,118,0,97,21,118,0,2.87063680293078,0.216494845360825
"United States","Alaska","AK",2020-12-06,2020-12-12,7,2020,"50",731545,135,72,97,38,63,9.84218332433411,5.19448564339856,0.391752577319588
"United States","Alaska","AK",2020-12-13,2020-12-19,7,2020,"51",731545,99,7,99,0,92,0.956878934310261,0,0
"United States","Alaska","AK",2020-12-20,2020-12-26,7,2020,"52",731545,115,16,99,16,99,2.18715184985203,2.18715184985203,0.161616161616162
"United States","Alaska","AK",2020-12-27,2021-01-02,7,2020,"53",731545,105,15,99,6,90,2.05045485923627,0.82018194369451,0.0606060606060606
"United States","Alaska","AK",2021-01-03,2021-01-09,7,2021,"1",731545,112,8,99,13,104,1.09357592492601,1.77706087800477,0.131313131313131
"United States","Alaska","AK",2021-01-10,2021-01-16,7,2021,"2",731545,128,5,102,26,123,0.683484953078758,3.55412175600954,0.254901960784314
"United States","Alaska","AK",2021-01-17,2021-01-23,7,2021,"3",731545,95,29,102,-7,66,3.9642127278568,-0.956878934310261,-0.0686274509803921
"United States","Alaska","AK",2021-01-24,2021-01-30,7,2021,"4",731545,91,3,101,-10,88,0.410090971847255,-1.36696990615752,-0.099009900990099
"United States","Alaska","AK",2021-01-31,2021-02-06,7,2021,"5",731545,86,16,98,-12,70,2.18715184985203,-1.64036388738902,-0.122448979591837
"United States","Alaska","AK",2021-02-07,2021-02-13,7,2021,"6",731545,92,2,97,-5,90,0.273393981231503,-0.683484953078758,-0.0515463917525774
"United States","Alaska","AK",2021-02-14,2021-02-20,7,2021,"7",731545,86,8,97,-11,78,1.09357592492601,-1.50366689677327,-0.11340206185567
"United States","Alaska","AK",2021-02-21,2021-02-27,7,2021,"8",731545,93,1,97,-4,92,0.136696990615752,-0.546787962463006,-0.0412371134020618
"United States","Alaska","AK",2021-02-28,2021-03-06,7,2021,"9",731545,95,12,97,-2,83,1.64036388738902,-0.273393981231503,-0.020618556701031
"United States","Alaska","AK",2021-03-07,2021-03-13,7,2021,"10",731545,81,1,99,-18,80,0.136696990615752,-2.46054583108353,-0.181818181818182
"United States","Alaska","AK",2021-03-14,2021-03-20,7,2021,"11",731545,100,4,97,3,96,0.546787962463006,0.410090971847255,0.0309278350515463
"United States","Alaska","AK",2021-03-21,2021-03-27,7,2021,"12",731545,91,3,96,-5,88,0.410090971847255,-0.683484953078758,-0.0520833333333334
"United States","Alaska","AK",2021-03-28,2021-04-03,7,2021,"13",731545,81,0,94,-13,81,0,-1.77706087800477,-0.138297872340426
"United States","Alaska","AK",2021-04-04,2021-04-10,7,2021,"14",731545,90,11,93,-3,79,1.50366689677327,-0.410090971847255,-0.032258064516129
"United States","Alaska","AK",2021-04-11,2021-04-17,7,2021,"15",731545,82,20,93,-11,62,2.73393981231503,-1.50366689677327,-0.118279569892473
"United States","Alaska","AK",2021-04-18,2021-04-24,7,2021,"16",731545,68,0,94,-26,68,0,-3.55412175600954,-0.276595744680851
"United States","Alaska","AK",2021-04-25,2021-05-01,7,2021,"17",731545,76,12,94,-18,64,1.64036388738902,-2.46054583108353,-0.191489361702128
"United States","Alaska","AK",2021-05-02,2021-05-08,7,2021,"18",731545,52,2,91,-39,50,0.273393981231503,-5.33118263401431,-0.428571428571429
"United States","Alaska","AK",2021-05-09,2021-05-15,7,2021,"19",731545,51,4,88,-37,47,0.546787962463006,-5.05778865278281,-0.420454545454545
"United States","Alaska","AK",2021-05-16,2021-05-22,7,2021,"20",731545,54,15,85,-31,39,2.05045485923627,-4.2376067090883,-0.364705882352941
"United States","Alaska","AK",2021-05-23,2021-05-29,7,2021,"21",731545,61,0,84,-23,61,0,-3.14403078416229,-0.273809523809524
"United States","Alaska","AK",2021-06-13,2021-06-19,7,2021,"24",731545,48,0,88,-40,48,0,-5.46787962463006,-0.454545454545455
"United States","Alaska","AK",2021-06-27,2021-07-03,7,2021,"26",731545,57,3,93,-36,54,0.410090971847255,-4.92109166216706,-0.387096774193548
"United States","Alaska","AK",2021-07-04,2021-07-10,7,2021,"27",731545,58,2,87,-29,56,0.273393981231503,-3.9642127278568,-0.333333333333333
"United States","Alaska","AK",2021-07-11,2021-07-17,7,2021,"28",731545,70,2,86,-16,68,0.273393981231503,-2.18715184985203,-0.186046511627907
"United States","Alaska","AK",2021-07-18,2021-07-24,7,2021,"29",731545,67,3,87,-20,64,0.410090971847255,-2.73393981231503,-0.229885057471264
"United States","Alaska","AK",2021-07-25,2021-07-31,7,2021,"30",731545,84,5,87,-3,79,0.683484953078758,-0.410090971847255,-0.0344827586206896
"United States","Alaska","AK",2021-08-01,2021-08-07,7,2021,"31",731545,107,8,86,21,99,1.09357592492601,2.87063680293078,0.244186046511628
"United States","Alaska","AK",2021-08-08,2021-08-14,7,2021,"32",731545,66,2,93,-27,64,0.273393981231503,-3.69081874662529,-0.290322580645161
"United States","Alaska","AK",2021-08-15,2021-08-21,7,2021,"33",731545,73,0,94,-21,73,0,-2.87063680293078,-0.223404255319149
"United States","Arizona","AZ",2019-12-29,2020-01-04,7,2020,"1",7278717,1301,0,1325,-24,1301,0,-0.329728439778604,-0.0181132075471698
"United States","Arizona","AZ",2020-01-05,2020-01-11,7,2020,"2",7278717,1391,0,1350,41,1391,0,0.563286084621782,0.0303703703703704
"United States","Arizona","AZ",2020-01-12,2020-01-18,7,2020,"3",7278717,1315,0,1353,-38,1315,0,-0.522070029649456,-0.0280857354028086
"United States","Arizona","AZ",2020-01-19,2020-01-25,7,2020,"4",7278717,1275,0,1344,-69,1275,0,-0.947969264363486,-0.0513392857142857
"United States","Arizona","AZ",2020-01-26,2020-02-01,7,2020,"5",7278717,1265,0,1337,-72,1265,0,-0.989185319335812,-0.0538519072550486
"United States","Arizona","AZ",2020-02-02,2020-02-08,7,2020,"6",7278717,1264,0,1328,-64,1264,0,-0.87927583940961,-0.0481927710843374
"United States","Arizona","AZ",2020-02-09,2020-02-15,7,2020,"7",7278717,1314,0,1314,0,1314,0,0,0
"United States","Arizona","AZ",2020-02-16,2020-02-22,7,2020,"8",7278717,1342,0,1300,42,1342,0,0.577024769612557,0.0323076923076924
"United States","Arizona","AZ",2020-02-23,2020-02-29,7,2020,"9",7278717,1353,0,1308,45,1353,0,0.618240824584882,0.0344036697247707
"United States","Arizona","AZ",2020-03-01,2020-03-07,7,2020,"10",7278717,1380,0,1315,65,1380,0,0.893014524400385,0.0494296577946769
"United States","Arizona","AZ",2020-03-08,2020-03-14,7,2020,"11",7278717,1349,0,1330,19,1349,0,0.261035014824728,0.0142857142857142
"United States","Arizona","AZ",2020-03-15,2020-03-21,7,2020,"12",7278717,1290,1,1322,-32,1289,0.0137386849907752,-0.439637919704805,-0.0242057488653555
"United States","Arizona","AZ",2020-03-22,2020-03-28,7,2020,"13",7278717,1324,14,1305,19,1310,0.192341589870852,0.261035014824728,0.0145593869731802
"United States","Arizona","AZ",2020-03-29,2020-04-04,7,2020,"14",7278717,1357,37,1294,63,1320,0.508331344658681,0.865537154418835,0.0486862442040186
"United States","Arizona","AZ",2020-04-05,2020-04-11,7,2020,"15",7278717,1403,56,1285,118,1347,0.769366359483409,1.62116482891147,0.091828793774319
"United States","Arizona","AZ",2020-04-12,2020-04-18,7,2020,"16",7278717,1316,68,1281,35,1248,0.934230579372711,0.480853974677131,0.0273224043715847
"United States","Arizona","AZ",2020-04-19,2020-04-25,7,2020,"17",7278717,1384,96,1259,125,1288,1.31891375911442,1.7173356238469,0.0992851469420175
"United States","Arizona","AZ",2020-04-26,2020-05-02,7,2020,"18",7278717,1404,74,1228,176,1330,1.01666268931736,2.41800855837643,0.143322475570033
"United States","Arizona","AZ",2020-05-03,2020-05-09,7,2020,"19",7278717,1427,183,1221,206,1244,2.51417935331185,2.83016910809968,0.168714168714169
"United States","Arizona","AZ",2020-05-10,2020-05-16,7,2020,"20",7278717,1306,147,1209,97,1159,2.01958669364395,1.33265244410519,0.0802315963606286
"United States","Arizona","AZ",2020-05-17,2020-05-23,7,2020,"21",7278717,1289,119,1198,91,1170,1.63490351390224,1.25022033416054,0.0759599332220366
"United States","Arizona","AZ",2020-05-24,2020-05-30,7,2020,"22",7278717,1310,101,1193,117,1209,1.38760718406829,1.60742614392069,0.0980720871751886
"United States","Arizona","AZ",2020-05-31,2020-06-06,7,2020,"23",7278717,1399,139,1182,217,1260,1.90967721371775,2.98129464299821,0.183587140439932
"United States","Arizona","AZ",2020-06-07,2020-06-13,7,2020,"24",7278717,1463,148,1192,271,1315,2.03332537863472,3.72318363250007,0.227348993288591
"United States","Arizona","AZ",2020-06-14,2020-06-20,7,2020,"25",7278717,1550,154,1203,347,1396,2.11575748857937,4.76732369179898,0.288445552784705
"United States","Arizona","AZ",2020-06-21,2020-06-27,7,2020,"26",7278717,1617,242,1196,421,1375,3.32476176776759,5.78398638111634,0.352006688963211
"United States","Arizona","AZ",2020-06-28,2020-07-04,7,2020,"27",7278717,1774,226,1178,596,1548,3.10494280791519,8.188256254502,0.505942275042445
"United States","Arizona","AZ",2020-07-05,2020-07-11,7,2020,"28",7278717,1954,346,1171,783,1608,4.7535850068082,10.757390347777,0.66865926558497
"United States","Arizona","AZ",2020-07-12,2020-07-18,7,2020,"29",7278717,1995,579,1164,831,1416,7.95469860965882,11.4168472273342,0.713917525773196
"United States","Arizona","AZ",2020-07-19,2020-07-25,7,2020,"30",7278717,1863,556,1159,704,1307,7.63870885487099,9.67203423350571,0.607420189818809
"United States","Arizona","AZ",2020-07-26,2020-08-01,7,2020,"31",7278717,1792,461,1150,642,1331,6.33353378074735,8.82023576407765,0.558260869565217
"United States","Arizona","AZ",2020-08-02,2020-08-08,7,2020,"32",7278717,1586,390,1133,453,1196,5.35808714640231,6.22362430082115,0.39982347749338
"United States","Arizona","AZ",2020-08-09,2020-08-15,7,2020,"33",7278717,1526,355,1118,408,1171,4.87723317172518,5.60538347623627,0.364937388193202
"United States","Arizona","AZ",2020-08-16,2020-08-22,7,2020,"34",7278717,1505,264,1121,384,1241,3.62701283756464,5.27565503645766,0.342551293487957
"United States","Arizona","AZ",2020-08-23,2020-08-29,7,2020,"35",7278717,1467,251,1119,348,1216,3.44840993268456,4.78106237678976,0.310991957104558
"United States","Arizona","AZ",2020-08-30,2020-09-05,7,2020,"36",7278717,1296,200,1129,167,1096,2.74773699815503,2.29436039345945,0.147918511957484
"United States","Arizona","AZ",2020-09-06,2020-09-12,7,2020,"37",7278717,1282,108,1135,147,1174,1.48377797900372,2.01958669364395,0.129515418502203
"United States","Arizona","AZ",2020-09-13,2020-09-19,7,2020,"38",7278717,1259,152,1137,122,1107,2.08828011859782,1.67611956887457,0.107299912049252
"United States","Arizona","AZ",2020-09-20,2020-09-26,7,2020,"39",7278717,1285,155,1133,152,1130,2.12949617357015,2.08828011859782,0.134157105030891
"United States","Arizona","AZ",2020-09-27,2020-10-03,7,2020,"40",7278717,1202,83,1134,68,1119,1.14031085423434,0.934230579372711,0.0599647266313934
"United States","Arizona","AZ",2020-10-04,2020-10-10,7,2020,"41",7278717,1241,54,1137,104,1187,0.741888989501859,1.42882323904062,0.0914687774846086
"United States","Arizona","AZ",2020-10-11,2020-10-17,7,2020,"42",7278717,1236,65,1128,108,1171,0.893014524400385,1.48377797900372,0.0957446808510638
"United States","Arizona","AZ",2020-10-18,2020-10-24,7,2020,"43",7278717,1282,45,1140,142,1237,0.618240824584882,1.95089326869007,0.124561403508772
"United States","Arizona","AZ",2020-10-25,2020-10-31,7,2020,"44",7278717,1312,109,1140,172,1203,1.49751666399449,2.36305381841333,0.150877192982456
"United States","Arizona","AZ",2020-11-01,2020-11-07,7,2020,"45",7278717,1399,169,1153,246,1230,2.321837763441,3.37971650773069,0.21335646140503
"United States","Arizona","AZ",2020-11-08,2020-11-14,7,2020,"46",7278717,1252,152,1167,85,1100,2.08828011859782,1.16778822421589,0.0728363324764354
"United States","Arizona","AZ",2020-11-15,2020-11-21,7,2020,"47",7278717,1525,157,1197,328,1368,2.1569735435517,4.50628867697425,0.274018379281537
"United States","Arizona","AZ",2020-11-22,2020-11-28,7,2020,"48",7278717,1531,168,1205,326,1363,2.30809907845023,4.4788113069927,0.270539419087137
"United States","Arizona","AZ",2020-11-29,2020-12-05,7,2020,"49",7278717,1696,301,1225,471,1395,4.13534418222332,6.4709206306551,0.384489795918367
"United States","Arizona","AZ",2020-12-06,2020-12-12,7,2020,"50",7278717,2004,397,1231,773,1607,5.45425794133774,10.6200034978692,0.627944760357433
"United States","Arizona","AZ",2020-12-13,2020-12-19,7,2020,"51",7278717,2098,615,1272,826,1483,8.44929126932672,11.3481538023803,0.64937106918239
"United States","Arizona","AZ",2020-12-20,2020-12-26,7,2020,"52",7278717,2205,34,1305,900,2171,0.467115289686355,12.3648164916976,0.689655172413793
"United States","Arizona","AZ",2020-12-27,2021-01-02,7,2020,"53",7278717,2301,1090,1344,957,1211,14.9751666399449,13.1479215361718,0.712053571428571
"United States","Arizona","AZ",2021-01-03,2021-01-09,7,2021,"1",7278717,2423,975,1358,1065,1448,13.3952178660058,14.6316995151755,0.784241531664212
"United States","Arizona","AZ",2021-01-10,2021-01-16,7,2021,"2",7278717,2465,1212,1369,1096,1253,16.6512862088195,15.0575987498896,0.800584368151936
"United States","Arizona","AZ",2021-01-17,2021-01-23,7,2021,"3",7278717,2404,922,1351,1053,1482,12.6670675614947,14.4668352952862,0.779422649888971
"United States","Arizona","AZ",2021-01-24,2021-01-30,7,2021,"4",7278717,2082,927,1328,754,1155,12.7357609864486,10.3589684830445,0.567771084337349
"United States","Arizona","AZ",2021-01-31,2021-02-06,7,2021,"5",7278717,1994,910,1316,678,1084,12.5022033416054,9.31482842374556,0.515197568389058
"United States","Arizona","AZ",2021-02-07,2021-02-13,7,2021,"6",7278717,1739,939,1285,454,800,12.9006252063379,6.23736298581192,0.353307392996109
"United States","Arizona","AZ",2021-02-14,2021-02-20,7,2021,"7",7278717,1552,533,1276,276,1019,7.32271910008316,3.79187705745394,0.216300940438871
"United States","Arizona","AZ",2021-02-21,2021-02-27,7,2021,"8",7278717,1515,501,1286,229,1014,6.88308118037836,3.14615886288751,0.178071539657854
"United States","Arizona","AZ",2021-02-28,2021-03-06,7,2021,"9",7278717,1494,289,1268,226,1205,3.97047996233402,3.10494280791519,0.178233438485804
"United States","Arizona","AZ",2021-03-07,2021-03-13,7,2021,"10",7278717,1411,284,1259,152,1127,3.90178653738015,2.08828011859782,0.120730738681493
"United States","Arizona","AZ",2021-03-14,2021-03-20,7,2021,"11",7278717,1397,139,1248,149,1258,1.90967721371775,2.0470640636255,0.119391025641026
"United States","Arizona","AZ",2021-03-21,2021-03-27,7,2021,"12",7278717,1294,226,1264,30,1068,3.10494280791519,0.412160549723255,0.0237341772151898
"United States","Arizona","AZ",2021-03-28,2021-04-03,7,2021,"13",7278717,1353,87,1248,105,1266,1.19526559419744,1.44256192403139,0.0841346153846154
"United States","Arizona","AZ",2021-04-04,2021-04-10,7,2021,"14",7278717,1278,81,1234,44,1197,1.11283348425279,0.604502139594107,0.0356564019448946
"United States","Arizona","AZ",2021-04-11,2021-04-17,7,2021,"15",7278717,1326,65,1218,108,1261,0.893014524400385,1.48377797900372,0.0886699507389161
"United States","Arizona","AZ",2021-04-18,2021-04-24,7,2021,"16",7278717,1255,117,1192,63,1138,1.60742614392069,0.865537154418835,0.0528523489932886
"United States","Arizona","AZ",2021-04-25,2021-05-01,7,2021,"17",7278717,1284,70,1184,100,1214,0.961707949354261,1.37386849907752,0.0844594594594594
"United States","Arizona","AZ",2021-05-02,2021-05-08,7,2021,"18",7278717,1420,69,1168,252,1351,0.947969264363486,3.46214861767534,0.215753424657534
"United States","Arizona","AZ",2021-05-09,2021-05-15,7,2021,"19",7278717,1324,59,1159,165,1265,0.810582414455735,2.2668830234779,0.142364106988783
"United States","Arizona","AZ",2021-05-16,2021-05-22,7,2021,"20",7278717,1260,81,1151,109,1179,1.11283348425279,1.49751666399449,0.0947002606429193
"United States","Arizona","AZ",2021-05-23,2021-05-29,7,2021,"21",7278717,1255,81,1137,118,1174,1.11283348425279,1.62116482891147,0.103781882145998
"United States","Arizona","AZ",2021-05-30,2021-06-05,7,2021,"22",7278717,1336,72,1135,201,1264,0.989185319335812,2.76147568314581,0.177092511013216
"United States","Arizona","AZ",2021-06-06,2021-06-12,7,2021,"23",7278717,1305,40,1149,156,1265,0.549547399631006,2.14323485856092,0.135770234986945
"United States","Arizona","AZ",2021-06-13,2021-06-19,7,2021,"24",7278717,1361,82,1147,214,1279,1.12657216924356,2.94007858802588,0.186573670444638
"United States","Arizona","AZ",2021-06-20,2021-06-26,7,2021,"25",7278717,1388,81,1162,226,1307,1.11283348425279,3.10494280791519,0.194492254733219
"United States","Arizona","AZ",2021-06-27,2021-07-03,7,2021,"26",7278717,1329,58,1160,169,1271,0.796843729464959,2.321837763441,0.145689655172414
"United States","Arizona","AZ",2021-07-04,2021-07-10,7,2021,"27",7278717,1305,48,1156,149,1257,0.659456879557208,2.0470640636255,0.128892733564014
"United States","Arizona","AZ",2021-07-11,2021-07-17,7,2021,"28",7278717,1371,91,1155,216,1280,1.25022033416054,2.96755595800743,0.187012987012987
"United States","Arizona","AZ",2021-07-18,2021-07-24,7,2021,"29",7278717,1264,44,1156,108,1220,0.604502139594107,1.48377797900372,0.0934256055363323
"United States","Arizona","AZ",2021-07-25,2021-07-31,7,2021,"30",7278717,1313,80,1137,176,1233,1.09909479926201,2.41800855837643,0.154793315743184
"United States","Arizona","AZ",2021-08-01,2021-08-07,7,2021,"31",7278717,1503,118,1126,377,1385,1.62116482891147,5.17948424152223,0.334813499111901
"United States","Arizona","AZ",2021-08-08,2021-08-14,7,2021,"32",7278717,1483,93,1133,350,1390,1.27769770414209,4.80853974677131,0.30891438658429
"United States","Arizona","AZ",2021-08-15,2021-08-21,7,2021,"33",7278717,1519,29,1144,375,1490,0.39842186473248,5.15200687154069,0.327797202797203
"United States","Arkansas","AR",2019-12-29,2020-01-04,7,2020,"1",3017825,672,0,741,-69,672,0,-2.28641488489227,-0.0931174089068826
"United States","Arkansas","AR",2020-01-05,2020-01-11,7,2020,"2",3017825,686,0,730,-44,686,0,-1.45800369471391,-0.0602739726027397
"United States","Arkansas","AR",2020-01-12,2020-01-18,7,2020,"3",3017825,658,0,705,-47,658,0,-1.55741303753531,-0.0666666666666667
"United States","Arkansas","AR",2020-01-19,2020-01-25,7,2020,"4",3017825,616,0,684,-68,616,0,-2.25327843728513,-0.0994152046783626
"United States","Arkansas","AR",2020-01-26,2020-02-01,7,2020,"5",3017825,681,0,681,0,681,0,0,0
"United States","Arkansas","AR",2020-02-02,2020-02-08,7,2020,"6",3017825,673,0,671,2,673,0,0.0662728952142686,0.00298062593144555
"United States","Arkansas","AR",2020-02-09,2020-02-15,7,2020,"7",3017825,688,0,679,9,688,0,0.298228028464209,0.0132547864506627
"United States","Arkansas","AR",2020-02-16,2020-02-22,7,2020,"8",3017825,697,0,675,22,697,0,0.729001847356954,0.0325925925925925
"United States","Arkansas","AR",2020-02-23,2020-02-29,7,2020,"9",3017825,656,0,662,-6,656,0,-0.198818685642806,-0.00906344410876136
"United States","Arkansas","AR",2020-03-01,2020-03-07,7,2020,"10",3017825,697,0,656,41,697,0,1.35859435189251,0.0625
"United States","Arkansas","AR",2020-03-08,2020-03-14,7,2020,"11",3017825,628,0,647,-19,628,0,-0.629592504535551,-0.0293663060278208
"United States","Arkansas","AR",2020-03-15,2020-03-21,7,2020,"12",3017825,640,0,646,-6,640,0,-0.198818685642806,-0.00928792569659442
"United States","Arkansas","AR",2020-03-22,2020-03-28,7,2020,"13",3017825,641,5,638,3,636,0.165682238035671,0.0994093428214028,0.00470219435736685
"United States","Arkansas","AR",2020-03-29,2020-04-04,7,2020,"14",3017825,606,8,630,-24,598,0.265091580857074,-0.795274742571223,-0.0380952380952381
"United States","Arkansas","AR",2020-04-05,2020-04-11,7,2020,"15",3017825,636,12,626,10,624,0.397637371285611,0.331364476071343,0.0159744408945688
"United States","Arkansas","AR",2020-04-12,2020-04-18,7,2020,"16",3017825,637,12,625,12,625,0.397637371285611,0.397637371285611,0.0192000000000001
"United States","Arkansas","AR",2020-04-19,2020-04-25,7,2020,"17",3017825,615,10,620,-5,605,0.331364476071343,-0.165682238035671,-0.00806451612903225
"United States","Arkansas","AR",2020-04-26,2020-05-02,7,2020,"18",3017825,630,25,612,18,605,0.828411190178357,0.596456056928417,0.0294117647058822
"United States","Arkansas","AR",2020-05-03,2020-05-09,7,2020,"19",3017825,661,16,608,53,645,0.530183161714148,1.75623172317812,0.087171052631579
"United States","Arkansas","AR",2020-05-10,2020-05-16,7,2020,"20",3017825,583,10,608,-25,573,0.331364476071343,-0.828411190178357,-0.0411184210526315
"United States","Arkansas","AR",2020-05-17,2020-05-23,7,2020,"21",3017825,642,17,603,39,625,0.563319609321283,1.29232145667824,0.0646766169154229
"United States","Arkansas","AR",2020-05-24,2020-05-30,7,2020,"22",3017825,610,18,604,6,592,0.596456056928417,0.198818685642806,0.00993377483443703
"United States","Arkansas","AR",2020-05-31,2020-06-06,7,2020,"23",3017825,649,20,598,51,629,0.662728952142685,1.68995882796385,0.0852842809364549
"United States","Arkansas","AR",2020-06-07,2020-06-13,7,2020,"24",3017825,652,24,587,65,628,0.795274742571223,2.15386909446373,0.110732538330494
"United States","Arkansas","AR",2020-06-14,2020-06-20,7,2020,"25",3017825,708,47,586,122,661,1.55741303753531,4.04264660807038,0.208191126279863
"United States","Arkansas","AR",2020-06-21,2020-06-27,7,2020,"26",3017825,663,35,592,71,628,1.1597756662497,2.35268778010653,0.119932432432432
"United States","Arkansas","AR",2020-06-28,2020-07-04,7,2020,"27",3017825,687,27,596,91,660,0.894684085392626,3.01541673224922,0.152684563758389
"United States","Arkansas","AR",2020-07-05,2020-07-11,7,2020,"28",3017825,661,33,598,63,628,1.09350277103543,2.08759619924946,0.105351170568562
"United States","Arkansas","AR",2020-07-12,2020-07-18,7,2020,"29",3017825,695,38,585,110,657,1.2591850090711,3.64500923678477,0.188034188034188
"United States","Arkansas","AR",2020-07-19,2020-07-25,7,2020,"30",3017825,714,42,582,132,672,1.39173079949964,4.37401108414173,0.22680412371134
"United States","Arkansas","AR",2020-07-26,2020-08-01,7,2020,"31",3017825,750,59,580,170,691,1.95505040882092,5.63319609321283,0.293103448275862
"United States","Arkansas","AR",2020-08-02,2020-08-08,7,2020,"32",3017825,736,77,575,161,659,2.55150646574934,5.33496806474862,0.28
"United States","Arkansas","AR",2020-08-09,2020-08-15,7,2020,"33",3017825,766,65,576,190,701,2.15386909446373,6.29592504535551,0.329861111111111
"United States","Arkansas","AR",2020-08-16,2020-08-22,7,2020,"34",3017825,750,74,569,181,676,2.45209712292794,5.9976970168913,0.318101933216169
"United States","Arkansas","AR",2020-08-23,2020-08-29,7,2020,"35",3017825,739,98,578,161,641,3.24737186549916,5.33496806474862,0.278546712802768
"United States","Arkansas","AR",2020-08-30,2020-09-05,7,2020,"36",3017825,713,110,581,132,603,3.64500923678477,4.37401108414173,0.227194492254733
"United States","Arkansas","AR",2020-09-06,2020-09-12,7,2020,"37",3017825,722,71,585,137,651,2.35268778010653,4.5396933221774,0.234188034188034
"United States","Arkansas","AR",2020-09-13,2020-09-19,7,2020,"38",3017825,736,228,586,150,508,7.55511005442661,4.97046714107014,0.255972696245734
"United States","Arkansas","AR",2020-09-20,2020-09-26,7,2020,"39",3017825,746,104,580,166,642,3.44619055114196,5.50065030278429,0.286206896551724
"United States","Arkansas","AR",2020-09-27,2020-10-03,7,2020,"40",3017825,784,122,570,214,662,4.04264660807038,7.09119978792673,0.375438596491228
"United States","Arkansas","AR",2020-10-04,2020-10-10,7,2020,"41",3017825,785,145,558,227,640,4.80478490303447,7.52197360681948,0.406810035842294
"United States","Arkansas","AR",2020-10-11,2020-10-17,7,2020,"42",3017825,778,132,569,209,646,4.37401108414173,6.92551754989106,0.367311072056239
"United States","Arkansas","AR",2020-10-18,2020-10-24,7,2020,"43",3017825,794,113,583,211,681,3.74441857960617,6.99179044510533,0.361921097770154
"United States","Arkansas","AR",2020-10-25,2020-10-31,7,2020,"44",3017825,790,127,597,193,663,4.20832884610605,6.39533438817692,0.323283082077052
"United States","Arkansas","AR",2020-11-01,2020-11-07,7,2020,"45",3017825,845,142,615,230,703,4.70537556021307,7.62138294964088,0.373983739837398
"United States","Arkansas","AR",2020-11-08,2020-11-14,7,2020,"46",3017825,893,89,618,275,804,2.94914383703495,9.11252309196193,0.444983818770227
"United States","Arkansas","AR",2020-11-15,2020-11-21,7,2020,"47",3017825,876,174,621,255,702,5.76574188364136,8.44979413981924,0.410628019323672
"United States","Arkansas","AR",2020-11-22,2020-11-28,7,2020,"48",3017825,833,107,639,194,726,3.54559989396337,6.42847083578405,0.303599374021909
"United States","Arkansas","AR",2020-11-29,2020-12-05,7,2020,"49",3017825,944,184,656,288,760,6.09710635971271,9.54329691085467,0.439024390243902
"United States","Arkansas","AR",2020-12-06,2020-12-12,7,2020,"50",3017825,912,290,667,245,622,9.60956980606894,8.1184296637479,0.367316341829085
"United States","Arkansas","AR",2020-12-13,2020-12-19,7,2020,"51",3017825,936,281,688,248,655,9.31134177760473,8.2178390065693,0.36046511627907
"United States","Arkansas","AR",2020-12-20,2020-12-26,7,2020,"52",3017825,922,250,701,221,672,8.28411190178357,7.32315492117668,0.315263908701855
"United States","Arkansas","AR",2020-12-27,2021-01-02,7,2020,"53",3017825,968,288,705,263,680,9.54329691085467,8.71488572067631,0.373049645390071
"United States","Arkansas","AR",2021-01-03,2021-01-09,7,2021,"1",3017825,962,281,704,258,681,9.31134177760473,8.54920348264064,0.366477272727273
"United States","Arkansas","AR",2021-01-10,2021-01-16,7,2021,"2",3017825,962,283,700,262,679,9.377614672819,8.68174927306918,0.374285714285714
"United States","Arkansas","AR",2021-01-17,2021-01-23,7,2021,"3",3017825,983,270,674,309,713,8.94684085392626,10.2391623106045,0.458456973293768
"United States","Arkansas","AR",2021-01-24,2021-01-30,7,2021,"4",3017825,873,275,675,198,598,9.11252309196193,6.56101662621259,0.293333333333333
"United States","Arkansas","AR",2021-01-31,2021-02-06,7,2021,"5",3017825,863,223,679,184,640,7.38942781639094,6.09710635971271,0.270986745213549
"United States","Arkansas","AR",2021-02-07,2021-02-13,7,2021,"6",3017825,802,191,672,130,611,6.32906149296265,4.30773818892746,0.193452380952381
"United States","Arkansas","AR",2021-02-14,2021-02-20,7,2021,"7",3017825,773,96,663,110,677,3.18109897028489,3.64500923678477,0.165912518853695
"United States","Arkansas","AR",2021-02-21,2021-02-27,7,2021,"8",3017825,788,72,664,124,716,2.38582422771367,4.10891950328465,0.186746987951807
"United States","Arkansas","AR",2021-02-28,2021-03-06,7,2021,"9",3017825,742,19,652,90,723,0.629592504535551,2.98228028464208,0.138036809815951
"United States","Arkansas","AR",2021-03-07,2021-03-13,7,2021,"10",3017825,718,87,638,80,631,2.88287094182068,2.65091580857074,0.125391849529781
"United States","Arkansas","AR",2021-03-14,2021-03-20,7,2021,"11",3017825,649,67,632,17,582,2.220141989678,0.563319609321283,0.0268987341772151
"United States","Arkansas","AR",2021-03-21,2021-03-27,7,2021,"12",3017825,705,49,625,80,656,1.62368593274958,2.65091580857074,0.128
"United States","Arkansas","AR",2021-03-28,2021-04-03,7,2021,"13",3017825,604,-1,613,-9,605,-0.0331364476071343,-0.298228028464209,-0.0146818923327896
"United States","Arkansas","AR",2021-04-04,2021-04-10,7,2021,"14",3017825,694,20,602,92,674,0.662728952142685,3.04855317985635,0.152823920265781
"United States","Arkansas","AR",2021-04-11,2021-04-17,7,2021,"15",3017825,612,32,596,16,580,1.0603663234283,0.530183161714148,0.0268456375838926
"United States","Arkansas","AR",2021-04-18,2021-04-24,7,2021,"16",3017825,663,24,593,70,639,0.795274742571223,2.3195513324994,0.118043844856661
"United States","Arkansas","AR",2021-04-25,2021-05-01,7,2021,"17",3017825,652,24,594,58,628,0.795274742571223,1.92191396121379,0.0976430976430978
"United States","Arkansas","AR",2021-05-02,2021-05-08,7,2021,"18",3017825,699,19,590,109,680,0.629592504535551,3.61187278917764,0.184745762711864
"United States","Arkansas","AR",2021-05-09,2021-05-15,7,2021,"19",3017825,693,33,592,101,660,1.09350277103543,3.34678120832056,0.170608108108108
"United States","Arkansas","AR",2021-05-16,2021-05-22,7,2021,"20",3017825,681,23,589,92,658,0.762138294964088,3.04855317985635,0.156196943972835
"United States","Arkansas","AR",2021-05-23,2021-05-29,7,2021,"21",3017825,653,14,594,59,639,0.46391026649988,1.95505040882092,0.0993265993265993
"United States","Arkansas","AR",2021-05-30,2021-06-05,7,2021,"22",3017825,674,16,589,85,658,0.530183161714148,2.81659804660641,0.144312393887946
"United States","Arkansas","AR",2021-06-06,2021-06-12,7,2021,"23",3017825,662,14,583,79,648,0.46391026649988,2.61777936096361,0.135506003430532
"United States","Arkansas","AR",2021-06-13,2021-06-19,7,2021,"24",3017825,693,14,581,112,679,0.46391026649988,3.71128213199904,0.192771084337349
"United States","Arkansas","AR",2021-06-20,2021-06-26,7,2021,"25",3017825,658,19,581,77,639,0.629592504535551,2.55150646574934,0.132530120481928
"United States","Arkansas","AR",2021-06-27,2021-07-03,7,2021,"26",3017825,686,20,579,107,666,0.662728952142685,3.54559989396337,0.184801381692573
"United States","Arkansas","AR",2021-07-04,2021-07-10,7,2021,"27",3017825,688,35,579,109,653,1.1597756662497,3.61187278917764,0.18825561312608
"United States","Arkansas","AR",2021-07-11,2021-07-17,7,2021,"28",3017825,722,33,579,143,689,1.09350277103543,4.7385120078202,0.246977547495682
"United States","Arkansas","AR",2021-07-18,2021-07-24,7,2021,"29",3017825,725,60,575,150,665,1.98818685642806,4.97046714107014,0.260869565217391
"United States","Arkansas","AR",2021-07-25,2021-07-31,7,2021,"30",3017825,837,82,578,259,755,2.71718870378501,8.58233993024778,0.448096885813149
"United States","Arkansas","AR",2021-08-01,2021-08-07,7,2021,"31",3017825,902,146,577,325,756,4.8379213506416,10.7693454723186,0.563258232235702
"United States","Arkansas","AR",2021-08-08,2021-08-14,7,2021,"32",3017825,895,163,577,318,732,5.40124095996289,10.5373903390687,0.551126516464471
"United States","Arkansas","AR",2021-08-15,2021-08-21,7,2021,"33",3017825,802,66,574,228,736,2.18700554207086,7.55511005442661,0.397212543554007
"United States","California","CA",2019-12-29,2020-01-04,7,2020,"1",39512223,5888,0,6353,-465,5888,0,-1.17685102151808,-0.0731937667243822
"United States","California","CA",2020-01-05,2020-01-11,7,2020,"2",39512223,5873,0,6365,-492,5873,0,-1.24518430663848,-0.0772977219167321
"United States","California","CA",2020-01-12,2020-01-18,7,2020,"3",39512223,5830,0,6213,-383,5830,0,-0.969320303744996,-0.0616449380331563
"United States","California","CA",2020-01-19,2020-01-25,7,2020,"4",39512223,5832,0,6088,-256,5832,0,-0.647900777437908,-0.0420499342969777
"United States","California","CA",2020-01-26,2020-02-01,7,2020,"5",39512223,5686,0,6005,-319,5686,0,-0.807345109385519,-0.0531223980016653
"United States","California","CA",2020-02-02,2020-02-08,7,2020,"6",39512223,5913,1,5893,20,5912,0.00253086241186683,0.0506172482373366,0.0033938571186154
"United States","California","CA",2020-02-09,2020-02-15,7,2020,"7",39512223,5588,0,5866,-278,5588,0,-0.703579750498978,-0.0473917490623934
"United States","California","CA",2020-02-16,2020-02-22,7,2020,"8",39512223,5797,1,5783,14,5796,0.00253086241186683,0.0354320737661356,0.00242088881203517
"United States","California","CA",2020-02-23,2020-02-29,7,2020,"9",39512223,5680,0,5730,-50,5680,0,-0.126543120593341,-0.00872600349040142
"United States","California","CA",2020-03-01,2020-03-07,7,2020,"10",39512223,5736,2,5773,-37,5734,0.00506172482373366,-0.0936419092390727,-0.0064091460245973
"United States","California","CA",2020-03-08,2020-03-14,7,2020,"11",39512223,5465,3,5709,-244,5462,0.00759258723560049,-0.617530428495506,-0.0427395340690139
"United States","California","CA",2020-03-15,2020-03-21,7,2020,"12",39512223,5681,23,5638,43,5658,0.0582098354729371,0.108827083710274,0.00762681802057474
"United States","California","CA",2020-03-22,2020-03-28,7,2020,"13",39512223,5689,94,5501,188,5595,0.237901066715482,0.475802133430964,0.0341756044355572
"United States","California","CA",2020-03-29,2020-04-04,7,2020,"14",39512223,5986,199,5390,596,5787,0.503641619961499,1.50839399747263,0.110575139146568
"United States","California","CA",2020-04-05,2020-04-11,7,2020,"15",39512223,6047,309,5350,697,5738,0.78203648526685,1.76401110107118,0.130280373831776
"United States","California","CA",2020-04-12,2020-04-18,7,2020,"16",39512223,6131,515,5315,816,5616,1.30339414211142,2.06518372808333,0.153527751646284
"United States","California","CA",2020-04-19,2020-04-25,7,2020,"17",39512223,5938,543,5273,665,5395,1.37425828964369,1.68302350389144,0.126114166508629
"United States","California","CA",2020-04-26,2020-05-02,7,2020,"18",39512223,5744,495,5186,558,5249,1.25277689387408,1.41222122582169,0.107597377554956
"United States","California","CA",2020-05-03,2020-05-09,7,2020,"19",39512223,5671,504,5137,534,5167,1.27555465558088,1.35148052793689,0.103951722795406
"United States","California","CA",2020-05-10,2020-05-16,7,2020,"20",39512223,5695,519,5116,579,5176,1.31351759175888,1.46536933647089,0.113174354964816
"United States","California","CA",2020-05-17,2020-05-23,7,2020,"21",39512223,5530,527,5087,443,5003,1.33376449105382,1.12117204845701,0.0870847257715746
"United States","California","CA",2020-05-24,2020-05-30,7,2020,"22",39512223,5593,406,4997,596,5187,1.02753013921793,1.50839399747263,0.119271562937763
"United States","California","CA",2020-05-31,2020-06-06,7,2020,"23",39512223,5518,463,4980,538,5055,1.17178929669434,1.36160397758435,0.108032128514056
"United States","California","CA",2020-06-07,2020-06-13,7,2020,"24",39512223,5570,451,4965,605,5119,1.14141894775194,1.53117175917943,0.121852970795569
"United States","California","CA",2020-06-14,2020-06-20,7,2020,"25",39512223,5489,431,4981,508,5058,1.0908016995146,1.28567810522835,0.101987552700261
"United States","California","CA",2020-06-21,2020-06-27,7,2020,"26",39512223,5701,412,4963,738,5289,1.04271531368913,1.86777645995772,0.148700382832964
"United States","California","CA",2020-06-28,2020-07-04,7,2020,"27",39512223,5901,432,4921,980,5469,1.09333256192647,2.48024516362949,0.199146514935989
"United States","California","CA",2020-07-05,2020-07-11,7,2020,"28",39512223,6042,696,4878,1164,5346,1.76148023865931,2.94592384741299,0.238622386223862
"United States","California","CA",2020-07-12,2020-07-18,7,2020,"29",39512223,6230,676,4815,1415,5554,1.71086299042198,3.58117031279156,0.293873312564901
"United States","California","CA",2020-07-19,2020-07-25,7,2020,"30",39512223,6250,726,4840,1410,5524,1.83740611101532,3.56851600073223,0.291322314049587
"United States","California","CA",2020-07-26,2020-08-01,7,2020,"31",39512223,6339,933,4803,1536,5406,2.36129463027175,3.88740466462745,0.319800124921924
"United States","California","CA",2020-08-02,2020-08-08,7,2020,"32",39512223,6309,924,4792,1517,5385,2.33851686856495,3.83931827880198,0.316569282136895
"United States","California","CA",2020-08-09,2020-08-15,7,2020,"33",39512223,6291,937,4737,1554,5354,2.37141807991922,3.93296018804105,0.328055731475617
"United States","California","CA",2020-08-16,2020-08-22,7,2020,"34",39512223,6478,894,4756,1722,5584,2.26259099620894,4.35814507323468,0.362068965517241
"United States","California","CA",2020-08-23,2020-08-29,7,2020,"35",39512223,5878,789,4744,1134,5089,1.99685044296293,2.86999797505698,0.239038785834739
"United States","California","CA",2020-08-30,2020-09-05,7,2020,"36",39512223,5784,802,4761,1023,4982,2.0297516543172,2.58907224733977,0.214870825456837
"United States","California","CA",2020-09-06,2020-09-12,7,2020,"37",39512223,5874,626,4775,1099,5248,1.58431986982864,2.78141779064165,0.230157068062827
"United States","California","CA",2020-09-13,2020-09-19,7,2020,"38",39512223,5755,654,4826,929,5101,1.65518401736091,2.35117118062428,0.192498963945296
"United States","California","CA",2020-09-20,2020-09-26,7,2020,"39",39512223,5563,547,4811,752,5016,1.38438173929116,1.90320853372386,0.156308459779672
"United States","California","CA",2020-09-27,2020-10-03,7,2020,"40",39512223,5671,608,4807,864,5063,1.53876434641503,2.18666512385294,0.179737882255045
"United States","California","CA",2020-10-04,2020-10-10,7,2020,"41",39512223,5568,447,4812,756,5121,1.13129549810447,1.91333198337132,0.1571072319202
"United States","California","CA",2020-10-11,2020-10-17,7,2020,"42",39512223,5621,375,4815,806,5246,0.949073404450061,2.03987510396466,0.167393561786085
"United States","California","CA",2020-10-18,2020-10-24,7,2020,"43",39512223,5351,381,4812,539,4970,0.964258578921262,1.36413483999622,0.112011637572735
"United States","California","CA",2020-10-25,2020-10-31,7,2020,"44",39512223,5529,314,4835,694,5215,0.794690797326184,1.75641851383558,0.1435367114788
"United States","California","CA",2020-11-01,2020-11-07,7,2020,"45",39512223,5872,305,4870,1002,5567,0.771913035619383,2.53592413669056,0.205749486652977
"United States","California","CA",2020-11-08,2020-11-14,7,2020,"46",39512223,6004,288,4913,1091,5716,0.728888374617647,2.76117089134671,0.222063912070018
"United States","California","CA",2020-11-15,2020-11-21,7,2020,"47",39512223,6350,345,4975,1375,6005,0.873147532094056,3.47993581631689,0.276381909547739
"United States","California","CA",2020-11-22,2020-11-28,7,2020,"48",39512223,6390,536,5056,1334,5854,1.35654225276062,3.37617045743035,0.263844936708861
"United States","California","CA",2020-11-29,2020-12-05,7,2020,"49",39512223,7164,746,5135,2029,6418,1.88802335925265,5.1351198336778,0.395131450827653
"United States","California","CA",2020-12-06,2020-12-12,7,2020,"50",39512223,8149,1092,5247,2902,7057,2.76370175375858,7.34456271923754,0.553077949304364
"United States","California","CA",2020-12-13,2020-12-19,7,2020,"51",39512223,9233,1612,5377,3856,7621,4.07975020792933,9.75900546015849,0.717128510321741
"United States","California","CA",2020-12-20,2020-12-26,7,2020,"52",39512223,10563,1400,5514,5049,9163,3.54320737661356,12.7783243175156,0.915669205658324
"United States","California","CA",2020-12-27,2021-01-02,7,2020,"53",39512223,11270,2374,5657,5613,8896,6.00826736577185,14.2057307178085,0.992222025808733
"United States","California","CA",2021-01-03,2021-01-09,7,2021,"1",39512223,11900,2876,5839,6061,9024,7.278760296529,15.3395570783249,1.03802020893989
"United States","California","CA",2021-01-10,2021-01-16,7,2021,"2",39512223,11574,3727,5860,5714,7847,9.43252420902767,14.4613478214071,0.975085324232082
"United States","California","CA",2021-01-17,2021-01-23,7,2021,"3",39512223,10402,3400,5836,4566,7002,8.60493220034722,11.5559177725839,0.782385195339274
"United States","California","CA",2021-01-24,2021-01-30,7,2021,"4",39512223,9590,3856,5793,3797,5734,9.75900546015849,9.60968457785835,0.655446228206456
"United States","California","CA",2021-01-31,2021-02-06,7,2021,"5",39512223,8766,3431,5756,3010,5335,8.68338893511509,7.61789585971916,0.522932592077832
"United States","California","CA",2021-02-07,2021-02-13,7,2021,"6",39512223,7856,2788,5694,2162,5068,7.05604440428472,5.47172453445608,0.379697927643133
"United States","California","CA",2021-02-14,2021-02-20,7,2021,"7",39512223,7008,2390,5707,1301,4618,6.04876116436172,3.29265199783874,0.22796565621167
"United States","California","CA",2021-02-21,2021-02-27,7,2021,"8",39512223,6713,2996,5738,975,3717,7.58246378595302,2.46759085157016,0.169919832694319
"United States","California","CA",2021-02-28,2021-03-06,7,2021,"9",39512223,6443,1901,5728,715,4542,4.81116944495884,1.80956662448478,0.124825418994413
"United States","California","CA",2021-03-07,2021-03-13,7,2021,"10",39512223,6200,1513,5674,526,4687,3.82919482915451,1.33123362864195,0.0927035600986958
"United States","California","CA",2021-03-14,2021-03-20,7,2021,"11",39512223,6002,883,5532,470,5119,2.23475150967841,1.18950533357741,0.0849602313810556
"United States","California","CA",2021-03-21,2021-03-27,7,2021,"12",39512223,5798,1628,5435,363,4170,4.1202440065192,0.918703055507659,0.066789328426863
"United States","California","CA",2021-03-28,2021-04-03,7,2021,"13",39512223,5757,683,5344,413,5074,1.72857902730504,1.045246176101,0.0772829341317365
"United States","California","CA",2021-04-04,2021-04-10,7,2021,"14",39512223,5427,684,5254,173,4743,1.73110988971691,0.437839197252961,0.0329272934906737
"United States","California","CA",2021-04-11,2021-04-17,7,2021,"15",39512223,5346,577,5192,154,4769,1.46030761164716,0.389752811427492,0.0296610169491525
"United States","California","CA",2021-04-18,2021-04-24,7,2021,"16",39512223,5363,445,5074,289,4918,1.12623377328074,0.731419237029514,0.0569570358691367
"United States","California","CA",2021-04-25,2021-05-01,7,2021,"17",39512223,5390,490,5011,379,4900,1.24012258181475,0.959196854097528,0.0756336060666534
"United States","California","CA",2021-05-02,2021-05-08,7,2021,"18",39512223,5366,542,5013,353,4824,1.37172742723182,0.893394431388991,0.0704169160183523
"United States","California","CA",2021-05-09,2021-05-15,7,2021,"19",39512223,5267,277,4993,274,4990,0.701048888087112,0.693456300851511,0.054876827558582
"United States","California","CA",2021-05-16,2021-05-22,7,2021,"20",39512223,5263,278,4964,299,4985,0.703579750498978,0.756727861148182,0.0602336825141014
"United States","California","CA",2021-05-23,2021-05-29,7,2021,"21",39512223,5349,59,4949,400,5290,0.149320882300143,1.01234496474673,0.0808244089715093
"United States","California","CA",2021-05-30,2021-06-05,7,2021,"22",39512223,5200,247,4919,281,4953,0.625123015731107,0.711172337734579,0.0571254319983736
"United States","California","CA",2021-06-06,2021-06-12,7,2021,"23",39512223,5170,258,4967,203,4912,0.652962502261642,0.513765069608966,0.0408697402858869
"United States","California","CA",2021-06-13,2021-06-19,7,2021,"24",39512223,5464,130,4959,505,5334,0.329012113542688,1.27808551799275,0.101835047388587
"United States","California","CA",2021-06-20,2021-06-26,7,2021,"25",39512223,5330,323,4939,391,5007,0.817468559032986,0.98956720303993,0.0791658230411014
"United States","California","CA",2021-06-27,2021-07-03,7,2021,"26",39512223,5228,250,4847,381,4978,0.632715602966707,0.964258578921262,0.078605322880132
"United States","California","CA",2021-07-04,2021-07-10,7,2021,"27",39512223,5244,237,4851,393,5007,0.599814391612439,0.994628927863664,0.0810142238713667
"United States","California","CA",2021-07-11,2021-07-17,7,2021,"28",39512223,5246,225,4858,388,5021,0.569444042670037,0.98197461580433,0.07986825854261
"United States","California","CA",2021-07-18,2021-07-24,7,2021,"29",39512223,5383,144,4866,517,5239,0.364444187308823,1.30845586693515,0.106247431154953
"United States","California","CA",2021-07-25,2021-07-31,7,2021,"30",39512223,5396,196,4862,534,5200,0.496049032725899,1.35148052793689,0.109831345125463
"United States","California","CA",2021-08-01,2021-08-07,7,2021,"31",39512223,5549,300,4794,755,5249,0.759258723560049,1.91080112095946,0.157488527325824
"United States","California","CA",2021-08-08,2021-08-14,7,2021,"32",39512223,5571,-155,4757,814,5726,-0.392283673839358,2.0601220032596,0.171116249737229
"United States","California","CA",2021-08-15,2021-08-21,7,2021,"33",39512223,5342,104,4840,502,5238,0.26320969083415,1.27049293075715,0.103719008264463
"United States","Colorado","CO",2019-12-29,2020-01-04,7,2020,"1",5758736,854,0,849,5,854,0,0.0868246087335832,0.00588928150765611
"United States","Colorado","CO",2020-01-05,2020-01-11,7,2020,"2",5758736,872,0,851,21,872,0,0.364663356681049,0.0246768507638073
"United States","Colorado","CO",2020-01-12,2020-01-18,7,2020,"3",5758736,848,0,853,-5,848,0,-0.0868246087335832,-0.00586166471277838
"United States","Colorado","CO",2020-01-19,2020-01-25,7,2020,"4",5758736,853,0,848,5,853,0,0.0868246087335832,0.00589622641509435
"United States","Colorado","CO",2020-01-26,2020-02-01,7,2020,"5",5758736,793,0,829,-36,793,0,-0.625137182881799,-0.0434258142340169
"United States","Colorado","CO",2020-02-02,2020-02-08,7,2020,"6",5758736,847,0,828,19,847,0,0.329933513187616,0.0229468599033817
"United States","Colorado","CO",2020-02-09,2020-02-15,7,2020,"7",5758736,807,0,820,-13,807,0,-0.225743982707316,-0.0158536585365854
"United States","Colorado","CO",2020-02-16,2020-02-22,7,2020,"8",5758736,881,0,816,65,881,0,1.12871991353658,0.079656862745098
"United States","Colorado","CO",2020-02-23,2020-02-29,7,2020,"9",5758736,842,0,814,28,842,0,0.486217808908066,0.0343980343980343
"United States","Colorado","CO",2020-03-01,2020-03-07,7,2020,"10",5758736,821,0,814,7,821,0,0.121554452227016,0.00859950859950853
"United States","Colorado","CO",2020-03-08,2020-03-14,7,2020,"11",5758736,822,1,805,17,821,0.0173649217467166,0.295203669694183,0.0211180124223602
"United States","Colorado","CO",2020-03-15,2020-03-21,7,2020,"12",5758736,891,5,807,84,886,0.0868246087335832,1.4586534267242,0.104089219330855
"United States","Colorado","CO",2020-03-22,2020-03-28,7,2020,"13",5758736,860,38,806,54,822,0.659867026375232,0.937705774322699,0.0669975186104219
"United States","Colorado","CO",2020-03-29,2020-04-04,7,2020,"14",5758736,967,82,798,169,885,1.42392358323076,2.93467177519511,0.211779448621554
"United States","Colorado","CO",2020-04-05,2020-04-11,7,2020,"15",5758736,1096,148,792,304,948,2.57000841851406,5.27893621100186,0.383838383838384
"United States","Colorado","CO",2020-04-12,2020-04-18,7,2020,"16",5758736,1106,137,785,321,969,2.37899427930018,5.57413988069604,0.408917197452229
"United States","Colorado","CO",2020-04-19,2020-04-25,7,2020,"17",5758736,1067,259,782,285,808,4.49751473239961,4.94900269781424,0.364450127877238
"United States","Colorado","CO",2020-04-26,2020-05-02,7,2020,"18",5758736,999,162,772,227,837,2.8131173229681,3.94183723650468,0.294041450777202
"United States","Colorado","CO",2020-05-03,2020-05-09,7,2020,"19",5758736,906,135,764,142,771,2.34426443580675,2.46581888803376,0.18586387434555
"United States","Colorado","CO",2020-05-10,2020-05-16,7,2020,"20",5758736,887,225,755,132,662,3.90710739301124,2.2921696705666,0.174834437086093
"United States","Colorado","CO",2020-05-17,2020-05-23,7,2020,"21",5758736,847,133,742,105,714,2.30953459231331,1.82331678340525,0.141509433962264
"United States","Colorado","CO",2020-05-24,2020-05-30,7,2020,"22",5758736,834,117,730,104,717,2.03169584436585,1.80595186165853,0.142465753424658
"United States","Colorado","CO",2020-05-31,2020-06-06,7,2020,"23",5758736,820,82,731,89,738,1.42392358323076,1.54547803545778,0.121751025991792
"United States","Colorado","CO",2020-06-07,2020-06-13,7,2020,"24",5758736,816,73,721,95,743,1.26763928751031,1.64966756593808,0.131761442441054
"United States","Colorado","CO",2020-06-14,2020-06-20,7,2020,"25",5758736,863,49,719,144,814,0.850881165589115,2.5005487315272,0.200278164116829
"United States","Colorado","CO",2020-06-21,2020-06-27,7,2020,"26",5758736,877,28,723,154,849,0.486217808908066,2.67419794899436,0.213001383125864
"United States","Colorado","CO",2020-06-28,2020-07-04,7,2020,"27",5758736,788,27,719,69,761,0.468852887161349,1.19817960052345,0.0959666203059806
"United States","Colorado","CO",2020-07-05,2020-07-11,7,2020,"28",5758736,815,24,718,97,791,0.416758121921199,1.68439740943151,0.135097493036212
"United States","Colorado","CO",2020-07-12,2020-07-18,7,2020,"29",5758736,808,27,721,87,781,0.468852887161349,1.51074819196435,0.120665742024965
"United States","Colorado","CO",2020-07-19,2020-07-25,7,2020,"30",5758736,833,42,722,111,791,0.729326713362099,1.92750631388555,0.153739612188366
"United States","Colorado","CO",2020-07-26,2020-08-01,7,2020,"31",5758736,813,50,715,98,763,0.868246087335832,1.70176233117823,0.137062937062937
"United States","Colorado","CO",2020-08-02,2020-08-08,7,2020,"32",5758736,841,13,722,119,828,0.225743982707316,2.06642568785928,0.164819944598338
"United States","Colorado","CO",2020-08-09,2020-08-15,7,2020,"33",5758736,836,39,730,106,797,0.677231948121949,1.84068170515196,0.145205479452055
"United States","Colorado","CO",2020-08-16,2020-08-22,7,2020,"34",5758736,863,22,729,134,841,0.382028278427766,2.32689951406003,0.183813443072702
"United States","Colorado","CO",2020-08-23,2020-08-29,7,2020,"35",5758736,817,26,734,83,791,0.451487965414633,1.44128850497748,0.11307901907357
"United States","Colorado","CO",2020-08-30,2020-09-05,7,2020,"36",5758736,743,22,735,8,721,0.382028278427766,0.138919373973733,0.0108843537414967
"United States","Colorado","CO",2020-09-06,2020-09-12,7,2020,"37",5758736,850,22,734,116,828,0.382028278427766,2.01433092261913,0.158038147138964
"United States","Colorado","CO",2020-09-13,2020-09-19,7,2020,"38",5758736,804,25,742,62,779,0.434123043667916,1.07662514829643,0.0835579514824798
"United States","Colorado","CO",2020-09-20,2020-09-26,7,2020,"39",5758736,838,27,753,85,811,0.468852887161349,1.47601834847091,0.112881806108898
"United States","Colorado","CO",2020-09-27,2020-10-03,7,2020,"40",5758736,782,17,757,25,765,0.295203669694183,0.434123043667916,0.0330250990752972
"United States","Colorado","CO",2020-10-04,2020-10-10,7,2020,"41",5758736,801,55,748,53,746,0.955070696069415,0.920340852575982,0.070855614973262
"United States","Colorado","CO",2020-10-11,2020-10-17,7,2020,"42",5758736,867,64,758,109,803,1.11135499178986,1.89277647039211,0.143799472295514
"United States","Colorado","CO",2020-10-18,2020-10-24,7,2020,"43",5758736,869,42,752,117,827,0.729326713362099,2.03169584436585,0.155585106382979
"United States","Colorado","CO",2020-10-25,2020-10-31,7,2020,"44",5758736,907,58,759,148,849,1.00716546130957,2.57000841851406,0.194993412384717
"United States","Colorado","CO",2020-11-01,2020-11-07,7,2020,"45",5758736,1007,111,758,249,896,1.92750631388555,4.32386551493244,0.328496042216359
"United States","Colorado","CO",2020-11-08,2020-11-14,7,2020,"46",5758736,1040,137,763,277,903,2.37899427930018,4.81008332384051,0.363040629095675
"United States","Colorado","CO",2020-11-15,2020-11-21,7,2020,"47",5758736,1132,263,763,369,869,4.56697441938648,6.40765612453844,0.483617300131062
"United States","Colorado","CO",2020-11-22,2020-11-28,7,2020,"48",5758736,1216,196,778,438,1020,3.40352466235646,7.60583572506189,0.562982005141388
"United States","Colorado","CO",2020-11-29,2020-12-05,7,2020,"49",5758736,1256,373,778,478,883,6.47711581152531,8.30043259493056,0.61439588688946
"United States","Colorado","CO",2020-12-06,2020-12-12,7,2020,"50",5758736,1258,515,775,483,743,8.94293469955907,8.38725720366414,0.623225806451613
"United States","Colorado","CO",2020-12-13,2020-12-19,7,2020,"51",5758736,1201,468,783,418,733,8.12678337746339,7.25853729012756,0.533844189016603
"United States","Colorado","CO",2020-12-20,2020-12-26,7,2020,"52",5758736,1100,253,806,294,847,4.39332520191931,5.10528699353469,0.364764267990074
"United States","Colorado","CO",2020-12-27,2021-01-02,7,2020,"53",5758736,1098,320,825,273,778,5.55677495894933,4.74062363685364,0.330909090909091
"United States","Colorado","CO",2021-01-03,2021-01-09,7,2021,"1",5758736,1080,278,831,249,802,4.82744824558723,4.32386551493244,0.299638989169675
"United States","Colorado","CO",2021-01-10,2021-01-16,7,2021,"2",5758736,1007,167,834,173,840,2.89994193170168,3.00413146218198,0.207434052757794
"United States","Colorado","CO",2021-01-17,2021-01-23,7,2021,"3",5758736,985,123,829,156,862,2.13588537484615,2.7089277924878,0.188178528347406
"United States","Colorado","CO",2021-01-24,2021-01-30,7,2021,"4",5758736,932,136,831,101,796,2.36162935755346,1.75385709641838,0.121540312876053
"United States","Colorado","CO",2021-01-31,2021-02-06,7,2021,"5",5758736,931,106,822,109,825,1.84068170515196,1.89277647039211,0.132603406326034
"United States","Colorado","CO",2021-02-07,2021-02-13,7,2021,"6",5758736,833,97,835,-2,736,1.68439740943151,-0.0347298434934333,-0.00239520958083828
"United States","Colorado","CO",2021-02-14,2021-02-20,7,2021,"7",5758736,894,75,829,65,819,1.30236913100375,1.12871991353658,0.0784077201447526
"United States","Colorado","CO",2021-02-21,2021-02-27,7,2021,"8",5758736,872,62,833,39,810,1.07662514829643,0.677231948121949,0.0468187274909964
"United States","Colorado","CO",2021-02-28,2021-03-06,7,2021,"9",5758736,867,40,832,35,827,0.694596869868666,0.607772261135082,0.0420673076923077
"United States","Colorado","CO",2021-03-07,2021-03-13,7,2021,"10",5758736,841,53,826,15,788,0.920340852575982,0.26047382620075,0.0181598062953996
"United States","Colorado","CO",2021-03-14,2021-03-20,7,2021,"11",5758736,902,27,819,83,875,0.468852887161349,1.44128850497748,0.101343101343101
"United States","Colorado","CO",2021-03-21,2021-03-27,7,2021,"12",5758736,889,27,818,71,862,0.468852887161349,1.23290944401688,0.08679706601467
"United States","Colorado","CO",2021-03-28,2021-04-03,7,2021,"13",5758736,840,30,810,30,810,0.520947652401499,0.520947652401499,0.037037037037037
"United States","Colorado","CO",2021-04-04,2021-04-10,7,2021,"14",5758736,806,23,809,-3,783,0.399393200174483,-0.0520947652401499,-0.00370828182941907
"United States","Colorado","CO",2021-04-11,2021-04-17,7,2021,"15",5758736,872,33,803,69,839,0.573042417641649,1.19817960052345,0.0859277708592776
"United States","Colorado","CO",2021-04-18,2021-04-24,7,2021,"16",5758736,838,61,795,43,777,1.05926022654972,0.746691635108816,0.0540880503144654
"United States","Colorado","CO",2021-04-25,2021-05-01,7,2021,"17",5758736,850,53,790,60,797,0.920340852575982,1.041895304803,0.0759493670886076
"United States","Colorado","CO",2021-05-02,2021-05-08,7,2021,"18",5758736,853,53,783,70,800,0.920340852575982,1.21554452227016,0.0893997445721584
"United States","Colorado","CO",2021-05-09,2021-05-15,7,2021,"19",5758736,881,87,781,100,794,1.51074819196435,1.73649217467166,0.128040973111396
"United States","Colorado","CO",2021-05-16,2021-05-22,7,2021,"20",5758736,851,61,778,73,790,1.05926022654972,1.26763928751031,0.0938303341902313
"United States","Colorado","CO",2021-05-23,2021-05-29,7,2021,"21",5758736,824,73,773,51,751,1.26763928751031,0.885611009082549,0.0659767141009056
"United States","Colorado","CO",2021-05-30,2021-06-05,7,2021,"22",5758736,831,37,764,67,794,0.642502104628516,1.16344975703002,0.087696335078534
"United States","Colorado","CO",2021-06-06,2021-06-12,7,2021,"23",5758736,890,75,755,135,815,1.30236913100375,2.34426443580675,0.178807947019868
"United States","Colorado","CO",2021-06-13,2021-06-19,7,2021,"24",5758736,844,44,748,96,800,0.764056556855532,1.6670324876848,0.128342245989305
"United States","Colorado","CO",2021-06-20,2021-06-26,7,2021,"25",5758736,797,38,742,55,759,0.659867026375232,0.955070696069415,0.0741239892183287
"United States","Colorado","CO",2021-06-27,2021-07-03,7,2021,"26",5758736,849,44,744,105,805,0.764056556855532,1.82331678340525,0.141129032258065
"United States","Colorado","CO",2021-07-04,2021-07-10,7,2021,"27",5758736,839,23,737,102,816,0.399393200174483,1.7712220181651,0.138398914518318
"United States","Colorado","CO",2021-07-11,2021-07-17,7,2021,"28",5758736,847,47,738,109,800,0.816151322095682,1.89277647039211,0.14769647696477
"United States","Colorado","CO",2021-07-18,2021-07-24,7,2021,"29",5758736,861,25,740,121,836,0.434123043667916,2.10115553135271,0.163513513513514
"United States","Colorado","CO",2021-07-25,2021-07-31,7,2021,"30",5758736,841,35,741,100,806,0.607772261135082,1.73649217467166,0.134952766531714
"United States","Colorado","CO",2021-08-01,2021-08-07,7,2021,"31",5758736,842,25,741,101,817,0.434123043667916,1.75385709641838,0.136302294197031
"United States","Colorado","CO",2021-08-08,2021-08-14,7,2021,"32",5758736,890,62,743,147,828,1.07662514829643,2.55264349676735,0.197846567967699
"United States","Colorado","CO",2021-08-15,2021-08-21,7,2021,"33",5758736,883,9,743,140,874,0.15628429572045,2.43108904454033,0.18842530282638
"United States","Connecticut","CT",2019-12-29,2020-01-04,7,2020,"1",3565287,633,0,691,-58,633,0,-1.62679750606333,-0.0839363241678727
"United States","Connecticut","CT",2020-01-05,2020-01-11,7,2020,"2",3565287,631,0,699,-68,631,0,-1.90727983469493,-0.0972818311874106
"United States","Connecticut","CT",2020-01-12,2020-01-18,7,2020,"3",3565287,639,0,694,-55,639,0,-1.54265280747384,-0.079250720461095
"United States","Connecticut","CT",2020-01-19,2020-01-25,7,2020,"4",3565287,653,0,704,-51,653,0,-1.4304598760212,-0.0724431818181818
"United States","Connecticut","CT",2020-01-26,2020-02-01,7,2020,"5",3565287,686,0,692,-6,686,0,-0.168289397178965,-0.00867052023121384
"United States","Connecticut","CT",2020-02-02,2020-02-08,7,2020,"6",3565287,652,0,683,-31,652,0,-0.869495218757985,-0.0453879941434846
"United States","Connecticut","CT",2020-02-09,2020-02-15,7,2020,"7",3565287,635,0,664,-29,635,0,-0.813398753031663,-0.0436746987951807
"United States","Connecticut","CT",2020-02-16,2020-02-22,7,2020,"8",3565287,653,0,663,-10,653,0,-0.280482328631608,-0.0150829562594268
"United States","Connecticut","CT",2020-02-23,2020-02-29,7,2020,"9",3565287,638,0,650,-12,638,0,-0.33657879435793,-0.0184615384615384
"United States","Connecticut","CT",2020-03-01,2020-03-07,7,2020,"10",3565287,625,0,644,-19,625,0,-0.532916424400055,-0.0295031055900621
"United States","Connecticut","CT",2020-03-08,2020-03-14,7,2020,"11",3565287,632,0,638,-6,632,0,-0.168289397178965,-0.00940438871473359
"United States","Connecticut","CT",2020-03-15,2020-03-21,7,2020,"12",3565287,665,5,637,28,660,0.140241164315804,0.785350520168502,0.043956043956044
"United States","Connecticut","CT",2020-03-22,2020-03-28,7,2020,"13",3565287,751,28,647,104,723,0.785350520168502,2.91701621776872,0.160741885625966
"United States","Connecticut","CT",2020-03-29,2020-04-04,7,2020,"14",3565287,891,132,649,242,759,3.70236673793723,6.78767235288491,0.372881355932203
"United States","Connecticut","CT",2020-04-05,2020-04-11,7,2020,"15",3565287,1260,329,647,613,931,9.22786861197991,17.1935667451176,0.947449768160742
"United States","Connecticut","CT",2020-04-12,2020-04-18,7,2020,"16",3565287,1389,592,643,746,797,16.6045538549912,20.923981715918,1.1601866251944
"United States","Connecticut","CT",2020-04-19,2020-04-25,7,2020,"17",3565287,1338,775,629,709,563,21.7373804689496,19.886197099981,1.12718600953895
"United States","Connecticut","CT",2020-04-26,2020-05-02,7,2020,"18",3565287,1165,575,611,554,590,16.1277338963175,15.5387210061911,0.90671031096563
"United States","Connecticut","CT",2020-05-03,2020-05-09,7,2020,"19",3565287,1052,496,602,450,556,13.9119235001278,12.6217047884224,0.74750830564784
"United States","Connecticut","CT",2020-05-10,2020-05-16,7,2020,"20",3565287,954,406,584,370,548,11.3875825424433,10.3778461593695,0.633561643835616
"United States","Connecticut","CT",2020-05-17,2020-05-23,7,2020,"21",3565287,823,336,581,242,487,9.42420624202203,6.78767235288491,0.416523235800344
"United States","Connecticut","CT",2020-05-24,2020-05-30,7,2020,"22",3565287,759,238,581,178,521,6.67547942143227,4.99258544964262,0.306368330464716
"United States","Connecticut","CT",2020-05-31,2020-06-06,7,2020,"23",3565287,669,143,586,83,526,4.01089729943199,2.32800332764235,0.141638225255973
"United States","Connecticut","CT",2020-06-07,2020-06-13,7,2020,"24",3565287,636,131,588,48,505,3.67431850507407,1.34631517743172,0.0816326530612246
"United States","Connecticut","CT",2020-06-14,2020-06-20,7,2020,"25",3565287,581,65,590,-9,516,1.82313513610545,-0.252434095768447,-0.0152542372881356
"United States","Connecticut","CT",2020-06-21,2020-06-27,7,2020,"26",3565287,598,60,584,14,538,1.68289397178965,0.392675260084251,0.023972602739726
"United States","Connecticut","CT",2020-06-28,2020-07-04,7,2020,"27",3565287,553,24,587,-34,529,0.673157588715859,-0.953639917347467,-0.0579216354344123
"United States","Connecticut","CT",2020-07-05,2020-07-11,7,2020,"28",3565287,611,13,587,24,598,0.36462702722109,0.673157588715859,0.040885860306644
"United States","Connecticut","CT",2020-07-12,2020-07-18,7,2020,"29",3565287,569,48,580,-11,521,1.34631517743172,-0.308530561494769,-0.0189655172413793
"United States","Connecticut","CT",2020-07-19,2020-07-25,7,2020,"30",3565287,586,17,572,14,569,0.476819958673734,0.392675260084251,0.0244755244755244
"United States","Connecticut","CT",2020-07-26,2020-08-01,7,2020,"31",3565287,555,19,563,-8,536,0.532916424400055,-0.224385862905286,-0.0142095914742452
"United States","Connecticut","CT",2020-08-02,2020-08-08,7,2020,"32",3565287,593,9,561,32,584,0.252434095768447,0.897543451621146,0.0570409982174689
"United States","Connecticut","CT",2020-08-09,2020-08-15,7,2020,"33",3565287,574,12,561,13,562,0.33657879435793,0.36462702722109,0.0231729055258467
"United States","Connecticut","CT",2020-08-16,2020-08-22,7,2020,"34",3565287,571,7,554,17,564,0.196337630042126,0.476819958673734,0.0306859205776173
"United States","Connecticut","CT",2020-08-23,2020-08-29,7,2020,"35",3565287,532,5,550,-18,527,0.140241164315804,-0.504868191536894,-0.0327272727272727
"United States","Connecticut","CT",2020-08-30,2020-09-05,7,2020,"36",3565287,574,3,556,18,571,0.0841446985894824,0.504868191536894,0.0323741007194245
"United States","Connecticut","CT",2020-09-06,2020-09-12,7,2020,"37",3565287,571,12,554,17,559,0.33657879435793,0.476819958673734,0.0306859205776173
"United States","Connecticut","CT",2020-09-13,2020-09-19,7,2020,"38",3565287,579,12,556,23,567,0.33657879435793,0.645109355852699,0.0413669064748201
"United States","Connecticut","CT",2020-09-20,2020-09-26,7,2020,"39",3565287,644,9,564,80,635,0.252434095768447,2.24385862905286,0.141843971631206
"United States","Connecticut","CT",2020-09-27,2020-10-03,7,2020,"40",3565287,623,12,564,59,611,0.33657879435793,1.65484573892649,0.104609929078014
"United States","Connecticut","CT",2020-10-04,2020-10-10,7,2020,"41",3565287,637,17,572,65,620,0.476819958673734,1.82313513610545,0.113636363636364
"United States","Connecticut","CT",2020-10-11,2020-10-17,7,2020,"42",3565287,619,12,570,49,607,0.33657879435793,1.37436341029488,0.0859649122807018
"United States","Connecticut","CT",2020-10-18,2020-10-24,7,2020,"43",3565287,683,35,581,102,648,0.981688150210628,2.8609197520424,0.175559380378657
"United States","Connecticut","CT",2020-10-25,2020-10-31,7,2020,"44",3565287,639,38,586,53,601,1.06583284880011,1.48655634174752,0.0904436860068258
"United States","Connecticut","CT",2020-11-01,2020-11-07,7,2020,"45",3565287,727,55,592,135,672,1.54265280747384,3.78651143652671,0.228040540540541
"United States","Connecticut","CT",2020-11-08,2020-11-14,7,2020,"46",3565287,685,67,597,88,618,1.87923160183177,2.46824449195815,0.147403685092127
"United States","Connecticut","CT",2020-11-15,2020-11-21,7,2020,"47",3565287,759,91,604,155,668,2.55238919054763,4.34747609378992,0.256622516556291
"United States","Connecticut","CT",2020-11-22,2020-11-28,7,2020,"48",3565287,757,133,618,139,624,3.73041497080039,3.89870436797935,0.224919093851133
"United States","Connecticut","CT",2020-11-29,2020-12-05,7,2020,"49",3565287,844,185,629,215,659,5.18892307968475,6.03037006557957,0.34181240063593
"United States","Connecticut","CT",2020-12-06,2020-12-12,7,2020,"50",3565287,846,217,635,211,629,6.08646653130589,5.91817713412693,0.332283464566929
"United States","Connecticut","CT",2020-12-13,2020-12-19,7,2020,"51",3565287,871,218,640,231,653,6.11451476416905,6.47914179139015,0.3609375
"United States","Connecticut","CT",2020-12-20,2020-12-26,7,2020,"52",3565287,920,210,651,269,710,5.89012890126377,7.54497464019026,0.41321044546851
"United States","Connecticut","CT",2020-12-27,2021-01-02,7,2020,"53",3565287,913,308,647,266,605,8.63885572185353,7.46082994160077,0.41112828438949
"United States","Connecticut","CT",2021-01-03,2021-01-09,7,2021,"1",3565287,852,225,660,192,627,6.31085239421118,5.38526070972688,0.290909090909091
"United States","Connecticut","CT",2021-01-10,2021-01-16,7,2021,"2",3565287,863,269,668,195,594,7.54497464019026,5.46940540831636,0.291916167664671
"United States","Connecticut","CT",2021-01-17,2021-01-23,7,2021,"3",3565287,857,226,676,181,631,6.33890062707434,5.07673014823211,0.267751479289941
"United States","Connecticut","CT",2021-01-24,2021-01-30,7,2021,"4",3565287,820,227,677,143,593,6.3669488599375,4.01089729943199,0.21122599704579
"United States","Connecticut","CT",2021-01-31,2021-02-06,7,2021,"5",3565287,775,168,681,94,607,4.71210312101102,2.63653388913712,0.138032305433186
"United States","Connecticut","CT",2021-02-07,2021-02-13,7,2021,"6",3565287,726,167,670,56,559,4.68405488814785,1.570701040337,0.0835820895522388
"United States","Connecticut","CT",2021-02-14,2021-02-20,7,2021,"7",3565287,679,142,664,15,537,3.98284906656883,0.420723492947412,0.0225903614457832
"United States","Connecticut","CT",2021-02-21,2021-02-27,7,2021,"8",3565287,671,104,656,15,567,2.91701621776872,0.420723492947412,0.0228658536585367
"United States","Connecticut","CT",2021-02-28,2021-03-06,7,2021,"9",3565287,639,77,645,-6,562,2.15971393046338,-0.168289397178965,-0.00930232558139532
"United States","Connecticut","CT",2021-03-07,2021-03-13,7,2021,"10",3565287,643,61,640,3,582,1.71094220465281,0.0841446985894824,0.00468749999999996
"United States","Connecticut","CT",2021-03-14,2021-03-20,7,2021,"11",3565287,639,68,639,0,571,1.90727983469493,0,0
"United States","Connecticut","CT",2021-03-21,2021-03-27,7,2021,"12",3565287,660,36,645,15,624,1.00973638307379,0.420723492947412,0.0232558139534884
"United States","Connecticut","CT",2021-03-28,2021-04-03,7,2021,"13",3565287,609,37,641,-32,572,1.03778461593695,-0.897543451621146,-0.0499219968798752
"United States","Connecticut","CT",2021-04-04,2021-04-10,7,2021,"14",3565287,579,38,634,-55,541,1.06583284880011,-1.54265280747384,-0.0867507886435331
"United States","Connecticut","CT",2021-04-11,2021-04-17,7,2021,"15",3565287,610,51,635,-25,559,1.4304598760212,-0.70120582157902,-0.0393700787401575
"United States","Connecticut","CT",2021-04-18,2021-04-24,7,2021,"16",3565287,616,52,625,-9,564,1.45850810888436,-0.252434095768447,-0.0144
"United States","Connecticut","CT",2021-04-25,2021-05-01,7,2021,"17",3565287,648,50,608,40,598,1.40241164315804,1.12192931452643,0.0657894736842106
"United States","Connecticut","CT",2021-05-02,2021-05-08,7,2021,"18",3565287,652,40,595,57,612,1.12192931452643,1.59874927320017,0.0957983193277312
"United States","Connecticut","CT",2021-05-09,2021-05-15,7,2021,"19",3565287,619,36,588,31,583,1.00973638307379,0.869495218757985,0.0527210884353742
"United States","Connecticut","CT",2021-05-16,2021-05-22,7,2021,"20",3565287,695,39,581,114,656,1.09388108166327,3.19749854640033,0.196213425129088
"United States","Connecticut","CT",2021-05-23,2021-05-29,7,2021,"21",3565287,738,26,575,163,712,0.729254054442181,4.57186195669521,0.283478260869565
"United States","Connecticut","CT",2021-05-30,2021-06-05,7,2021,"22",3565287,663,8,570,93,655,0.224385862905286,2.60848565627396,0.163157894736842
"United States","Connecticut","CT",2021-06-06,2021-06-12,7,2021,"23",3565287,693,15,572,121,678,0.420723492947412,3.39383617644246,0.211538461538461
"United States","Connecticut","CT",2021-06-13,2021-06-19,7,2021,"24",3565287,681,9,572,109,672,0.252434095768447,3.05725738208453,0.190559440559441
"United States","Connecticut","CT",2021-06-20,2021-06-26,7,2021,"25",3565287,697,5,579,118,692,0.140241164315804,3.30969147785297,0.203799654576857
"United States","Connecticut","CT",2021-06-27,2021-07-03,7,2021,"26",3565287,700,4,581,119,696,0.112192931452643,3.33773971071614,0.204819277108434
"United States","Connecticut","CT",2021-07-04,2021-07-10,7,2021,"27",3565287,688,0,584,104,688,0,2.91701621776872,0.178082191780822
"United States","Connecticut","CT",2021-07-11,2021-07-17,7,2021,"28",3565287,661,3,581,80,658,0.0841446985894824,2.24385862905286,0.137693631669535
"United States","Connecticut","CT",2021-07-18,2021-07-24,7,2021,"29",3565287,694,4,589,105,690,0.112192931452643,2.94506445063188,0.178268251273345
"United States","Connecticut","CT",2021-07-25,2021-07-31,7,2021,"30",3565287,678,7,580,98,671,0.196337630042126,2.74872682058976,0.168965517241379
"United States","Delaware","DE",2019-12-29,2020-01-04,7,2020,"1",973764,199,0,215,-16,199,0,-1.64310859715496,-0.0744186046511628
"United States","Delaware","DE",2020-01-05,2020-01-11,7,2020,"2",973764,194,0,212,-18,194,0,-1.84849717179933,-0.0849056603773585
"United States","Delaware","DE",2020-01-12,2020-01-18,7,2020,"3",973764,190,0,213,-23,190,0,-2.36196860841025,-0.107981220657277
"United States","Delaware","DE",2020-01-19,2020-01-25,7,2020,"4",973764,190,0,209,-19,190,0,-1.95119145912151,-0.0909090909090909
"United States","Delaware","DE",2020-01-26,2020-02-01,7,2020,"5",973764,183,0,210,-27,183,0,-2.77274575769899,-0.128571428571429
"United States","Delaware","DE",2020-02-02,2020-02-08,7,2020,"6",973764,191,0,208,-17,191,0,-1.74580288447714,-0.0817307692307693
"United States","Delaware","DE",2020-02-09,2020-02-15,7,2020,"7",973764,202,0,201,1,202,0,0.102694287322185,0.00497512437810954
"United States","Delaware","DE",2020-02-16,2020-02-22,7,2020,"8",973764,194,0,202,-8,194,0,-0.821554298577479,-0.0396039603960396
"United States","Delaware","DE",2020-02-23,2020-02-29,7,2020,"9",973764,164,0,200,-36,164,0,-3.69699434359865,-0.18
"United States","Delaware","DE",2020-03-01,2020-03-07,7,2020,"10",973764,200,0,201,-1,200,0,-0.102694287322185,-0.00497512437810943
"United States","Delaware","DE",2020-03-08,2020-03-14,7,2020,"11",973764,189,0,203,-14,189,0,-1.43772002251059,-0.0689655172413793
"United States","Delaware","DE",2020-03-15,2020-03-21,7,2020,"12",973764,221,0,207,14,221,0,1.43772002251059,0.067632850241546
"United States","Delaware","DE",2020-03-22,2020-03-28,7,2020,"13",973764,188,5,204,-16,183,0.513471436610924,-1.64310859715496,-0.0784313725490197
"United States","Delaware","DE",2020-03-29,2020-04-04,7,2020,"14",973764,214,9,211,3,205,0.924248585899664,0.308082861966554,0.014218009478673
"United States","Delaware","DE",2020-04-05,2020-04-11,7,2020,"15",973764,219,19,208,11,200,1.95119145912151,1.12963716054403,0.0528846153846154
"United States","Delaware","DE",2020-04-12,2020-04-18,7,2020,"16",973764,229,34,198,31,195,3.49160576895428,3.18352290698773,0.156565656565657
"United States","Delaware","DE",2020-04-19,2020-04-25,7,2020,"17",973764,285,45,192,93,240,4.62124292949832,9.55056872096319,0.484375
"United States","Delaware","DE",2020-04-26,2020-05-02,7,2020,"18",973764,251,56,187,64,195,5.75088009004235,6.57243438861983,0.342245989304813
"United States","Delaware","DE",2020-05-03,2020-05-09,7,2020,"19",973764,271,34,186,85,237,3.49160576895428,8.72901442238571,0.456989247311828
"United States","Delaware","DE",2020-05-10,2020-05-16,7,2020,"20",973764,276,84,179,97,192,8.62632013506353,9.96134587025193,0.541899441340782
"United States","Delaware","DE",2020-05-17,2020-05-23,7,2020,"21",973764,222,38,179,43,184,3.90238291824302,4.41585435485395,0.240223463687151
"United States","Delaware","DE",2020-05-24,2020-05-30,7,2020,"22",973764,226,37,179,47,189,3.79968863092084,4.82663150414269,0.262569832402235
"United States","Delaware","DE",2020-05-31,2020-06-06,7,2020,"23",973764,182,29,176,6,153,2.97813433234336,0.616165723933109,0.0340909090909092
"United States","Delaware","DE",2020-06-07,2020-06-13,7,2020,"24",973764,200,29,175,25,171,2.97813433234336,2.56735718305462,0.142857142857143
"United States","Delaware","DE",2020-06-14,2020-06-20,7,2020,"25",973764,162,15,182,-20,147,1.54041430983277,-2.0538857464437,-0.10989010989011
"United States","Delaware","DE",2020-06-21,2020-06-27,7,2020,"26",973764,201,73,180,21,128,7.49668297451949,2.15658003376588,0.116666666666667
"United States","Delaware","DE",2020-06-28,2020-07-04,7,2020,"27",973764,201,5,182,19,196,0.513471436610924,1.95119145912151,0.104395604395604
"United States","Delaware","DE",2020-07-05,2020-07-11,7,2020,"28",973764,194,3,182,12,191,0.308082861966554,1.23233144786622,0.0659340659340659
"United States","Delaware","DE",2020-07-12,2020-07-18,7,2020,"29",973764,191,8,179,12,183,0.821554298577479,1.23233144786622,0.0670391061452513
"United States","Delaware","DE",2020-07-19,2020-07-25,7,2020,"30",973764,201,56,177,24,145,5.75088009004235,2.46466289573244,0.135593220338983
"United States","Delaware","DE",2020-07-26,2020-08-01,7,2020,"31",973764,195,6,183,12,189,0.616165723933109,1.23233144786622,0.0655737704918034
"United States","Delaware","DE",2020-08-02,2020-08-08,7,2020,"32",973764,197,5,181,16,192,0.513471436610924,1.64310859715496,0.0883977900552486
"United States","Delaware","DE",2020-08-09,2020-08-15,7,2020,"33",973764,189,3,180,9,186,0.308082861966554,0.924248585899664,0.05
"United States","Delaware","DE",2020-08-16,2020-08-22,7,2020,"34",973764,194,7,177,17,187,0.718860011255294,1.74580288447714,0.0960451977401129
"United States","Delaware","DE",2020-08-23,2020-08-29,7,2020,"35",973764,190,4,178,12,186,0.410777149288739,1.23233144786622,0.0674157303370786
"United States","Delaware","DE",2020-08-30,2020-09-05,7,2020,"36",973764,208,4,177,31,204,0.410777149288739,3.18352290698773,0.175141242937853
"United States","Delaware","DE",2020-09-06,2020-09-12,7,2020,"37",973764,198,5,178,20,193,0.513471436610924,2.0538857464437,0.112359550561798
"United States","Delaware","DE",2020-09-13,2020-09-19,7,2020,"38",973764,161,8,174,-13,153,0.821554298577479,-1.3350257351884,-0.0747126436781609
"United States","Delaware","DE",2020-09-20,2020-09-26,7,2020,"39",973764,202,12,180,22,190,1.23233144786622,2.25927432108807,0.122222222222222
"United States","Delaware","DE",2020-09-27,2020-10-03,7,2020,"40",973764,202,12,181,21,190,1.23233144786622,2.15658003376588,0.116022099447514
"United States","Delaware","DE",2020-10-04,2020-10-10,7,2020,"41",973764,203,8,183,20,195,0.821554298577479,2.0538857464437,0.109289617486339
"United States","Delaware","DE",2020-10-11,2020-10-17,7,2020,"42",973764,203,12,181,22,191,1.23233144786622,2.25927432108807,0.121546961325967
"United States","Delaware","DE",2020-10-18,2020-10-24,7,2020,"43",973764,215,16,183,32,199,1.64310859715496,3.28621719430991,0.174863387978142
"United States","Delaware","DE",2020-10-25,2020-10-31,7,2020,"44",973764,195,28,183,12,167,2.87544004502118,1.23233144786622,0.0655737704918034
"United States","Delaware","DE",2020-11-01,2020-11-07,7,2020,"45",973764,199,7,189,10,192,0.718860011255294,1.02694287322185,0.052910052910053
"United States","Delaware","DE",2020-11-08,2020-11-14,7,2020,"46",973764,172,20,191,-19,152,2.0538857464437,-1.95119145912151,-0.099476439790576
"United States","Delaware","DE",2020-11-15,2020-11-21,7,2020,"47",973764,232,12,195,37,220,1.23233144786622,3.79968863092084,0.18974358974359
"United States","Delaware","DE",2020-11-22,2020-11-28,7,2020,"48",973764,199,21,196,3,178,2.15658003376588,0.308082861966554,0.0153061224489797
"United States","Delaware","DE",2020-11-29,2020-12-05,7,2020,"49",973764,231,24,193,38,207,2.46466289573244,3.90238291824302,0.196891191709845
"United States","Delaware","DE",2020-12-06,2020-12-12,7,2020,"50",973764,277,22,197,80,255,2.25927432108807,8.21554298577479,0.406091370558376
"United States","Delaware","DE",2020-12-13,2020-12-19,7,2020,"51",973764,281,43,195,86,238,4.41585435485395,8.8317087097079,0.441025641025641
"United States","Delaware","DE",2020-12-20,2020-12-26,7,2020,"52",973764,289,36,198,91,253,3.69699434359865,9.34518014631882,0.45959595959596
"United States","Delaware","DE",2020-12-27,2021-01-02,7,2020,"53",973764,285,36,201,84,249,3.69699434359865,8.62632013506353,0.417910447761194
"United States","Delaware","DE",2021-01-03,2021-01-09,7,2021,"1",973764,276,39,200,76,237,4.00507720556521,7.80476583648605,0.38
"United States","Delaware","DE",2021-01-10,2021-01-16,7,2021,"2",973764,287,47,196,91,240,4.82663150414269,9.34518014631882,0.464285714285714
"United States","Delaware","DE",2021-01-17,2021-01-23,7,2021,"3",973764,283,20,195,88,263,2.0538857464437,9.03709728435227,0.451282051282051
"United States","Delaware","DE",2021-01-24,2021-01-30,7,2021,"4",973764,265,45,192,73,220,4.62124292949832,7.49668297451949,0.380208333333333
"United States","Delaware","DE",2021-01-31,2021-02-06,7,2021,"5",973764,262,121,194,68,141,12.4260087659844,6.98321153790857,0.350515463917526
"United States","Delaware","DE",2021-02-07,2021-02-13,7,2021,"6",973764,234,80,193,41,154,8.21554298577479,4.21046578020958,0.212435233160622
"United States","Delaware","DE",2021-02-14,2021-02-20,7,2021,"7",973764,205,84,191,14,121,8.62632013506353,1.43772002251059,0.0732984293193717
"United States","Delaware","DE",2021-02-21,2021-02-27,7,2021,"8",973764,213,56,193,20,157,5.75088009004235,2.0538857464437,0.103626943005181
"United States","Delaware","DE",2021-02-28,2021-03-06,7,2021,"9",973764,217,42,191,26,175,4.31316006753176,2.67005147037681,0.136125654450262
"United States","Delaware","DE",2021-03-07,2021-03-13,7,2021,"10",973764,203,32,190,13,171,3.28621719430991,1.3350257351884,0.0684210526315789
"United States","Delaware","DE",2021-03-14,2021-03-20,7,2021,"11",973764,234,26,191,43,208,2.67005147037681,4.41585435485395,0.225130890052356
"United States","Delaware","DE",2021-03-21,2021-03-27,7,2021,"12",973764,212,22,185,27,190,2.25927432108807,2.77274575769899,0.145945945945946
"United States","Delaware","DE",2021-03-28,2021-04-03,7,2021,"13",973764,163,22,187,-24,141,2.25927432108807,-2.46466289573244,-0.128342245989305
"United States","Delaware","DE",2021-04-04,2021-04-10,7,2021,"14",973764,193,7,188,5,186,0.718860011255294,0.513471436610924,0.0265957446808511
"United States","Delaware","DE",2021-04-11,2021-04-17,7,2021,"15",973764,212,29,181,31,183,2.97813433234336,3.18352290698773,0.171270718232044
"United States","Delaware","DE",2021-04-18,2021-04-24,7,2021,"16",973764,215,13,176,39,202,1.3350257351884,4.00507720556521,0.221590909090909
"United States","Delaware","DE",2021-04-25,2021-05-01,7,2021,"17",973764,210,11,179,31,199,1.12963716054403,3.18352290698773,0.173184357541899
"United States","Delaware","DE",2021-05-02,2021-05-08,7,2021,"18",973764,198,10,174,24,188,1.02694287322185,2.46466289573244,0.137931034482759
"United States","Delaware","DE",2021-05-09,2021-05-15,7,2021,"19",973764,206,15,174,32,191,1.54041430983277,3.28621719430991,0.183908045977011
"United States","Delaware","DE",2021-05-16,2021-05-22,7,2021,"20",973764,216,8,172,44,208,0.821554298577479,4.51854864217613,0.255813953488372
"United States","Delaware","DE",2021-05-23,2021-05-29,7,2021,"21",973764,204,2,177,27,202,0.20538857464437,2.77274575769899,0.152542372881356
"United States","Delaware","DE",2021-05-30,2021-06-05,7,2021,"22",973764,176,16,176,0,160,1.64310859715496,0,0
"United States","Delaware","DE",2021-06-06,2021-06-12,7,2021,"23",973764,200,2,174,26,198,0.20538857464437,2.67005147037681,0.149425287356322
"United States","Delaware","DE",2021-06-13,2021-06-19,7,2021,"24",973764,174,0,174,0,174,0,0,0
"United States","Delaware","DE",2021-06-20,2021-06-26,7,2021,"25",973764,219,14,178,41,205,1.43772002251059,4.21046578020958,0.230337078651685
"United States","Delaware","DE",2021-06-27,2021-07-03,7,2021,"26",973764,211,2,175,36,209,0.20538857464437,3.69699434359865,0.205714285714286
"United States","Delaware","DE",2021-07-04,2021-07-10,7,2021,"27",973764,190,0,175,15,190,0,1.54041430983277,0.0857142857142856
"United States","Delaware","DE",2021-07-11,2021-07-17,7,2021,"28",973764,186,2,173,13,184,0.20538857464437,1.3350257351884,0.0751445086705202
"United States","Delaware","DE",2021-07-18,2021-07-24,7,2021,"29",973764,201,1,169,32,200,0.102694287322185,3.28621719430991,0.189349112426036
"United States","Delaware","DE",2021-07-25,2021-07-31,7,2021,"30",973764,200,2,169,31,198,0.20538857464437,3.18352290698773,0.183431952662722
"United States","Delaware","DE",2021-08-01,2021-08-07,7,2021,"31",973764,199,133,167,32,66,13.6583402138506,3.28621719430991,0.191616766467066
"United States","Delaware","DE",2021-08-08,2021-08-14,7,2021,"32",973764,270,4,166,104,266,0.410777149288739,10.6802058815072,0.626506024096386
"United States","Delaware","DE",2021-08-15,2021-08-21,7,2021,"33",973764,224,1,168,56,223,0.102694287322185,5.75088009004235,0.333333333333333
"United States","District of Columbia","DC",2019-12-29,2020-01-04,7,2020,"1",705749,132,0,138,-6,132,0,-0.85016060950848,-0.0434782608695652
"United States","District of Columbia","DC",2020-01-05,2020-01-11,7,2020,"2",705749,128,0,135,-7,128,0,-0.99185404442656,-0.0518518518518518
"United States","District of Columbia","DC",2020-01-12,2020-01-18,7,2020,"3",705749,140,0,138,2,140,0,0.28338686983616,0.0144927536231885
"United States","District of Columbia","DC",2020-01-19,2020-01-25,7,2020,"4",705749,131,0,134,-3,131,0,-0.42508030475424,-0.0223880597014925
"United States","District of Columbia","DC",2020-01-26,2020-02-01,7,2020,"5",705749,143,0,132,11,143,0,1.55862778409888,0.0833333333333333
"United States","District of Columbia","DC",2020-02-02,2020-02-08,7,2020,"6",705749,131,0,130,1,131,0,0.14169343491808,0.00769230769230766
"United States","District of Columbia","DC",2020-02-09,2020-02-15,7,2020,"7",705749,122,0,128,-6,122,0,-0.85016060950848,-0.046875
"United States","District of Columbia","DC",2020-02-16,2020-02-22,7,2020,"8",705749,104,0,126,-22,104,0,-3.11725556819776,-0.174603174603175
"United States","District of Columbia","DC",2020-02-23,2020-02-29,7,2020,"9",705749,135,0,124,11,135,0,1.55862778409888,0.0887096774193548
"United States","District of Columbia","DC",2020-03-01,2020-03-07,7,2020,"10",705749,118,0,121,-3,118,0,-0.42508030475424,-0.0247933884297521
"United States","District of Columbia","DC",2020-03-08,2020-03-14,7,2020,"11",705749,114,0,125,-11,114,0,-1.55862778409888,-0.088
"United States","District of Columbia","DC",2020-03-15,2020-03-21,7,2020,"12",705749,129,1,123,6,128,0.14169343491808,0.85016060950848,0.0487804878048781
"United States","District of Columbia","DC",2020-03-22,2020-03-28,7,2020,"13",705749,130,4,123,7,126,0.56677373967232,0.99185404442656,0.056910569105691
"United States","District of Columbia","DC",2020-03-29,2020-04-04,7,2020,"14",705749,156,16,121,35,140,2.26709495868928,4.9592702221328,0.289256198347107
"United States","District of Columbia","DC",2020-04-05,2020-04-11,7,2020,"15",705749,194,1,124,70,193,0.14169343491808,9.9185404442656,0.564516129032258
"United States","District of Columbia","DC",2020-04-12,2020-04-18,7,2020,"16",705749,202,69,125,77,133,9.77684700934752,10.9103944886922,0.616
"United States","District of Columbia","DC",2020-04-19,2020-04-25,7,2020,"17",705749,242,74,122,120,168,10.4853141839379,17.0032121901696,0.983606557377049
"United States","District of Columbia","DC",2020-04-26,2020-05-02,7,2020,"18",705749,215,75,120,95,140,10.627007618856,13.4608763172176,0.791666666666667
"United States","District of Columbia","DC",2020-05-03,2020-05-09,7,2020,"19",705749,214,71,120,94,143,10.0602338791837,13.3191828822995,0.783333333333333
"United States","District of Columbia","DC",2020-05-10,2020-05-16,7,2020,"20",705749,185,64,114,71,121,9.06837983475712,10.0602338791837,0.62280701754386
"United States","District of Columbia","DC",2020-05-17,2020-05-23,7,2020,"21",705749,181,52,109,72,129,7.36805861574016,10.2019273141018,0.660550458715596
"United States","District of Columbia","DC",2020-05-24,2020-05-30,7,2020,"22",705749,169,35,112,57,134,4.9592702221328,8.07652579033056,0.508928571428571
"United States","District of Columbia","DC",2020-05-31,2020-06-06,7,2020,"23",705749,149,21,109,40,128,2.97556213327968,5.6677373967232,0.36697247706422
"United States","District of Columbia","DC",2020-06-07,2020-06-13,7,2020,"24",705749,147,28,109,38,119,3.96741617770624,5.38435052688704,0.348623853211009
"United States","District of Columbia","DC",2020-06-14,2020-06-20,7,2020,"25",705749,132,20,110,22,112,2.8338686983616,3.11725556819776,0.2
"United States","District of Columbia","DC",2020-06-21,2020-06-27,7,2020,"26",705749,130,17,109,21,113,2.40878839360736,2.97556213327968,0.192660550458716
"United States","District of Columbia","DC",2020-06-28,2020-07-04,7,2020,"27",705749,122,9,109,13,113,1.27524091426272,1.84201465393504,0.119266055045872
"United States","District of Columbia","DC",2020-07-05,2020-07-11,7,2020,"28",705749,138,11,111,27,127,1.55862778409888,3.82572274278816,0.243243243243243
"United States","District of Columbia","DC",2020-07-12,2020-07-18,7,2020,"29",705749,121,10,111,10,111,1.4169343491808,1.4169343491808,0.0900900900900901
"United States","District of Columbia","DC",2020-07-19,2020-07-25,7,2020,"30",705749,123,3,109,14,120,0.42508030475424,1.98370808885312,0.128440366972477
"United States","District of Columbia","DC",2020-07-26,2020-08-01,7,2020,"31",705749,130,4,110,20,126,0.56677373967232,2.8338686983616,0.181818181818182
"United States","District of Columbia","DC",2020-08-02,2020-08-08,7,2020,"32",705749,118,5,108,10,113,0.7084671745904,1.4169343491808,0.0925925925925926
"United States","District of Columbia","DC",2020-08-09,2020-08-15,7,2020,"33",705749,117,7,106,11,110,0.99185404442656,1.55862778409888,0.10377358490566
"United States","District of Columbia","DC",2020-08-16,2020-08-22,7,2020,"34",705749,113,7,105,8,106,0.99185404442656,1.13354747934464,0.0761904761904761
"United States","District of Columbia","DC",2020-08-23,2020-08-29,7,2020,"35",705749,140,1,106,34,139,0.14169343491808,4.81757678721472,0.320754716981132
"United States","District of Columbia","DC",2020-08-30,2020-09-05,7,2020,"36",705749,143,6,106,37,137,0.85016060950848,5.24265709196896,0.349056603773585
"United States","District of Columbia","DC",2020-09-06,2020-09-12,7,2020,"37",705749,125,5,107,18,120,0.7084671745904,2.55048182852544,0.168224299065421
"United States","District of Columbia","DC",2020-09-13,2020-09-19,7,2020,"38",705749,109,0,110,-1,109,0,-0.14169343491808,-0.00909090909090904
"United States","District of Columbia","DC",2020-09-20,2020-09-26,7,2020,"39",705749,112,8,111,1,104,1.13354747934464,0.14169343491808,0.00900900900900892
"United States","District of Columbia","DC",2020-09-27,2020-10-03,7,2020,"40",705749,138,5,111,27,133,0.7084671745904,3.82572274278816,0.243243243243243
"United States","District of Columbia","DC",2020-10-04,2020-10-10,7,2020,"41",705749,146,7,112,34,139,0.99185404442656,4.81757678721472,0.303571428571429
"United States","District of Columbia","DC",2020-10-11,2020-10-17,7,2020,"42",705749,118,5,110,8,113,0.7084671745904,1.13354747934464,0.0727272727272728
"United States","District of Columbia","DC",2020-10-18,2020-10-24,7,2020,"43",705749,105,1,109,-4,104,0.14169343491808,-0.56677373967232,-0.036697247706422
"United States","District of Columbia","DC",2020-10-25,2020-10-31,7,2020,"44",705749,128,4,108,20,124,0.56677373967232,2.8338686983616,0.185185185185185
"United States","District of Columbia","DC",2020-11-01,2020-11-07,7,2020,"45",705749,137,8,106,31,129,1.13354747934464,4.39249648246048,0.292452830188679
"United States","District of Columbia","DC",2020-11-08,2020-11-14,7,2020,"46",705749,130,4,103,27,126,0.56677373967232,3.82572274278816,0.262135922330097
"United States","District of Columbia","DC",2020-11-15,2020-11-21,7,2020,"47",705749,135,12,105,30,123,1.70032121901696,4.2508030475424,0.285714285714286
"United States","District of Columbia","DC",2020-11-22,2020-11-28,7,2020,"48",705749,120,8,108,12,112,1.13354747934464,1.70032121901696,0.111111111111111
"United States","District of Columbia","DC",2020-11-29,2020-12-05,7,2020,"49",705749,153,17,109,44,136,2.40878839360736,6.23451113639552,0.403669724770642
"United States","District of Columbia","DC",2020-12-06,2020-12-12,7,2020,"50",705749,175,18,110,65,157,2.55048182852544,9.2100732696752,0.590909090909091
"United States","District of Columbia","DC",2020-12-13,2020-12-19,7,2020,"51",705749,144,17,112,32,127,2.40878839360736,4.53418991737856,0.285714285714286
"United States","District of Columbia","DC",2020-12-20,2020-12-26,7,2020,"52",705749,165,32,115,50,133,4.53418991737856,7.084671745904,0.434782608695652
"United States","District of Columbia","DC",2020-12-27,2021-01-02,7,2020,"53",705749,178,30,115,63,148,4.2508030475424,8.92668639983904,0.547826086956522
"United States","District of Columbia","DC",2021-01-03,2021-01-09,7,2021,"1",705749,173,21,112,61,152,2.97556213327968,8.64329953000288,0.544642857142857
"United States","District of Columbia","DC",2021-01-10,2021-01-16,7,2021,"2",705749,171,34,115,56,137,4.81757678721472,7.93483235541248,0.486956521739131
"United States","District of Columbia","DC",2021-01-17,2021-01-23,7,2021,"3",705749,163,23,114,49,140,3.25894900311584,6.94297831098592,0.429824561403509
"United States","District of Columbia","DC",2021-01-24,2021-01-30,7,2021,"4",705749,181,39,109,72,142,5.52604396180512,10.2019273141018,0.660550458715596
"United States","District of Columbia","DC",2021-01-31,2021-02-06,7,2021,"5",705749,164,38,110,54,126,5.38435052688704,7.65144548557632,0.490909090909091
"United States","District of Columbia","DC",2021-02-07,2021-02-13,7,2021,"6",705749,153,32,108,45,121,4.53418991737856,6.3762045713136,0.416666666666667
"United States","District of Columbia","DC",2021-02-14,2021-02-20,7,2021,"7",705749,167,15,107,60,152,2.1254015237712,8.5016060950848,0.560747663551402
"United States","District of Columbia","DC",2021-02-21,2021-02-27,7,2021,"8",705749,144,11,105,39,133,1.55862778409888,5.52604396180512,0.371428571428571
"United States","District of Columbia","DC",2021-02-28,2021-03-06,7,2021,"9",705749,134,25,103,31,109,3.542335872952,4.39249648246048,0.300970873786408
"United States","District of Columbia","DC",2021-03-07,2021-03-13,7,2021,"10",705749,125,10,100,25,115,1.4169343491808,3.542335872952,0.25
"United States","District of Columbia","DC",2021-03-14,2021-03-20,7,2021,"11",705749,147,9,104,43,138,1.27524091426272,6.09281770147744,0.413461538461539
"United States","District of Columbia","DC",2021-03-21,2021-03-27,7,2021,"12",705749,137,7,102,35,130,0.99185404442656,4.9592702221328,0.343137254901961
"United States","District of Columbia","DC",2021-03-28,2021-04-03,7,2021,"13",705749,128,14,102,26,114,1.98370808885312,3.68402930787008,0.254901960784314
"United States","District of Columbia","DC",2021-04-04,2021-04-10,7,2021,"14",705749,160,11,105,55,149,1.55862778409888,7.7931389204944,0.523809523809524
"United States","District of Columbia","DC",2021-04-11,2021-04-17,7,2021,"15",705749,123,14,106,17,109,1.98370808885312,2.40878839360736,0.160377358490566
"United States","District of Columbia","DC",2021-04-18,2021-04-24,7,2021,"16",705749,129,4,106,23,125,0.56677373967232,3.25894900311584,0.216981132075472
"United States","District of Columbia","DC",2021-04-25,2021-05-01,7,2021,"17",705749,123,7,105,18,116,0.99185404442656,2.55048182852544,0.171428571428571
"United States","District of Columbia","DC",2021-05-02,2021-05-08,7,2021,"18",705749,127,4,105,22,123,0.56677373967232,3.11725556819776,0.209523809523809
"United States","District of Columbia","DC",2021-05-09,2021-05-15,7,2021,"19",705749,126,8,103,23,118,1.13354747934464,3.25894900311584,0.223300970873786
"United States","District of Columbia","DC",2021-05-16,2021-05-22,7,2021,"20",705749,135,7,103,32,128,0.99185404442656,4.53418991737856,0.310679611650486
"United States","District of Columbia","DC",2021-05-23,2021-05-29,7,2021,"21",705749,122,7,101,21,115,0.99185404442656,2.97556213327968,0.207920792079208
"United States","District of Columbia","DC",2021-05-30,2021-06-05,7,2021,"22",705749,125,4,104,21,121,0.56677373967232,2.97556213327968,0.201923076923077
"United States","District of Columbia","DC",2021-06-06,2021-06-12,7,2021,"23",705749,140,1,102,38,139,0.14169343491808,5.38435052688704,0.372549019607843
"United States","District of Columbia","DC",2021-06-13,2021-06-19,7,2021,"24",705749,130,4,102,28,126,0.56677373967232,3.96741617770624,0.274509803921569
"United States","District of Columbia","DC",2021-06-20,2021-06-26,7,2021,"25",705749,117,0,103,14,117,0,1.98370808885312,0.135922330097087
"United States","District of Columbia","DC",2021-06-27,2021-07-03,7,2021,"26",705749,108,0,106,2,108,0,0.28338686983616,0.0188679245283019
"United States","District of Columbia","DC",2021-07-04,2021-07-10,7,2021,"27",705749,149,2,107,42,147,0.28338686983616,5.95112426655936,0.392523364485981
"United States","District of Columbia","DC",2021-07-11,2021-07-17,7,2021,"28",705749,123,3,107,16,120,0.42508030475424,2.26709495868928,0.149532710280374
"United States","District of Columbia","DC",2021-07-18,2021-07-24,7,2021,"29",705749,136,0,110,26,136,0,3.68402930787008,0.236363636363636
"United States","District of Columbia","DC",2021-07-25,2021-07-31,7,2021,"30",705749,99,3,111,-12,96,0.42508030475424,-1.70032121901696,-0.108108108108108
"United States","District of Columbia","DC",2021-08-01,2021-08-07,7,2021,"31",705749,124,0,110,14,124,0,1.98370808885312,0.127272727272727
"United States","District of Columbia","DC",2021-08-08,2021-08-14,7,2021,"32",705749,126,1,107,19,125,0.14169343491808,2.69217526344352,0.177570093457944
"United States","District of Columbia","DC",2021-08-15,2021-08-21,7,2021,"33",705749,89,0,111,-22,89,0,-3.11725556819776,-0.198198198198198
"United States","Florida","FL",2019-12-29,2020-01-04,7,2020,"1",21477737,4341,0,4485,-144,4341,0,-0.670461697151799,-0.0321070234113713
"United States","Florida","FL",2020-01-05,2020-01-11,7,2020,"2",21477737,4410,0,4569,-159,4410,0,-0.740301457271779,-0.0347997373604727
"United States","Florida","FL",2020-01-12,2020-01-18,7,2020,"3",21477737,4385,0,4182,203,4385,0,0.945164753623718,0.0485413677666189
"United States","Florida","FL",2020-01-19,2020-01-25,7,2020,"4",21477737,4387,0,4256,131,4387,0,0.609933905047818,0.0307800751879699
"United States","Florida","FL",2020-01-26,2020-02-01,7,2020,"5",21477737,4419,0,4684,-265,4419,0,-1.23383576211963,-0.0565755764304013
"United States","Florida","FL",2020-02-02,2020-02-08,7,2020,"6",21477737,4385,0,4615,-230,4385,0,-1.07087632183968,-0.0498374864572048
"United States","Florida","FL",2020-02-09,2020-02-15,7,2020,"7",21477737,4358,0,4582,-224,4358,0,-1.04294041779169,-0.048886948930598
"United States","Florida","FL",2020-02-16,2020-02-22,7,2020,"8",21477737,4416,0,4576,-160,4416,0,-0.744957441279777,-0.034965034965035
"United States","Florida","FL",2020-02-23,2020-02-29,7,2020,"9",21477737,4399,0,4533,-134,4399,0,-0.623901857071813,-0.0295609971321421
"United States","Florida","FL",2020-03-01,2020-03-07,7,2020,"10",21477737,4520,2,4528,-8,4518,0.00931196801599722,-0.0372478720639889,-0.00176678445229683
"United States","Florida","FL",2020-03-08,2020-03-14,7,2020,"11",21477737,4435,1,4504,-69,4434,0.00465598400799861,-0.321262896551904,-0.0153197158081705
"United States","Florida","FL",2020-03-15,2020-03-21,7,2020,"12",21477737,4362,7,4521,-159,4355,0.0325918880559903,-0.740301457271779,-0.0351692103516921
"United States","Florida","FL",2020-03-22,2020-03-28,7,2020,"13",21477737,4461,46,4491,-30,4415,0.214175264367936,-0.139679520239958,-0.00668002672010692
"United States","Florida","FL",2020-03-29,2020-04-04,7,2020,"14",21477737,4497,139,4414,83,4358,0.647181777111806,0.386446672663884,0.0188038060715905
"United States","Florida","FL",2020-04-05,2020-04-11,7,2020,"15",21477737,4544,251,4358,186,4293,1.16865198600765,0.866013025487741,0.0426801284993117
"United States","Florida","FL",2020-04-12,2020-04-18,7,2020,"16",21477737,4416,304,4275,141,4112,1.41541913843158,0.656493745127804,0.0329824561403509
"United States","Florida","FL",2020-04-19,2020-04-25,7,2020,"17",21477737,4555,304,4236,319,4251,1.41541913843158,1.48525889855156,0.0753068932955618
"United States","Florida","FL",2020-04-26,2020-05-02,7,2020,"18",21477737,4352,310,4177,175,4042,1.44335504247957,0.814797201399756,0.0418960976777591
"United States","Florida","FL",2020-05-03,2020-05-09,7,2020,"19",21477737,4407,349,4099,308,4058,1.62493841879151,1.43404307446357,0.0751402781166137
"United States","Florida","FL",2020-05-10,2020-05-16,7,2020,"20",21477737,4279,250,4074,205,4029,1.16399600199965,0.954476721639715,0.0503190967108493
"United States","Florida","FL",2020-05-17,2020-05-23,7,2020,"21",21477737,4360,269,4033,327,4091,1.25245969815163,1.52250677061554,0.0810810810810811
"United States","Florida","FL",2020-05-24,2020-05-30,7,2020,"22",21477737,4211,214,4032,179,3997,0.996380577711702,0.833421137431751,0.0443948412698412
"United States","Florida","FL",2020-05-31,2020-06-06,7,2020,"23",21477737,4265,242,4018,247,4023,1.12674812993566,1.15002804997566,0.0614733698357393
"United States","Florida","FL",2020-06-07,2020-06-13,7,2020,"24",21477737,4256,237,3998,258,4019,1.10346820989567,1.20124387406364,0.0645322661330665
"United States","Florida","FL",2020-06-14,2020-06-20,7,2020,"25",21477737,4408,219,3989,419,4189,1.0196604977517,1.95085729935142,0.105038856856355
"United States","Florida","FL",2020-06-21,2020-06-27,7,2020,"26",21477737,4504,246,3946,558,4258,1.14537206596766,2.59803907646322,0.141409021794222
"United States","Florida","FL",2020-06-28,2020-07-04,7,2020,"27",21477737,4725,312,3943,782,4413,1.45266701049557,3.64097949425491,0.198326147603348
"United States","Florida","FL",2020-07-05,2020-07-11,7,2020,"28",21477737,5084,495,3942,1142,4589,2.30471208395931,5.31713373713441,0.289700659563673
"United States","Florida","FL",2020-07-12,2020-07-18,7,2020,"29",21477737,5509,698,3900,1609,4811,3.24987683758303,7.49147826886976,0.412564102564102
"United States","Florida","FL",2020-07-19,2020-07-25,7,2020,"30",21477737,5704,882,3858,1846,4822,4.10657789505477,8.59494647876543,0.478486262312079
"United States","Florida","FL",2020-07-26,2020-08-01,7,2020,"31",21477737,5791,1245,3848,1943,4546,5.79670008995827,9.0465769275413,0.50493762993763
"United States","Florida","FL",2020-08-02,2020-08-08,7,2020,"32",21477737,5585,1087,3858,1727,4498,5.06105461669449,8.0408843818136,0.447641264904095
"United States","Florida","FL",2020-08-09,2020-08-15,7,2020,"33",21477737,5510,1236,3859,1651,4274,5.75479623388628,7.6870295972057,0.427831044311998
"United States","Florida","FL",2020-08-16,2020-08-22,7,2020,"34",21477737,5203,929,3857,1346,4274,4.32540914343071,6.26695447476613,0.348975887995852
"United States","Florida","FL",2020-08-23,2020-08-29,7,2020,"35",21477737,5015,831,3873,1142,4184,3.86912271064684,5.31713373713441,0.294861864187968
"United States","Florida","FL",2020-08-30,2020-09-05,7,2020,"36",21477737,4758,706,3860,898,4052,3.28712470964702,4.18107363918275,0.232642487046632
"United States","Florida","FL",2020-09-06,2020-09-12,7,2020,"37",21477737,4513,789,3882,631,3724,3.6735713823109,2.93792590904712,0.162545079855744
"United States","Florida","FL",2020-09-13,2020-09-19,7,2020,"38",21477737,4667,687,3913,754,3980,3.19866101349504,3.51061194203095,0.192691029900332
"United States","Florida","FL",2020-09-20,2020-09-26,7,2020,"39",21477737,4444,735,3939,505,3709,3.42214824587898,2.3512719240393,0.128205128205128
"United States","Florida","FL",2020-09-27,2020-10-03,7,2020,"40",21477737,4346,606,3911,435,3740,2.82152630884716,2.02535304347939,0.111224750703145
"United States","Florida","FL",2020-10-04,2020-10-10,7,2020,"41",21477737,4525,736,3909,616,3789,3.42680422988698,2.86808614892714,0.157585060117677
"United States","Florida","FL",2020-10-11,2020-10-17,7,2020,"42",21477737,4389,553,3887,502,3836,2.57475915642323,2.3373039720153,0.129148443529714
"United States","Florida","FL",2020-10-18,2020-10-24,7,2020,"43",21477737,4335,500,3890,445,3835,2.3279920039993,2.07191288355938,0.11439588688946
"United States","Florida","FL",2020-10-25,2020-10-31,7,2020,"44",21477737,4265,344,3893,372,3921,1.60165849875152,1.73202605097548,0.0955561263806832
"United States","Florida","FL",2020-11-01,2020-11-07,7,2020,"45",21477737,4305,339,3913,392,3966,1.57837857871153,1.82514573113545,0.100178890876565
"United States","Florida","FL",2020-11-08,2020-11-14,7,2020,"46",21477737,4487,388,3933,554,4099,1.80652179510346,2.57941514043123,0.140859394863972
"United States","Florida","FL",2020-11-15,2020-11-21,7,2020,"47",21477737,4561,442,3980,581,4119,2.05794493153538,2.70512670864719,0.145979899497487
"United States","Florida","FL",2020-11-22,2020-11-28,7,2020,"48",21477737,4634,507,3998,636,4127,2.36058389205529,2.96120582908711,0.159079539769885
"United States","Florida","FL",2020-11-29,2020-12-05,7,2020,"49",21477737,4911,632,4020,891,4279,2.94258189305512,4.14848175112676,0.221641791044776
"United States","Florida","FL",2020-12-06,2020-12-12,7,2020,"50",21477737,5085,716,4077,1008,4369,3.333684549727,4.6932318800626,0.247240618101545
"United States","Florida","FL",2020-12-13,2020-12-19,7,2020,"51",21477737,4945,688,4119,826,4257,3.20331699750304,3.84584279060685,0.200534110220927
"United States","Florida","FL",2020-12-20,2020-12-26,7,2020,"52",21477737,5137,661,4151,986,4476,3.07760542928708,4.59080023188663,0.237533124548302
"United States","Florida","FL",2020-12-27,2021-01-02,7,2020,"53",21477737,5709,753,4222,1487,4956,3.50595595802295,6.92344821989393,0.352202747513027
"United States","Florida","FL",2021-01-03,2021-01-09,7,2021,"1",21477737,5497,917,4258,1239,4580,4.26953733533472,5.76876418591028,0.290981681540629
"United States","Florida","FL",2021-01-10,2021-01-16,7,2021,"2",21477737,5923,1200,4276,1647,4723,5.58718080959833,7.66840566117371,0.385173058933583
"United States","Florida","FL",2021-01-17,2021-01-23,7,2021,"3",21477737,5664,1160,4380,1284,4504,5.40094144927839,5.97828346627021,0.293150684931507
"United States","Florida","FL",2021-01-24,2021-01-30,7,2021,"4",21477737,5488,1196,4446,1042,4292,5.56855687356634,4.85153533633455,0.234367971210077
"United States","Florida","FL",2021-01-31,2021-02-06,7,2021,"5",21477737,5569,1243,4394,1175,4326,5.78738812194227,5.47078120939836,0.267410104688211
"United States","Florida","FL",2021-02-07,2021-02-13,7,2021,"6",21477737,5459,1085,4407,1052,4374,5.05174264867849,4.89809517641454,0.238711141366009
"United States","Florida","FL",2021-02-14,2021-02-20,7,2021,"7",21477737,5119,1126,4317,802,3993,5.24263799300643,3.73409917441488,0.18577716006486
"United States","Florida","FL",2021-02-21,2021-02-27,7,2021,"8",21477737,4892,926,4272,620,3966,4.31144119140671,2.88671008495914,0.145131086142322
"United States","Florida","FL",2021-02-28,2021-03-06,7,2021,"9",21477737,4820,886,4253,567,3934,4.12520183108677,2.63994293253521,0.133317658123677
"United States","Florida","FL",2021-03-07,2021-03-13,7,2021,"10",21477737,4637,628,4270,367,4009,2.92395795702313,1.70874613093549,0.0859484777517565
"United States","Florida","FL",2021-03-14,2021-03-20,7,2021,"11",21477737,4600,477,4269,331,4123,2.22090437181534,1.54113070664754,0.0775357226516749
"United States","Florida","FL",2021-03-21,2021-03-27,7,2021,"12",21477737,4750,444,4275,475,4306,2.06725689955138,2.21159240379934,0.111111111111111
"United States","Florida","FL",2021-03-28,2021-04-03,7,2021,"13",21477737,4492,497,4240,252,3995,2.31402405197531,1.17330797001565,0.0594339622641509
"United States","Florida","FL",2021-04-04,2021-04-10,7,2021,"14",21477737,4714,342,4196,518,4372,1.59234653073552,2.41179971614328,0.123450905624404
"United States","Florida","FL",2021-04-11,2021-04-17,7,2021,"15",21477737,4660,390,4158,502,4270,1.81583376311946,2.3373039720153,0.120731120731121
"United States","Florida","FL",2021-04-18,2021-04-24,7,2021,"16",21477737,4735,408,4129,606,4327,1.89964147526343,2.82152630884716,0.146766771615403
"United States","Florida","FL",2021-04-25,2021-05-01,7,2021,"17",21477737,4489,427,4064,425,4062,1.98810517141541,1.97879320339941,0.104576771653543
"United States","Florida","FL",2021-05-02,2021-05-08,7,2021,"18",21477737,4605,461,4014,591,4144,2.14640862768736,2.75168654872718,0.147234678624813
"United States","Florida","FL",2021-05-09,2021-05-15,7,2021,"19",21477737,4531,356,3959,572,4175,1.6575303068475,2.6632228525752,0.144480929527659
"United States","Florida","FL",2021-05-16,2021-05-22,7,2021,"20",21477737,4589,407,3951,638,4182,1.89498549125543,2.97051779710311,0.161478106808403
"United States","Florida","FL",2021-05-23,2021-05-29,7,2021,"21",21477737,4528,311,3925,603,4217,1.44801102648757,2.80755835682316,0.153630573248408
"United States","Florida","FL",2021-05-30,2021-06-05,7,2021,"22",21477737,4394,199,3890,504,4195,0.926540817591723,2.3466159400313,0.129562982005141
"United States","Florida","FL",2021-06-06,2021-06-12,7,2021,"23",21477737,4434,292,3865,569,4142,1.35954733033559,2.64925490055121,0.147218628719276
"United States","Florida","FL",2021-06-13,2021-06-19,7,2021,"24",21477737,4403,290,3853,550,4113,1.3502353623196,2.56079120439923,0.142745912276149
"United States","Florida","FL",2021-06-20,2021-06-26,7,2021,"25",21477737,4516,217,3861,655,4299,1.0103485297357,3.04966952523909,0.16964516964517
"United States","Florida","FL",2021-06-27,2021-07-03,7,2021,"26",21477737,4418,213,3827,591,4205,0.991724593703704,2.75168654872718,0.154429056702378
"United States","Florida","FL",2021-07-04,2021-07-10,7,2021,"27",21477737,4481,190,3796,685,4291,0.884636961519736,3.18934904547905,0.1804531085353
"United States","Florida","FL",2021-07-11,2021-07-17,7,2021,"28",21477737,4501,229,3769,732,4272,1.06622033783168,3.40818029385498,0.194215972406474
"United States","Florida","FL",2021-07-18,2021-07-24,7,2021,"29",21477737,4878,291,3742,1136,4587,1.35489134632759,5.28919783308642,0.303580972741849
"United States","Florida","FL",2021-07-25,2021-07-31,7,2021,"30",21477737,5323,416,3726,1597,4907,1.93688934732742,7.43560646077378,0.428609769189479
"United States","Florida","FL",2021-08-01,2021-08-07,7,2021,"31",21477737,5963,703,3741,2222,5260,3.27315675762302,10.3455964657729,0.59395883453622
"United States","Florida","FL",2021-08-08,2021-08-14,7,2021,"32",21477737,6440,770,3709,2731,5670,3.58510768615893,12.7154923258442,0.73631706659477
"United States","Florida","FL",2021-08-15,2021-08-21,7,2021,"33",21477737,6559,0,3702,2857,6559,0,13.302146310852,0.771745002701242
"United States","Georgia","GA",2019-12-29,2020-01-04,7,2020,"1",10617423,1803,0,1895,-92,1803,0,-0.866500279775987,-0.0485488126649076
"United States","Georgia","GA",2020-01-05,2020-01-11,7,2020,"2",10617423,1807,0,1915,-108,1807,0,-1.01719598060659,-0.0563968668407311
"United States","Georgia","GA",2020-01-12,2020-01-18,7,2020,"3",10617423,1746,0,1932,-186,1746,0,-1.7518375221558,-0.0962732919254659
"United States","Georgia","GA",2020-01-19,2020-01-25,7,2020,"4",10617423,1829,0,1930,-101,1829,0,-0.951266611493203,-0.0523316062176166
"United States","Georgia","GA",2020-01-26,2020-02-01,7,2020,"5",10617423,1797,0,1925,-128,1797,0,-1.20556560664485,-0.0664935064935065
"United States","Georgia","GA",2020-02-02,2020-02-08,7,2020,"6",10617423,1781,0,1857,-76,1781,0,-0.715804578945381,-0.040926225094238
"United States","Georgia","GA",2020-02-09,2020-02-15,7,2020,"7",10617423,1762,0,1825,-63,1762,0,-0.593364322020513,-0.0345205479452054
"United States","Georgia","GA",2020-02-16,2020-02-22,7,2020,"8",10617423,1749,0,1791,-42,1749,0,-0.395576214680342,-0.0234505862646566
"United States","Georgia","GA",2020-02-23,2020-02-29,7,2020,"9",10617423,1860,0,1776,84,1860,0,0.791152429360684,0.0472972972972974
"United States","Georgia","GA",2020-03-01,2020-03-07,7,2020,"10",10617423,1755,0,1776,-21,1755,0,-0.197788107340171,-0.0118243243243243
"United States","Georgia","GA",2020-03-08,2020-03-14,7,2020,"11",10617423,1784,1,1772,12,1783,0.0094184813019129,0.113021775622955,0.00677200902934527
"United States","Georgia","GA",2020-03-15,2020-03-21,7,2020,"12",10617423,1775,19,1773,2,1756,0.178951144736345,0.0188369626038258,0.00112803158488428
"United States","Georgia","GA",2020-03-22,2020-03-28,7,2020,"13",10617423,1881,58,1762,119,1823,0.546271915510948,1.12079927492764,0.0675368898978435
"United States","Georgia","GA",2020-03-29,2020-04-04,7,2020,"14",10617423,2033,129,1739,294,1904,1.21498408794676,2.76903350276239,0.169062679700978
"United States","Georgia","GA",2020-04-05,2020-04-11,7,2020,"15",10617423,2042,223,1740,302,1819,2.10032133032658,2.8443813531777,0.173563218390805
"United States","Georgia","GA",2020-04-12,2020-04-18,7,2020,"16",10617423,2032,243,1709,323,1789,2.28869095636484,3.04216946051787,0.188999414862493
"United States","Georgia","GA",2020-04-19,2020-04-25,7,2020,"17",10617423,2040,229,1692,348,1811,2.15683221813805,3.27763149306569,0.205673758865248
"United States","Georgia","GA",2020-04-26,2020-05-02,7,2020,"18",10617423,1975,263,1677,298,1712,2.47706058240309,2.80670742797005,0.177698270721526
"United States","Georgia","GA",2020-05-03,2020-05-09,7,2020,"19",10617423,1987,225,1663,324,1762,2.1191582929304,3.05158794181978,0.194828622970535
"United States","Georgia","GA",2020-05-10,2020-05-16,7,2020,"20",10617423,1961,194,1652,309,1767,1.8271853725711,2.91031072229109,0.187046004842615
"United States","Georgia","GA",2020-05-17,2020-05-23,7,2020,"21",10617423,1911,234,1623,288,1677,2.20392462464762,2.71252261495092,0.177449168207024
"United States","Georgia","GA",2020-05-24,2020-05-30,7,2020,"22",10617423,1785,180,1602,183,1605,1.69532663434432,1.72358207825006,0.114232209737828
"United States","Georgia","GA",2020-05-31,2020-06-06,7,2020,"23",10617423,1782,173,1607,175,1609,1.62939726523093,1.64823422783476,0.108898568761668
"United States","Georgia","GA",2020-06-07,2020-06-13,7,2020,"24",10617423,1746,269,1595,151,1477,2.53357147021457,1.42219067658885,0.0946708463949844
"United States","Georgia","GA",2020-06-14,2020-06-20,7,2020,"25",10617423,1780,192,1594,186,1588,1.80834840996728,1.7518375221558,0.116687578419072
"United States","Georgia","GA",2020-06-21,2020-06-27,7,2020,"26",10617423,1823,145,1583,240,1678,1.36567978877737,2.2604355124591,0.151610865445357
"United States","Georgia","GA",2020-06-28,2020-07-04,7,2020,"27",10617423,1880,83,1574,306,1797,0.781733948058771,2.88205527838535,0.194409148665819
"United States","Georgia","GA",2020-07-05,2020-07-11,7,2020,"28",10617423,1983,137,1574,409,1846,1.29033193836207,3.85215885248238,0.259847522236341
"United States","Georgia","GA",2020-07-12,2020-07-18,7,2020,"29",10617423,2177,171,1568,609,2006,1.61056030262711,5.73585511286496,0.388392857142857
"United States","Georgia","GA",2020-07-19,2020-07-25,7,2020,"30",10617423,2177,327,1581,596,1850,3.07984338572552,5.61341485594009,0.376976597090449
"United States","Georgia","GA",2020-07-26,2020-08-01,7,2020,"31",10617423,2193,330,1588,605,1863,3.10809882963126,5.69818118765731,0.380982367758187
"United States","Georgia","GA",2020-08-02,2020-08-08,7,2020,"32",10617423,2192,361,1607,585,1831,3.40007174999056,5.50981156161905,0.364032358431861
"United States","Georgia","GA",2020-08-09,2020-08-15,7,2020,"33",10617423,2245,483,1605,640,1762,4.54912646882393,6.02782803322426,0.398753894080997
"United States","Georgia","GA",2020-08-16,2020-08-22,7,2020,"34",10617423,2247,423,1596,651,1824,3.98401759070916,6.1314313275453,0.407894736842105
"United States","Georgia","GA",2020-08-23,2020-08-29,7,2020,"35",10617423,2132,484,1610,522,1648,4.55854495012585,4.91644723959854,0.324223602484472
"United States","Georgia","GA",2020-08-30,2020-09-05,7,2020,"36",10617423,2044,401,1611,433,1643,3.77681100206707,4.07820240372829,0.268777157045313
"United States","Georgia","GA",2020-09-06,2020-09-12,7,2020,"37",10617423,2073,310,1596,477,1763,2.919729203593,4.49261558101245,0.298872180451128
"United States","Georgia","GA",2020-09-13,2020-09-19,7,2020,"38",10617423,1928,312,1601,327,1616,2.93856616619683,3.07984338572552,0.204247345409119
"United States","Georgia","GA",2020-09-20,2020-09-26,7,2020,"39",10617423,1997,315,1607,390,1682,2.96682161010256,3.67320770774603,0.242688238954574
"United States","Georgia","GA",2020-09-27,2020-10-03,7,2020,"40",10617423,1926,220,1613,313,1706,2.07206588642084,2.94798464749874,0.194048357098574
"United States","Georgia","GA",2020-10-04,2020-10-10,7,2020,"41",10617423,1886,259,1609,277,1627,2.43938665719544,2.60891932062987,0.172156619018024
"United States","Georgia","GA",2020-10-11,2020-10-17,7,2020,"42",10617423,1923,214,1624,299,1709,2.01555499860936,2.81612590927196,0.184113300492611
"United States","Georgia","GA",2020-10-18,2020-10-24,7,2020,"43",10617423,1960,201,1616,344,1759,1.89311474168449,3.23995756785804,0.212871287128713
"United States","Georgia","GA",2020-10-25,2020-10-31,7,2020,"44",10617423,1944,163,1628,316,1781,1.5352124522118,2.97624009140448,0.194103194103194
"United States","Georgia","GA",2020-11-01,2020-11-07,7,2020,"45",10617423,2020,219,1642,378,1801,2.06264740511893,3.56018593212308,0.23020706455542
"United States","Georgia","GA",2020-11-08,2020-11-14,7,2020,"46",10617423,2050,257,1646,404,1793,2.42054969459162,3.80506644597281,0.245443499392467
"United States","Georgia","GA",2020-11-15,2020-11-21,7,2020,"47",10617423,1978,166,1671,307,1812,1.56346789611754,2.89147375968726,0.183722321962897
"United States","Georgia","GA",2020-11-22,2020-11-28,7,2020,"48",10617423,2070,158,1701,369,1912,1.48812004570224,3.47541960040586,0.216931216931217
"United States","Georgia","GA",2020-11-29,2020-12-05,7,2020,"49",10617423,2171,196,1724,447,1975,1.84602233517493,4.21006114195507,0.259280742459397
"United States","Georgia","GA",2020-12-06,2020-12-12,7,2020,"50",10617423,2241,236,1741,500,2005,2.22276158725145,4.70924065095645,0.287191269385411
"United States","Georgia","GA",2020-12-13,2020-12-19,7,2020,"51",10617423,2422,231,1756,666,2191,2.17566918074188,6.27270854707399,0.379271070615034
"United States","Georgia","GA",2020-12-20,2020-12-26,7,2020,"52",10617423,2379,274,1778,601,2105,2.58066387672414,5.66050726244965,0.338020247469066
"United States","Georgia","GA",2020-12-27,2021-01-02,7,2020,"53",10617423,2725,183,1801,924,2542,1.72358207825006,8.70267672296752,0.513048306496391
"United States","Georgia","GA",2021-01-03,2021-01-09,7,2021,"1",10617423,2863,389,1827,1036,2474,3.66378922644412,9.75754662878177,0.567049808429119
"United States","Georgia","GA",2021-01-10,2021-01-16,7,2021,"2",10617423,3085,749,1842,1243,2336,7.05444249513276,11.7071722582777,0.674809989142237
"United States","Georgia","GA",2021-01-17,2021-01-23,7,2021,"3",10617423,2944,769,1849,1095,2175,7.24281212117102,10.3132370255946,0.592212006489995
"United States","Georgia","GA",2021-01-24,2021-01-30,7,2021,"4",10617423,2759,770,1821,938,1989,7.25223060247294,8.8345354611943,0.515101592531576
"United States","Georgia","GA",2021-01-31,2021-02-06,7,2021,"5",10617423,2700,756,1798,902,1944,7.12037186424615,8.49547013432544,0.50166852057842
"United States","Georgia","GA",2021-02-07,2021-02-13,7,2021,"6",10617423,2375,638,1763,612,1737,6.00899107062043,5.7641105567707,0.3471355643789
"United States","Georgia","GA",2021-02-14,2021-02-20,7,2021,"7",10617423,2273,668,1738,535,1605,6.29154550967782,5.0388874965234,0.307825086306099
"United States","Georgia","GA",2021-02-21,2021-02-27,7,2021,"8",10617423,2095,438,1705,390,1657,4.12529481023785,3.67320770774603,0.228739002932551
"United States","Georgia","GA",2021-02-28,2021-03-06,7,2021,"9",10617423,1929,536,1712,217,1393,5.04830597782532,2.0438104425151,0.126752336448598
"United States","Georgia","GA",2021-03-07,2021-03-13,7,2021,"10",10617423,1977,285,1696,281,1692,2.68426717104518,2.64659324583753,0.165683962264151
"United States","Georgia","GA",2021-03-14,2021-03-20,7,2021,"11",10617423,1924,275,1708,216,1649,2.59008235802605,2.03439196121319,0.126463700234192
"United States","Georgia","GA",2021-03-21,2021-03-27,7,2021,"12",10617423,1884,336,1704,180,1548,3.16460971744274,1.69532663434432,0.105633802816901
"United States","Georgia","GA",2021-03-28,2021-04-03,7,2021,"13",10617423,1753,2710,1706,47,-957,25.524084328184,0.442668621189906,0.0275498241500587
"United States","Georgia","GA",2021-04-04,2021-04-10,7,2021,"14",10617423,1947,278,1706,241,1669,2.61833780193179,2.26985399376101,0.14126611957796
"United States","Georgia","GA",2021-04-11,2021-04-17,7,2021,"15",10617423,1877,269,1697,180,1608,2.53357147021457,1.69532663434432,0.106069534472599
"United States","Georgia","GA",2021-04-18,2021-04-24,7,2021,"16",10617423,1888,216,1696,192,1672,2.03439196121319,1.80834840996728,0.113207547169811
"United States","Georgia","GA",2021-04-25,2021-05-01,7,2021,"17",10617423,1821,239,1685,136,1582,2.25101703115718,1.28091345706015,0.0807121661721069
"United States","Georgia","GA",2021-05-02,2021-05-08,7,2021,"18",10617423,1810,156,1679,131,1654,1.46928308309841,1.23382105055059,0.0780226325193567
"United States","Georgia","GA",2021-05-09,2021-05-15,7,2021,"19",10617423,1777,137,1652,125,1640,1.29033193836207,1.17731016273911,0.0756658595641646
"United States","Georgia","GA",2021-05-16,2021-05-22,7,2021,"20",10617423,1873,156,1628,245,1717,1.46928308309841,2.30752791896866,0.1504914004914
"United States","Georgia","GA",2021-05-23,2021-05-29,7,2021,"21",10617423,1860,176,1623,237,1684,1.65765270913667,2.23218006855336,0.146025878003697
"United States","Georgia","GA",2021-05-30,2021-06-05,7,2021,"22",10617423,1748,149,1606,142,1599,1.40335371398502,1.33742434487163,0.0884184308841842
"United States","Georgia","GA",2021-06-06,2021-06-12,7,2021,"23",10617423,1742,172,1612,130,1570,1.61997878392902,1.22440256924868,0.0806451612903225
"United States","Georgia","GA",2021-06-13,2021-06-19,7,2021,"24",10617423,1696,161,1601,95,1535,1.51637548960798,0.894755723681726,0.0593379138038725
"United States","Georgia","GA",2021-06-20,2021-06-26,7,2021,"25",10617423,1733,74,1581,152,1659,0.696967616341555,1.43160915789076,0.0961416824794434
"United States","Georgia","GA",2021-06-27,2021-07-03,7,2021,"26",10617423,1728,50,1584,144,1678,0.470924065095645,1.35626130747546,0.0909090909090908
"United States","Georgia","GA",2021-07-04,2021-07-10,7,2021,"27",10617423,1726,43,1586,140,1683,0.404994695982255,1.31858738226781,0.0882723833543506
"United States","Georgia","GA",2021-07-11,2021-07-17,7,2021,"28",10617423,1669,72,1603,66,1597,0.678130653737729,0.621619765926252,0.0411728009981285
"United States","Georgia","GA",2021-07-18,2021-07-24,7,2021,"29",10617423,1742,56,1604,138,1686,0.527434952907123,1.29975041966398,0.0860349127182045
"United States","Georgia","GA",2021-07-25,2021-07-31,7,2021,"30",10617423,1865,62,1597,268,1803,0.5839458407186,2.52415298891266,0.167814652473388
"United States","Georgia","GA",2021-08-01,2021-08-07,7,2021,"31",10617423,1906,126,1613,293,1780,1.18672864404103,2.75961502146048,0.181649101053937
"United States","Georgia","GA",2021-08-08,2021-08-14,7,2021,"32",10617423,2094,176,1614,480,1918,1.65765270913667,4.52087102491819,0.297397769516729
"United States","Georgia","GA",2021-08-15,2021-08-21,7,2021,"33",10617423,2000,36,1620,380,1964,0.339065326868864,3.5790228947269,0.234567901234568
"United States","Hawaii","HI",2019-12-29,2020-01-04,7,2020,"1",1415872,242,0,234,8,242,0,0.565022826922208,0.0341880341880343
"United States","Hawaii","HI",2020-01-05,2020-01-11,7,2020,"2",1415872,242,0,265,-23,242,0,-1.62444062740135,-0.0867924528301887
"United States","Hawaii","HI",2020-01-12,2020-01-18,7,2020,"3",1415872,215,0,264,-49,215,0,-3.46076481489852,-0.185606060606061
"United States","Hawaii","HI",2020-01-19,2020-01-25,7,2020,"4",1415872,242,0,256,-14,242,0,-0.988789947113863,-0.0546875
"United States","Hawaii","HI",2020-01-26,2020-02-01,7,2020,"5",1415872,242,0,250,-8,242,0,-0.565022826922208,-0.032
"United States","Hawaii","HI",2020-02-02,2020-02-08,7,2020,"6",1415872,236,0,249,-13,236,0,-0.918162093748587,-0.0522088353413654
"United States","Hawaii","HI",2020-02-09,2020-02-15,7,2020,"7",1415872,281,0,247,34,281,0,2.40134701441938,0.137651821862348
"United States","Hawaii","HI",2020-02-16,2020-02-22,7,2020,"8",1415872,250,0,248,2,250,0,0.141255706730552,0.00806451612903225
"United States","Hawaii","HI",2020-02-23,2020-02-29,7,2020,"9",1415872,238,0,254,-16,238,0,-1.13004565384442,-0.062992125984252
"United States","Hawaii","HI",2020-03-01,2020-03-07,7,2020,"10",1415872,239,0,254,-15,239,0,-1.05941780047914,-0.0590551181102362
"United States","Hawaii","HI",2020-03-08,2020-03-14,7,2020,"11",1415872,243,0,254,-11,243,0,-0.776906387018036,-0.0433070866141733
"United States","Hawaii","HI",2020-03-15,2020-03-21,7,2020,"12",1415872,212,0,253,-41,212,0,-2.89574198797631,-0.162055335968379
"United States","Hawaii","HI",2020-03-22,2020-03-28,7,2020,"13",1415872,235,0,253,-18,235,0,-1.27130136057497,-0.0711462450592886
"United States","Hawaii","HI",2020-03-29,2020-04-04,7,2020,"14",1415872,235,3,242,-7,232,0.211883560095828,-0.494394973556932,-0.0289256198347108
"United States","Hawaii","HI",2020-04-05,2020-04-11,7,2020,"15",1415872,221,5,237,-16,216,0.35313926682638,-1.13004565384442,-0.0675105485232067
"United States","Hawaii","HI",2020-04-12,2020-04-18,7,2020,"16",1415872,211,1,233,-22,210,0.070627853365276,-1.55381277403607,-0.0944206008583691
"United States","Hawaii","HI",2020-04-19,2020-04-25,7,2020,"17",1415872,200,0,231,-31,200,0,-2.18946345432355,-0.134199134199134
"United States","Hawaii","HI",2020-04-26,2020-05-02,7,2020,"18",1415872,223,7,225,-2,216,0.494394973556932,-0.141255706730552,-0.00888888888888884
"United States","Hawaii","HI",2020-05-03,2020-05-09,7,2020,"19",1415872,210,1,226,-16,209,0.070627853365276,-1.13004565384442,-0.0707964601769911
"United States","Hawaii","HI",2020-05-10,2020-05-16,7,2020,"20",1415872,230,0,226,4,230,0,0.282511413461104,0.0176991150442478
"United States","Hawaii","HI",2020-05-17,2020-05-23,7,2020,"21",1415872,210,0,223,-13,210,0,-0.918162093748587,-0.0582959641255605
"United States","Hawaii","HI",2020-05-24,2020-05-30,7,2020,"22",1415872,200,0,227,-27,200,0,-1.90695204086245,-0.118942731277533
"United States","Hawaii","HI",2020-05-31,2020-06-06,7,2020,"23",1415872,217,0,228,-11,217,0,-0.776906387018036,-0.0482456140350878
"United States","Hawaii","HI",2020-06-07,2020-06-13,7,2020,"24",1415872,203,0,226,-23,203,0,-1.62444062740135,-0.101769911504425
"United States","Hawaii","HI",2020-06-14,2020-06-20,7,2020,"25",1415872,246,0,227,19,246,0,1.34192921394024,0.0837004405286343
"United States","Hawaii","HI",2020-06-21,2020-06-27,7,2020,"26",1415872,236,1,227,9,235,0.070627853365276,0.635650680287484,0.0396475770925111
"United States","Hawaii","HI",2020-06-28,2020-07-04,7,2020,"27",1415872,207,1,225,-18,206,0.070627853365276,-1.27130136057497,-0.08
"United States","Hawaii","HI",2020-07-05,2020-07-11,7,2020,"28",1415872,239,0,220,19,239,0,1.34192921394024,0.0863636363636364
"United States","Hawaii","HI",2020-07-12,2020-07-18,7,2020,"29",1415872,227,5,216,11,222,0.35313926682638,0.776906387018036,0.0509259259259258
"United States","Hawaii","HI",2020-07-19,2020-07-25,7,2020,"30",1415872,219,2,213,6,217,0.141255706730552,0.423767120191656,0.028169014084507
"United States","Hawaii","HI",2020-07-26,2020-08-01,7,2020,"31",1415872,217,0,214,3,217,0,0.211883560095828,0.014018691588785
"United States","Hawaii","HI",2020-08-02,2020-08-08,7,2020,"32",1415872,231,5,214,17,226,0.35313926682638,1.20067350720969,0.0794392523364487
"United States","Hawaii","HI",2020-08-09,2020-08-15,7,2020,"33",1415872,223,9,215,8,214,0.635650680287484,0.565022826922208,0.0372093023255815
"United States","Hawaii","HI",2020-08-16,2020-08-22,7,2020,"34",1415872,242,7,218,24,235,0.494394973556932,1.69506848076662,0.110091743119266
"United States","Hawaii","HI",2020-08-23,2020-08-29,7,2020,"35",1415872,255,15,218,37,240,1.05941780047914,2.61323057451521,0.169724770642202
"United States","Hawaii","HI",2020-08-30,2020-09-05,7,2020,"36",1415872,235,22,220,15,213,1.55381277403607,1.05941780047914,0.0681818181818181
"United States","Hawaii","HI",2020-09-06,2020-09-12,7,2020,"37",1415872,274,13,219,55,261,0.918162093748587,3.88453193509018,0.251141552511416
"United States","Hawaii","HI",2020-09-13,2020-09-19,7,2020,"38",1415872,242,23,216,26,219,1.62444062740135,1.83632418749717,0.12037037037037
"United States","Hawaii","HI",2020-09-20,2020-09-26,7,2020,"39",1415872,242,11,213,29,231,0.776906387018036,2.048207747593,0.136150234741784
"United States","Hawaii","HI",2020-09-27,2020-10-03,7,2020,"40",1415872,214,22,213,1,192,1.55381277403607,0.070627853365276,0.00469483568075124
"United States","Hawaii","HI",2020-10-04,2020-10-10,7,2020,"41",1415872,231,15,209,22,216,1.05941780047914,1.55381277403607,0.105263157894737
"United States","Hawaii","HI",2020-10-11,2020-10-17,7,2020,"42",1415872,237,18,206,31,219,1.27130136057497,2.18946345432355,0.150485436893204
"United States","Hawaii","HI",2020-10-18,2020-10-24,7,2020,"43",1415872,237,26,209,28,211,1.83632418749717,1.97757989422773,0.133971291866029
"United States","Hawaii","HI",2020-10-25,2020-10-31,7,2020,"44",1415872,238,7,214,24,231,0.494394973556932,1.69506848076662,0.11214953271028
"United States","Hawaii","HI",2020-11-01,2020-11-07,7,2020,"45",1415872,236,1,214,22,235,0.070627853365276,1.55381277403607,0.102803738317757
"United States","Hawaii","HI",2020-11-08,2020-11-14,7,2020,"46",1415872,249,2,216,33,247,0.141255706730552,2.33071916105411,0.152777777777778
"United States","Hawaii","HI",2020-11-15,2020-11-21,7,2020,"47",1415872,224,9,227,-3,215,0.635650680287484,-0.211883560095828,-0.013215859030837
"United States","Hawaii","HI",2020-11-22,2020-11-28,7,2020,"48",1415872,216,9,229,-13,207,0.635650680287484,-0.918162093748587,-0.0567685589519651
"United States","Hawaii","HI",2020-11-29,2020-12-05,7,2020,"49",1415872,237,21,232,5,216,1.4831849206708,0.35313926682638,0.021551724137931
"United States","Hawaii","HI",2020-12-06,2020-12-12,7,2020,"50",1415872,212,8,236,-24,204,0.565022826922208,-1.69506848076662,-0.101694915254237
"United States","Hawaii","HI",2020-12-13,2020-12-19,7,2020,"51",1415872,249,0,245,4,249,0,0.282511413461104,0.0163265306122449
"United States","Hawaii","HI",2020-12-20,2020-12-26,7,2020,"52",1415872,198,0,240,-42,198,0,-2.96636984134159,-0.175
"United States","Hawaii","HI",2020-12-27,2021-01-02,7,2020,"53",1415872,225,0,248,-23,225,0,-1.62444062740135,-0.092741935483871
"United States","Hawaii","HI",2021-01-03,2021-01-09,7,2021,"1",1415872,215,38,250,-35,177,2.68385842788049,-2.47197486778466,-0.14
"United States","Hawaii","HI",2021-01-10,2021-01-16,7,2021,"2",1415872,246,13,246,0,233,0.918162093748587,0,0
"United States","Hawaii","HI",2021-01-17,2021-01-23,7,2021,"3",1415872,205,8,246,-41,197,0.565022826922208,-2.89574198797631,-0.166666666666667
"United States","Hawaii","HI",2021-01-24,2021-01-30,7,2021,"4",1415872,228,73,244,-16,155,5.15583329566515,-1.13004565384442,-0.0655737704918032
"United States","Hawaii","HI",2021-01-31,2021-02-06,7,2021,"5",1415872,237,15,243,-6,222,1.05941780047914,-0.423767120191656,-0.0246913580246914
"United States","Hawaii","HI",2021-02-07,2021-02-13,7,2021,"6",1415872,264,9,242,22,255,0.635650680287484,1.55381277403607,0.0909090909090908
"United States","Hawaii","HI",2021-02-14,2021-02-20,7,2021,"7",1415872,251,5,243,8,246,0.35313926682638,0.565022826922208,0.0329218106995885
"United States","Hawaii","HI",2021-02-21,2021-02-27,7,2021,"8",1415872,261,9,248,13,252,0.635650680287484,0.918162093748587,0.0524193548387097
"United States","Hawaii","HI",2021-02-28,2021-03-06,7,2021,"9",1415872,231,5,253,-22,226,0.35313926682638,-1.55381277403607,-0.0869565217391305
"United States","Hawaii","HI",2021-03-07,2021-03-13,7,2021,"10",1415872,253,5,249,4,248,0.35313926682638,0.282511413461104,0.0160642570281124
"United States","Hawaii","HI",2021-03-14,2021-03-20,7,2021,"11",1415872,236,4,249,-13,232,0.282511413461104,-0.918162093748587,-0.0522088353413654
"United States","Hawaii","HI",2021-03-21,2021-03-27,7,2021,"12",1415872,244,9,247,-3,235,0.635650680287484,-0.211883560095828,-0.0121457489878543
"United States","Hawaii","HI",2021-03-28,2021-04-03,7,2021,"13",1415872,251,5,240,11,246,0.35313926682638,0.776906387018036,0.0458333333333334
"United States","Hawaii","HI",2021-04-04,2021-04-10,7,2021,"14",1415872,252,4,233,19,248,0.282511413461104,1.34192921394024,0.0815450643776825
"United States","Hawaii","HI",2021-04-11,2021-04-17,7,2021,"15",1415872,220,3,231,-11,217,0.211883560095828,-0.776906387018036,-0.0476190476190477
"United States","Hawaii","HI",2021-04-18,2021-04-24,7,2021,"16",1415872,256,4,227,29,252,0.282511413461104,2.048207747593,0.127753303964758
"United States","Hawaii","HI",2021-04-25,2021-05-01,7,2021,"17",1415872,236,5,226,10,231,0.35313926682638,0.706278533652759,0.0442477876106195
"United States","Hawaii","HI",2021-05-02,2021-05-08,7,2021,"18",1415872,240,4,226,14,236,0.282511413461104,0.988789947113863,0.0619469026548674
"United States","Hawaii","HI",2021-05-09,2021-05-15,7,2021,"19",1415872,233,3,227,6,230,0.211883560095828,0.423767120191656,0.026431718061674
"United States","Hawaii","HI",2021-05-16,2021-05-22,7,2021,"20",1415872,256,4,227,29,252,0.282511413461104,2.048207747593,0.127753303964758
"United States","Hawaii","HI",2021-05-23,2021-05-29,7,2021,"21",1415872,214,5,227,-13,209,0.35313926682638,-0.918162093748587,-0.0572687224669604
"United States","Hawaii","HI",2021-05-30,2021-06-05,7,2021,"22",1415872,212,3,229,-17,209,0.211883560095828,-1.20067350720969,-0.074235807860262
"United States","Hawaii","HI",2021-06-06,2021-06-12,7,2021,"23",1415872,225,3,227,-2,222,0.211883560095828,-0.141255706730552,-0.00881057268722463
"United States","Hawaii","HI",2021-06-13,2021-06-19,7,2021,"24",1415872,234,5,230,4,229,0.35313926682638,0.282511413461104,0.017391304347826
"United States","Hawaii","HI",2021-06-20,2021-06-26,7,2021,"25",1415872,225,4,231,-6,221,0.282511413461104,-0.423767120191656,-0.025974025974026
"United States","Hawaii","HI",2021-06-27,2021-07-03,7,2021,"26",1415872,213,4,232,-19,209,0.282511413461104,-1.34192921394024,-0.0818965517241379
"United States","Hawaii","HI",2021-07-04,2021-07-10,7,2021,"27",1415872,237,1,226,11,236,0.070627853365276,0.776906387018036,0.0486725663716814
"United States","Hawaii","HI",2021-07-11,2021-07-17,7,2021,"28",1415872,233,4,223,10,229,0.282511413461104,0.706278533652759,0.0448430493273542
"United States","Hawaii","HI",2021-07-18,2021-07-24,7,2021,"29",1415872,228,4,223,5,224,0.282511413461104,0.35313926682638,0.0224215246636772
"United States","Hawaii","HI",2021-07-25,2021-07-31,7,2021,"30",1415872,234,10,218,16,224,0.706278533652759,1.13004565384442,0.073394495412844
"United States","Hawaii","HI",2021-08-01,2021-08-07,7,2021,"31",1415872,210,3,215,-5,207,0.211883560095828,-0.35313926682638,-0.0232558139534884
"United States","Hawaii","HI",2021-08-08,2021-08-14,7,2021,"32",1415872,268,7,210,58,261,0.494394973556932,4.09641549518601,0.276190476190476
"United States","Hawaii","HI",2021-08-15,2021-08-21,7,2021,"33",1415872,259,5,210,49,254,0.35313926682638,3.46076481489852,0.233333333333333
"United States","Idaho","ID",2019-12-29,2020-01-04,7,2020,"1",1787065,278,0,319,-41,278,0,-2.29426461824276,-0.128526645768025
"United States","Idaho","ID",2020-01-05,2020-01-11,7,2020,"2",1787065,292,0,316,-24,292,0,-1.34298416677625,-0.0759493670886076
"United States","Idaho","ID",2020-01-12,2020-01-18,7,2020,"3",1787065,293,0,317,-24,293,0,-1.34298416677625,-0.0757097791798107
"United States","Idaho","ID",2020-01-19,2020-01-25,7,2020,"4",1787065,275,0,314,-39,275,0,-2.18234927101141,-0.124203821656051
"United States","Idaho","ID",2020-01-26,2020-02-01,7,2020,"5",1787065,249,0,308,-59,249,0,-3.30150274332495,-0.191558441558442
"United States","Idaho","ID",2020-02-02,2020-02-08,7,2020,"6",1787065,292,0,302,-10,292,0,-0.559576736156771,-0.0331125827814569
"United States","Idaho","ID",2020-02-09,2020-02-15,7,2020,"7",1787065,279,0,304,-25,279,0,-1.39894184039193,-0.0822368421052632
"United States","Idaho","ID",2020-02-16,2020-02-22,7,2020,"8",1787065,318,0,300,18,318,0,1.00723812508219,0.0600000000000001
"United States","Idaho","ID",2020-02-23,2020-02-29,7,2020,"9",1787065,290,0,296,-6,290,0,-0.335746041694063,-0.0202702702702703
"United States","Idaho","ID",2020-03-01,2020-03-07,7,2020,"10",1787065,278,0,299,-21,278,0,-1.17511114592922,-0.0702341137123745
"United States","Idaho","ID",2020-03-08,2020-03-14,7,2020,"11",1787065,282,0,299,-17,282,0,-0.951280451466511,-0.0568561872909699
"United States","Idaho","ID",2020-03-15,2020-03-21,7,2020,"12",1787065,308,0,299,9,308,0,0.503619062541094,0.0301003344481605
"United States","Idaho","ID",2020-03-22,2020-03-28,7,2020,"13",1787065,332,5,296,36,327,0.279788368078385,2.01447625016438,0.121621621621622
"United States","Idaho","ID",2020-03-29,2020-04-04,7,2020,"14",1787065,271,5,294,-23,266,0.279788368078385,-1.28702649316057,-0.0782312925170068
"United States","Idaho","ID",2020-04-05,2020-04-11,7,2020,"15",1787065,306,17,290,16,289,0.951280451466511,0.895322777850834,0.0551724137931036
"United States","Idaho","ID",2020-04-12,2020-04-18,7,2020,"16",1787065,283,17,286,-3,266,0.951280451466511,-0.167873020847031,-0.0104895104895105
"United States","Idaho","ID",2020-04-19,2020-04-25,7,2020,"17",1787065,262,12,289,-27,250,0.671492083388125,-1.51085718762328,-0.0934256055363322
"United States","Idaho","ID",2020-04-26,2020-05-02,7,2020,"18",1787065,252,7,281,-29,245,0.39170371530974,-1.62277253485464,-0.103202846975089
"United States","Idaho","ID",2020-05-03,2020-05-09,7,2020,"19",1787065,304,4,278,26,300,0.223830694462708,1.4548995140076,0.0935251798561152
"United States","Idaho","ID",2020-05-10,2020-05-16,7,2020,"20",1787065,269,6,282,-13,263,0.335746041694063,-0.727449757003802,-0.0460992907801419
"United States","Idaho","ID",2020-05-17,2020-05-23,7,2020,"21",1787065,262,5,282,-20,257,0.279788368078385,-1.11915347231354,-0.0709219858156028
"United States","Idaho","ID",2020-05-24,2020-05-30,7,2020,"22",1787065,279,4,281,-2,275,0.223830694462708,-0.111915347231354,-0.00711743772241991
"United States","Idaho","ID",2020-05-31,2020-06-06,7,2020,"23",1787065,294,1,287,7,293,0.0559576736156771,0.39170371530974,0.024390243902439
"United States","Idaho","ID",2020-06-07,2020-06-13,7,2020,"24",1787065,286,3,284,2,283,0.167873020847031,0.111915347231354,0.00704225352112675
"United States","Idaho","ID",2020-06-14,2020-06-20,7,2020,"25",1787065,282,3,287,-5,279,0.167873020847031,-0.279788368078385,-0.0174216027874564
"United States","Idaho","ID",2020-06-21,2020-06-27,7,2020,"26",1787065,296,2,283,13,294,0.111915347231354,0.727449757003802,0.0459363957597174
"United States","Idaho","ID",2020-06-28,2020-07-04,7,2020,"27",1787065,281,1,285,-4,280,0.0559576736156771,-0.223830694462708,-0.0140350877192983
"United States","Idaho","ID",2020-07-05,2020-07-11,7,2020,"28",1787065,287,10,283,4,277,0.559576736156771,0.223830694462708,0.0141342756183747
"United States","Idaho","ID",2020-07-12,2020-07-18,7,2020,"29",1787065,312,17,275,37,295,0.951280451466511,2.07043392378005,0.134545454545455
"United States","Idaho","ID",2020-07-19,2020-07-25,7,2020,"30",1787065,328,27,279,49,301,1.51085718762328,2.74192600716818,0.175627240143369
"United States","Idaho","ID",2020-07-26,2020-08-01,7,2020,"31",1787065,327,50,277,50,277,2.79788368078386,2.79788368078386,0.180505415162455
"United States","Idaho","ID",2020-08-02,2020-08-08,7,2020,"32",1787065,312,39,275,37,273,2.18234927101141,2.07043392378005,0.134545454545455
"United States","Idaho","ID",2020-08-09,2020-08-15,7,2020,"33",1787065,319,34,274,45,285,1.90256090293302,2.51809531270547,0.164233576642336
"United States","Idaho","ID",2020-08-16,2020-08-22,7,2020,"34",1787065,360,37,272,88,323,2.07043392378005,4.92427527817958,0.323529411764706
"United States","Idaho","ID",2020-08-23,2020-08-29,7,2020,"35",1787065,327,52,273,54,275,2.90979902801521,3.02171437524656,0.197802197802198
"United States","Idaho","ID",2020-08-30,2020-09-05,7,2020,"36",1787065,352,26,274,78,326,1.4548995140076,4.36469854202281,0.284671532846715
"United States","Idaho","ID",2020-09-06,2020-09-12,7,2020,"37",1787065,321,31,278,43,290,1.73468788208599,2.40617996547412,0.154676258992806
"United States","Idaho","ID",2020-09-13,2020-09-19,7,2020,"38",1787065,320,26,277,43,294,1.4548995140076,2.40617996547412,0.155234657039711
"United States","Idaho","ID",2020-09-20,2020-09-26,7,2020,"39",1787065,292,19,275,17,273,1.06319579869787,0.951280451466511,0.0618181818181818
"United States","Idaho","ID",2020-09-27,2020-10-03,7,2020,"40",1787065,328,20,273,55,308,1.11915347231354,3.07767204886224,0.201465201465201
"United States","Idaho","ID",2020-10-04,2020-10-10,7,2020,"41",1787065,300,27,272,28,273,1.51085718762328,1.56681486123896,0.102941176470588
"United States","Idaho","ID",2020-10-11,2020-10-17,7,2020,"42",1787065,326,22,266,60,304,1.2310688195449,3.35746041694063,0.225563909774436
"United States","Idaho","ID",2020-10-18,2020-10-24,7,2020,"43",1787065,341,42,267,74,299,2.35022229185844,4.14086784756011,0.277153558052434
"United States","Idaho","ID",2020-10-25,2020-10-31,7,2020,"44",1787065,351,57,271,80,294,3.18958739609359,4.47661388925417,0.29520295202952
"United States","Idaho","ID",2020-11-01,2020-11-07,7,2020,"45",1787065,365,54,269,96,311,3.02171437524656,5.371936667105,0.356877323420074
"United States","Idaho","ID",2020-11-08,2020-11-14,7,2020,"46",1787065,410,68,265,145,342,3.80512180586604,8.11386267427318,0.547169811320755
"United States","Idaho","ID",2020-11-15,2020-11-21,7,2020,"47",1787065,391,95,265,126,296,5.31597899348932,7.05066687557532,0.475471698113207
"United States","Idaho","ID",2020-11-22,2020-11-28,7,2020,"48",1787065,424,68,267,157,356,3.80512180586604,8.78535475766131,0.588014981273408
"United States","Idaho","ID",2020-11-29,2020-12-05,7,2020,"49",1787065,397,119,269,128,278,6.65896316026557,7.16258222280667,0.475836431226766
"United States","Idaho","ID",2020-12-06,2020-12-12,7,2020,"50",1787065,373,137,275,98,236,7.66620128534776,5.48385201433636,0.356363636363636
"United States","Idaho","ID",2020-12-13,2020-12-19,7,2020,"51",1787065,394,106,278,116,288,5.93151340326177,6.49109013941854,0.41726618705036
"United States","Idaho","ID",2020-12-20,2020-12-26,7,2020,"52",1787065,390,38,289,101,352,2.12639159739573,5.65172503518339,0.349480968858132
"United States","Idaho","ID",2020-12-27,2021-01-02,7,2020,"53",1787065,349,135,293,56,214,7.55428593811641,3.13362972247792,0.191126279863481
"United States","Idaho","ID",2021-01-03,2021-01-09,7,2021,"1",1787065,389,80,293,96,309,4.47661388925417,5.371936667105,0.327645051194539
"United States","Idaho","ID",2021-01-10,2021-01-16,7,2021,"2",1787065,341,77,290,51,264,4.30874086840714,2.85384135439953,0.175862068965517
"United States","Idaho","ID",2021-01-17,2021-01-23,7,2021,"3",1787065,339,63,293,46,276,3.52533343778766,2.57405298632115,0.156996587030717
"United States","Idaho","ID",2021-01-24,2021-01-30,7,2021,"4",1787065,284,57,289,-5,227,3.18958739609359,-0.279788368078385,-0.0173010380622838
"United States","Idaho","ID",2021-01-31,2021-02-06,7,2021,"5",1787065,328,42,298,30,286,2.35022229185844,1.67873020847031,0.100671140939597
"United States","Idaho","ID",2021-02-07,2021-02-13,7,2021,"6",1787065,305,37,305,0,268,2.07043392378005,0,0
"United States","Idaho","ID",2021-02-14,2021-02-20,7,2021,"7",1787065,298,22,311,-13,276,1.2310688195449,-0.727449757003802,-0.0418006430868167
"United States","Idaho","ID",2021-02-21,2021-02-27,7,2021,"8",1787065,302,34,314,-12,268,1.90256090293302,-0.671492083388125,-0.0382165605095541
"United States","Idaho","ID",2021-02-28,2021-03-06,7,2021,"9",1787065,307,17,305,2,290,0.951280451466511,0.111915347231354,0.00655737704918025
"United States","Idaho","ID",2021-03-07,2021-03-13,7,2021,"10",1787065,309,33,305,4,276,1.84660322931734,0.223830694462708,0.0131147540983607
"United States","Idaho","ID",2021-03-14,2021-03-20,7,2021,"11",1787065,295,31,300,-5,264,1.73468788208599,-0.279788368078385,-0.0166666666666667
"United States","Idaho","ID",2021-03-21,2021-03-27,7,2021,"12",1787065,303,15,299,4,288,0.839365104235157,0.223830694462708,0.0133779264214047
"United States","Idaho","ID",2021-03-28,2021-04-03,7,2021,"13",1787065,325,10,299,26,315,0.559576736156771,1.4548995140076,0.0869565217391304
"United States","Idaho","ID",2021-04-04,2021-04-10,7,2021,"14",1787065,346,23,295,51,323,1.28702649316057,2.85384135439953,0.172881355932203
"United States","Idaho","ID",2021-04-11,2021-04-17,7,2021,"15",1787065,281,28,290,-9,253,1.56681486123896,-0.503619062541094,-0.0310344827586206
"United States","Idaho","ID",2021-04-18,2021-04-24,7,2021,"16",1787065,284,14,288,-4,270,0.783407430619479,-0.223830694462708,-0.0138888888888888
"United States","Idaho","ID",2021-04-25,2021-05-01,7,2021,"17",1787065,277,15,281,-4,262,0.839365104235157,-0.223830694462708,-0.0142348754448398
"United States","Idaho","ID",2021-05-02,2021-05-08,7,2021,"18",1787065,276,15,276,0,261,0.839365104235157,0,0
"United States","Idaho","ID",2021-05-09,2021-05-15,7,2021,"19",1787065,291,3,277,14,288,0.167873020847031,0.783407430619479,0.0505415162454874
"United States","Idaho","ID",2021-05-16,2021-05-22,7,2021,"20",1787065,329,16,282,47,313,0.895322777850834,2.63001065993682,0.166666666666667
"United States","Idaho","ID",2021-05-23,2021-05-29,7,2021,"21",1787065,326,10,280,46,316,0.559576736156771,2.57405298632115,0.164285714285714
"United States","Idaho","ID",2021-05-30,2021-06-05,7,2021,"22",1787065,295,11,280,15,284,0.615534409772448,0.839365104235157,0.0535714285714286
"United States","Idaho","ID",2021-06-06,2021-06-12,7,2021,"23",1787065,325,15,279,46,310,0.839365104235157,2.57405298632115,0.164874551971326
"United States","Idaho","ID",2021-06-13,2021-06-19,7,2021,"24",1787065,317,6,274,43,311,0.335746041694063,2.40617996547412,0.156934306569343
"United States","Idaho","ID",2021-06-20,2021-06-26,7,2021,"25",1787065,297,23,268,29,274,1.28702649316057,1.62277253485464,0.108208955223881
"United States","Idaho","ID",2021-06-27,2021-07-03,7,2021,"26",1787065,316,13,269,47,303,0.727449757003802,2.63001065993682,0.174721189591078
"United States","Idaho","ID",2021-07-04,2021-07-10,7,2021,"27",1787065,291,7,265,26,284,0.39170371530974,1.4548995140076,0.0981132075471698
"United States","Idaho","ID",2021-07-11,2021-07-17,7,2021,"28",1787065,302,8,263,39,294,0.447661388925417,2.18234927101141,0.14828897338403
"United States","Idaho","ID",2021-07-18,2021-07-24,7,2021,"29",1787065,324,10,262,62,314,0.559576736156771,3.46937576417198,0.236641221374046
"United States","Idaho","ID",2021-07-25,2021-07-31,7,2021,"30",1787065,338,14,264,74,324,0.783407430619479,4.14086784756011,0.28030303030303
"United States","Idaho","ID",2021-08-01,2021-08-07,7,2021,"31",1787065,339,13,256,83,326,0.727449757003802,4.6444869101012,0.32421875
"United States","Idaho","ID",2021-08-08,2021-08-14,7,2021,"32",1787065,332,35,260,72,297,1.9585185765487,4.02895250032875,0.276923076923077
"United States","Idaho","ID",2021-08-15,2021-08-21,7,2021,"33",1787065,325,6,264,61,319,0.335746041694063,3.4134180905563,0.231060606060606
"United States","Illinois","IL",2019-12-29,2020-01-04,7,2020,"1",12671821,2191,0,2391,-200,2191,0,-1.57830512283909,-0.0836470096194061
"United States","Illinois","IL",2020-01-05,2020-01-11,7,2020,"2",12671821,2252,0,2417,-165,2252,0,-1.30210172634225,-0.0682664460074472
"United States","Illinois","IL",2020-01-12,2020-01-18,7,2020,"3",12671821,2231,0,2392,-161,2231,0,-1.27053562388547,-0.0673076923076923
"United States","Illinois","IL",2020-01-19,2020-01-25,7,2020,"4",12671821,2199,0,2377,-178,2199,0,-1.40469155932679,-0.0748843079511989
"United States","Illinois","IL",2020-01-26,2020-02-01,7,2020,"5",12671821,2137,0,2352,-215,2137,0,-1.69667800705203,-0.0914115646258503
"United States","Illinois","IL",2020-02-02,2020-02-08,7,2020,"6",12671821,2232,0,2324,-92,2232,0,-0.726020356505983,-0.0395869191049913
"United States","Illinois","IL",2020-02-09,2020-02-15,7,2020,"7",12671821,2216,0,2296,-80,2216,0,-0.631322049135637,-0.0348432055749129
"United States","Illinois","IL",2020-02-16,2020-02-22,7,2020,"8",12671821,2207,0,2261,-54,2207,0,-0.426142383166555,-0.0238832375055286
"United States","Illinois","IL",2020-02-23,2020-02-29,7,2020,"9",12671821,2209,0,2220,-11,2209,0,-0.0868067817561501,-0.0049549549549549
"United States","Illinois","IL",2020-03-01,2020-03-07,7,2020,"10",12671821,2254,0,2222,32,2254,0,0.252528819654255,0.0144014401440145
"United States","Illinois","IL",2020-03-08,2020-03-14,7,2020,"11",12671821,2191,0,2203,-12,2191,0,-0.0946983073703456,-0.00544711756695415
"United States","Illinois","IL",2020-03-15,2020-03-21,7,2020,"12",12671821,2283,6,2187,96,2277,0.0473491536851728,0.757586458962765,0.0438957475994513
"United States","Illinois","IL",2020-03-22,2020-03-28,7,2020,"13",12671821,2304,41,2174,130,2263,0.323552550182014,1.02589832984541,0.0597976080956761
"United States","Illinois","IL",2020-03-29,2020-04-04,7,2020,"14",12671821,2622,197,2162,460,2425,1.55463054599651,3.63010178252991,0.212765957446809
"United States","Illinois","IL",2020-04-05,2020-04-11,7,2020,"15",12671821,2870,433,2130,740,2437,3.41703059094664,5.83972895450464,0.347417840375587
"United States","Illinois","IL",2020-04-12,2020-04-18,7,2020,"16",12671821,2912,582,2119,793,2330,4.59286790746176,6.257979812057,0.374233128834356
"United States","Illinois","IL",2020-04-19,2020-04-25,7,2020,"17",12671821,3010,616,2078,932,2394,4.86117977834441,7.35490187243017,0.448508180943215
"United States","Illinois","IL",2020-04-26,2020-05-02,7,2020,"18",12671821,2952,679,2025,927,2273,5.35834589203872,7.3154442443592,0.457777777777778
"United States","Illinois","IL",2020-05-03,2020-05-09,7,2020,"19",12671821,2962,793,2002,960,2169,6.257979812057,7.57586458962765,0.479520479520479
"United States","Illinois","IL",2020-05-10,2020-05-16,7,2020,"20",12671821,2865,780,1959,906,2085,6.15538997907246,7.14972220646109,0.462480857580398
"United States","Illinois","IL",2020-05-17,2020-05-23,7,2020,"21",12671821,2638,663,1961,677,1975,5.23208148221159,5.34256284081033,0.345232024477307
"United States","Illinois","IL",2020-05-24,2020-05-30,7,2020,"22",12671821,2547,540,1963,584,2007,4.26142383166555,4.60865095869015,0.297503820682629
"United States","Illinois","IL",2020-05-31,2020-06-06,7,2020,"23",12671821,2511,533,1946,565,1978,4.20618315236618,4.45871197202044,0.290339157245632
"United States","Illinois","IL",2020-06-07,2020-06-13,7,2020,"24",12671821,2270,426,1947,323,1844,3.36178991164727,2.54896277338514,0.165896250642013
"United States","Illinois","IL",2020-06-14,2020-06-20,7,2020,"25",12671821,2255,336,1926,329,1919,2.65155260636968,2.59631192707031,0.170820353063344
"United States","Illinois","IL",2020-06-21,2020-06-27,7,2020,"26",12671821,2134,248,1937,197,1886,1.95709835232048,1.55463054599651,0.101703665462055
"United States","Illinois","IL",2020-06-28,2020-07-04,7,2020,"27",12671821,2182,141,1936,246,2041,1.11270511160156,1.94131530109208,0.127066115702479
"United States","Illinois","IL",2020-07-05,2020-07-11,7,2020,"28",12671821,2189,154,1930,259,2035,1.2152949445861,2.04390513407663,0.13419689119171
"United States","Illinois","IL",2020-07-12,2020-07-18,7,2020,"29",12671821,2087,122,1933,154,1965,0.962766124931847,1.2152949445861,0.0796689084324884
"United States","Illinois","IL",2020-07-19,2020-07-25,7,2020,"30",12671821,2034,107,1931,103,1927,0.844393240718915,0.812827138262133,0.0533402382185397
"United States","Illinois","IL",2020-07-26,2020-08-01,7,2020,"31",12671821,2071,106,1927,144,1965,0.836501715104719,1.13637968844415,0.0747275557861962
"United States","Illinois","IL",2020-08-02,2020-08-08,7,2020,"32",12671821,2138,128,1932,206,2010,1.01011527861702,1.62565427652427,0.106625258799172
"United States","Illinois","IL",2020-08-09,2020-08-15,7,2020,"33",12671821,2126,95,1921,205,2031,0.749694933348569,1.61776275091007,0.10671525247267
"United States","Illinois","IL",2020-08-16,2020-08-22,7,2020,"34",12671821,2151,148,1923,228,2003,1.16794579090093,1.79926784003657,0.118564742589704
"United States","Illinois","IL",2020-08-23,2020-08-29,7,2020,"35",12671821,2120,134,1937,183,1986,1.05746443230219,1.44414918739777,0.0944759938048529
"United States","Illinois","IL",2020-08-30,2020-09-05,7,2020,"36",12671821,2198,158,1950,248,2040,1.24686104704288,1.95709835232048,0.127179487179487
"United States","Illinois","IL",2020-09-06,2020-09-12,7,2020,"37",12671821,2080,129,1963,117,1951,1.01800680423121,0.923308496860869,0.0596026490066226
"United States","Illinois","IL",2020-09-13,2020-09-19,7,2020,"38",12671821,2080,141,1980,100,1939,1.11270511160156,0.789152561419547,0.0505050505050506
"United States","Illinois","IL",2020-09-20,2020-09-26,7,2020,"39",12671821,2295,152,1984,311,2143,1.19951189335771,2.45426446601479,0.156754032258065
"United States","Illinois","IL",2020-09-27,2020-10-03,7,2020,"40",12671821,2138,186,1977,161,1952,1.46782376424036,1.27053562388547,0.0814365199797673
"United States","Illinois","IL",2020-10-04,2020-10-10,7,2020,"41",12671821,2333,201,1956,377,2132,1.58619664845329,2.97510515655169,0.192740286298569
"United States","Illinois","IL",2020-10-11,2020-10-17,7,2020,"42",12671821,2281,217,1957,324,2064,1.71246105828042,2.55685429899933,0.165559529892693
"United States","Illinois","IL",2020-10-18,2020-10-24,7,2020,"43",12671821,2290,289,1968,322,2001,2.28065090250249,2.54107124777094,0.163617886178862
"United States","Illinois","IL",2020-10-25,2020-10-31,7,2020,"44",12671821,2455,228,1965,490,2227,1.79926784003657,3.86684755095578,0.249363867684478
"United States","Illinois","IL",2020-11-01,2020-11-07,7,2020,"45",12671821,2699,444,1987,712,2255,3.50383737270279,5.61876623730717,0.35832913940614
"United States","Illinois","IL",2020-11-08,2020-11-14,7,2020,"46",12671821,2905,515,1992,913,2390,4.06413569131066,7.20496288576046,0.458333333333333
"United States","Illinois","IL",2020-11-15,2020-11-21,7,2020,"47",12671821,3186,762,1991,1195,2424,6.01334251801694,9.43037310896358,0.600200904068307
"United States","Illinois","IL",2020-11-22,2020-11-28,7,2020,"48",12671821,3151,707,2015,1136,2444,5.57930860923619,8.96477309772605,0.563771712158809
"United States","Illinois","IL",2020-11-29,2020-12-05,7,2020,"49",12671821,3282,1041,2034,1248,2241,8.21507816437748,9.84862396651594,0.613569321533923
"United States","Illinois","IL",2020-12-06,2020-12-12,7,2020,"50",12671821,3345,998,2037,1308,2347,7.87574256296707,10.3221155033677,0.642120765832106
"United States","Illinois","IL",2020-12-13,2020-12-19,7,2020,"51",12671821,3130,944,2070,1060,2186,7.44960017980052,8.36501715104719,0.51207729468599
"United States","Illinois","IL",2020-12-20,2020-12-26,7,2020,"52",12671821,3040,745,2094,946,2295,5.87918658257562,7.46538323102891,0.451766953199618
"United States","Illinois","IL",2020-12-27,2021-01-02,7,2020,"53",12671821,3031,802,2105,926,2229,6.32900354258476,7.307552718745,0.439904988123516
"United States","Illinois","IL",2021-01-03,2021-01-09,7,2021,"1",12671821,2794,827,2142,652,1967,6.52629168293965,5.14527470045544,0.304388422035481
"United States","Illinois","IL",2021-01-10,2021-01-16,7,2021,"2",12671821,2733,684,2172,561,2049,5.3978035201097,4.42714586956366,0.25828729281768
"United States","Illinois","IL",2021-01-17,2021-01-23,7,2021,"3",12671821,2608,531,2166,442,2077,4.19040010113779,3.4880543214744,0.204062788550323
"United States","Illinois","IL",2021-01-24,2021-01-30,7,2021,"4",12671821,2585,494,2172,413,2091,3.89841365341256,3.25920007866273,0.190147329650092
"United States","Illinois","IL",2021-01-31,2021-02-06,7,2021,"5",12671821,2562,382,2178,384,2180,3.01456278462267,3.03034583585106,0.176308539944904
"United States","Illinois","IL",2021-02-07,2021-02-13,7,2021,"6",12671821,2476,344,2158,318,2132,2.71468481128324,2.50950514531416,0.147358665430955
"United States","Illinois","IL",2021-02-14,2021-02-20,7,2021,"7",12671821,2439,308,2124,315,2131,2.4305898891722,2.48583056847157,0.148305084745763
"United States","Illinois","IL",2021-02-21,2021-02-27,7,2021,"8",12671821,2333,260,2112,221,2073,2.05179665969082,1.7440271607372,0.104640151515152
"United States","Illinois","IL",2021-02-28,2021-03-06,7,2021,"9",12671821,2178,258,2088,90,1920,2.03601360846243,0.710237305277592,0.0431034482758621
"United States","Illinois","IL",2021-03-07,2021-03-13,7,2021,"10",12671821,2109,174,2094,15,1935,1.37312545687001,0.118372884212932,0.00716332378223505
"United States","Illinois","IL",2021-03-14,2021-03-20,7,2021,"11",12671821,2125,133,2077,48,1992,1.049572906688,0.378793229481382,0.0231102551757343
"United States","Illinois","IL",2021-03-21,2021-03-27,7,2021,"12",12671821,2134,171,2055,79,1963,1.34945088002742,0.623430523521442,0.0384428223844282
"United States","Illinois","IL",2021-03-28,2021-04-03,7,2021,"13",12671821,2181,2402,2064,117,-221,18.9554445252975,0.923308496860869,0.0566860465116279
"United States","Illinois","IL",2021-04-04,2021-04-10,7,2021,"14",12671821,2239,142,2039,200,2097,1.12059663721576,1.57830512283909,0.0980872976949485
"United States","Illinois","IL",2021-04-11,2021-04-17,7,2021,"15",12671821,2114,168,2018,96,1946,1.32577630318484,0.757586458962765,0.047571853320119
"United States","Illinois","IL",2021-04-18,2021-04-24,7,2021,"16",12671821,2227,169,2004,223,2058,1.33366782879903,1.75981021196559,0.11127744510978
"United States","Illinois","IL",2021-04-25,2021-05-01,7,2021,"17",12671821,2230,216,1978,252,2014,1.70456953266622,1.98866445477726,0.127401415571284
"United States","Illinois","IL",2021-05-02,2021-05-08,7,2021,"18",12671821,2161,216,1968,193,1945,1.70456953266622,1.52306444353972,0.098069105691057
"United States","Illinois","IL",2021-05-09,2021-05-15,7,2021,"19",12671821,2136,179,1951,185,1957,1.41258308494099,1.45993223862616,0.0948231676063558
"United States","Illinois","IL",2021-05-16,2021-05-22,7,2021,"20",12671821,2221,210,1933,288,2011,1.65722037898105,2.27275937688829,0.148991205380238
"United States","Illinois","IL",2021-05-23,2021-05-29,7,2021,"21",12671821,2029,231,1903,126,1798,1.82294241687915,0.994332227388629,0.0662112454019967
"United States","Illinois","IL",2021-05-30,2021-06-05,7,2021,"22",12671821,2189,116,1890,299,2073,0.915416971246674,2.35956615864444,0.158201058201058
"United States","Illinois","IL",2021-06-06,2021-06-12,7,2021,"23",12671821,2123,187,1886,237,1936,1.47571528985455,1.87029157056433,0.125662778366914
"United States","Illinois","IL",2021-06-13,2021-06-19,7,2021,"24",12671821,2040,97,1870,170,1943,0.76547798457696,1.34155935441323,0.0909090909090908
"United States","Illinois","IL",2021-06-20,2021-06-26,7,2021,"25",12671821,2006,71,1858,148,1935,0.560298318607878,1.16794579090093,0.0796555435952637
"United States","Illinois","IL",2021-06-27,2021-07-03,7,2021,"26",12671821,2053,59,1870,183,1994,0.465600011237532,1.44414918739777,0.097860962566845
"United States","Illinois","IL",2021-07-04,2021-07-10,7,2021,"27",12671821,2099,59,1869,230,2040,0.465600011237532,1.81505089126496,0.123060460139112
"United States","Illinois","IL",2021-07-11,2021-07-17,7,2021,"28",12671821,2110,65,1875,235,2045,0.512949164922705,1.85450851933593,0.125333333333333
"United States","Illinois","IL",2021-07-18,2021-07-24,7,2021,"29",12671821,2077,47,1867,210,2030,0.370901703867187,1.65722037898105,0.112479914301018
"United States","Illinois","IL",2021-07-25,2021-07-31,7,2021,"30",12671821,2062,49,1874,188,2013,0.386684755095578,1.48360681546875,0.100320170757737
"United States","Illinois","IL",2021-08-01,2021-08-07,7,2021,"31",12671821,2097,76,1853,244,2021,0.599755946678855,1.92553224986369,0.131678359417161
"United States","Illinois","IL",2021-08-08,2021-08-14,7,2021,"32",12671821,2144,100,1852,292,2044,0.789152561419547,2.30432547934508,0.157667386609071
"United States","Illinois","IL",2021-08-15,2021-08-21,7,2021,"33",12671821,2191,31,1850,341,2160,0.244637294040059,2.69101023444065,0.184324324324324
"United States","Indiana","IN",2019-12-29,2020-01-04,7,2020,"1",6732219,1470,0,1501,-31,1470,0,-0.460472245481022,-0.0206528980679547
"United States","Indiana","IN",2020-01-05,2020-01-11,7,2020,"2",6732219,1386,0,1511,-125,1386,0,-1.8567429253267,-0.0827266710787558
"United States","Indiana","IN",2020-01-12,2020-01-18,7,2020,"3",6732219,1389,0,1512,-123,1389,0,-1.82703503852147,-0.0813492063492064
"United States","Indiana","IN",2020-01-19,2020-01-25,7,2020,"4",6732219,1422,0,1495,-73,1422,0,-1.08433786839079,-0.0488294314381271
"United States","Indiana","IN",2020-01-26,2020-02-01,7,2020,"5",6732219,1380,0,1468,-88,1380,0,-1.30714701943,-0.0599455040871935
"United States","Indiana","IN",2020-02-02,2020-02-08,7,2020,"6",6732219,1363,0,1451,-88,1363,0,-1.30714701943,-0.0606478290833907
"United States","Indiana","IN",2020-02-09,2020-02-15,7,2020,"7",6732219,1429,0,1425,4,1429,0,0.0594157736104544,0.0028070175438597
"United States","Indiana","IN",2020-02-16,2020-02-22,7,2020,"8",6732219,1412,0,1418,-6,1412,0,-0.0891236604156817,-0.00423131170662905
"United States","Indiana","IN",2020-02-23,2020-02-29,7,2020,"9",6732219,1449,0,1396,53,1449,0,0.787259000338521,0.0379656160458453
"United States","Indiana","IN",2020-03-01,2020-03-07,7,2020,"10",6732219,1372,0,1390,-18,1372,0,-0.267370981247045,-0.0129496402877698
"United States","Indiana","IN",2020-03-08,2020-03-14,7,2020,"11",6732219,1407,0,1391,16,1407,0,0.237663094441818,0.0115025161754134
"United States","Indiana","IN",2020-03-15,2020-03-21,7,2020,"12",6732219,1329,9,1388,-59,1320,0.133685490623523,-0.876382660754203,-0.042507204610951
"United States","Indiana","IN",2020-03-22,2020-03-28,7,2020,"13",6732219,1486,38,1368,118,1448,0.564449849299317,1.75276532150841,0.0862573099415205
"United States","Indiana","IN",2020-03-29,2020-04-04,7,2020,"14",6732219,1581,138,1351,230,1443,2.04984418956068,3.41640698260113,0.170244263508512
"United States","Indiana","IN",2020-04-05,2020-04-11,7,2020,"15",6732219,1633,207,1335,298,1426,3.07476628434102,4.42647513397886,0.223220973782772
"United States","Indiana","IN",2020-04-12,2020-04-18,7,2020,"16",6732219,1510,224,1313,197,1286,3.32728332218545,2.92622685031488,0.15003808073115
"United States","Indiana","IN",2020-04-19,2020-04-25,7,2020,"17",6732219,1597,227,1292,305,1370,3.37184515239329,4.53045273779715,0.236068111455108
"United States","Indiana","IN",2020-04-26,2020-05-02,7,2020,"18",6732219,1537,272,1265,272,1265,4.0402726055109,4.0402726055109,0.21501976284585
"United States","Indiana","IN",2020-05-03,2020-05-09,7,2020,"19",6732219,1583,247,1230,353,1336,3.66892402044556,5.2434420211226,0.286991869918699
"United States","Indiana","IN",2020-05-10,2020-05-16,7,2020,"20",6732219,1572,234,1228,344,1338,3.47582275621158,5.10975653049908,0.280130293159609
"United States","Indiana","IN",2020-05-17,2020-05-23,7,2020,"21",6732219,1474,216,1215,259,1258,3.20845177496454,3.84717134127693,0.213168724279835
"United States","Indiana","IN",2020-05-24,2020-05-30,7,2020,"22",6732219,1383,131,1216,167,1252,1.94586658574238,2.48060854823647,0.137335526315789
"United States","Indiana","IN",2020-05-31,2020-06-06,7,2020,"23",6732219,1396,167,1201,195,1229,2.48060854823647,2.89651896350965,0.162364696086595
"United States","Indiana","IN",2020-06-07,2020-06-13,7,2020,"24",6732219,1392,121,1195,197,1271,1.79732715171625,2.92622685031488,0.164853556485356
"United States","Indiana","IN",2020-06-14,2020-06-20,7,2020,"25",6732219,1353,115,1199,154,1238,1.70820349130057,2.2875072840025,0.128440366972477
"United States","Indiana","IN",2020-06-21,2020-06-27,7,2020,"26",6732219,1380,78,1199,181,1302,1.15860758540386,2.68856375587306,0.150959132610509
"United States","Indiana","IN",2020-06-28,2020-07-04,7,2020,"27",6732219,1345,70,1193,152,1275,1.03977603818295,2.25779939719727,0.127409891031014
"United States","Indiana","IN",2020-07-05,2020-07-11,7,2020,"28",6732219,1352,69,1200,152,1283,1.02492209478034,2.25779939719727,0.126666666666667
"United States","Indiana","IN",2020-07-12,2020-07-18,7,2020,"29",6732219,1383,64,1190,193,1319,0.950652377767271,2.86681107670443,0.16218487394958
"United States","Indiana","IN",2020-07-19,2020-07-25,7,2020,"30",6732219,1318,71,1180,138,1247,1.05462998158557,2.04984418956068,0.116949152542373
"United States","Indiana","IN",2020-07-26,2020-08-01,7,2020,"31",6732219,1367,73,1184,183,1294,1.08433786839079,2.71827164267829,0.154560810810811
"United States","Indiana","IN",2020-08-02,2020-08-08,7,2020,"32",6732219,1344,63,1189,155,1281,0.935798434364657,2.30236122740511,0.130361648444071
"United States","Indiana","IN",2020-08-09,2020-08-15,7,2020,"33",6732219,1372,87,1192,180,1285,1.29229307602738,2.67370981247045,0.151006711409396
"United States","Indiana","IN",2020-08-16,2020-08-22,7,2020,"34",6732219,1359,80,1189,170,1279,1.18831547220909,2.52517037844431,0.142977291841884
"United States","Indiana","IN",2020-08-23,2020-08-29,7,2020,"35",6732219,1356,284,1191,165,1072,4.21851992634227,2.45090066143125,0.138539042821159
"United States","Indiana","IN",2020-08-30,2020-09-05,7,2020,"36",6732219,1271,77,1192,79,1194,1.14375364200125,1.17346152880648,0.0662751677852349
"United States","Indiana","IN",2020-09-06,2020-09-12,7,2020,"37",6732219,1343,75,1191,152,1268,1.11404575519602,2.25779939719727,0.127623845507977
"United States","Indiana","IN",2020-09-13,2020-09-19,7,2020,"38",6732219,1409,66,1189,220,1343,0.980360264572498,3.26786754857499,0.185029436501261
"United States","Indiana","IN",2020-09-20,2020-09-26,7,2020,"39",6732219,1441,74,1190,251,1367,1.09919181179341,3.72833979405602,0.210924369747899
"United States","Indiana","IN",2020-09-27,2020-10-03,7,2020,"40",6732219,1411,92,1189,222,1319,1.36656279304045,3.29757543538022,0.186711522287637
"United States","Indiana","IN",2020-10-04,2020-10-10,7,2020,"41",6732219,1442,113,1194,248,1329,1.67849560449534,3.68377796384818,0.207705192629816
"United States","Indiana","IN",2020-10-11,2020-10-17,7,2020,"42",6732219,1524,136,1204,320,1388,2.02013630275545,4.75326188883636,0.26578073089701
"United States","Indiana","IN",2020-10-18,2020-10-24,7,2020,"43",6732219,1514,200,1204,310,1314,2.97078868052272,4.60472245481022,0.257475083056478
"United States","Indiana","IN",2020-10-25,2020-10-31,7,2020,"44",6732219,1600,213,1212,388,1387,3.1638899447567,5.76333004021408,0.32013201320132
"United States","Indiana","IN",2020-11-01,2020-11-07,7,2020,"45",6732219,1655,260,1220,435,1395,3.86202528467954,6.46146538013692,0.35655737704918
"United States","Indiana","IN",2020-11-08,2020-11-14,7,2020,"46",6732219,1721,296,1224,497,1425,4.39676724717363,7.38240987109896,0.406045751633987
"United States","Indiana","IN",2020-11-15,2020-11-21,7,2020,"47",6732219,1936,359,1225,711,1577,5.33256568153829,10.5611537592583,0.580408163265306
"United States","Indiana","IN",2020-11-22,2020-11-28,7,2020,"48",6732219,2015,417,1248,767,1598,6.19409439888988,11.3929745898046,0.614583333333333
"United States","Indiana","IN",2020-11-29,2020-12-05,7,2020,"49",6732219,1943,544,1262,681,1399,8.08054521102181,10.1155354571799,0.539619651347068
"United States","Indiana","IN",2020-12-06,2020-12-12,7,2020,"50",6732219,2119,550,1287,832,1569,8.16966887143749,12.3584809109745,0.646464646464646
"United States","Indiana","IN",2020-12-13,2020-12-19,7,2020,"51",6732219,2060,581,1306,754,1479,8.63014111691851,11.1998733255707,0.577335375191424
"United States","Indiana","IN",2020-12-20,2020-12-26,7,2020,"52",6732219,2010,463,1323,687,1547,6.8773757954101,10.2046591175956,0.519274376417234
"United States","Indiana","IN",2020-12-27,2021-01-02,7,2020,"53",6732219,2050,609,1340,710,1441,9.04605153219169,10.5462998158557,0.529850746268657
"United States","Indiana","IN",2021-01-03,2021-01-09,7,2021,"1",6732219,1981,556,1363,618,1425,8.25879253185317,9.17973702281521,0.453411592076302
"United States","Indiana","IN",2021-01-10,2021-01-16,7,2021,"2",6732219,1914,321,1370,544,1593,4.76811583223897,8.08054521102181,0.397080291970803
"United States","Indiana","IN",2021-01-17,2021-01-23,7,2021,"3",6732219,1793,405,1377,416,1388,6.01584707805851,6.17924045548726,0.302106027596224
"United States","Indiana","IN",2021-01-24,2021-01-30,7,2021,"4",6732219,1624,275,1375,249,1349,4.08483443571874,3.69863190725079,0.181090909090909
"United States","Indiana","IN",2021-01-31,2021-02-06,7,2021,"5",6732219,1606,1785,1372,234,-179,26.5142889736653,3.47582275621158,0.170553935860058
"United States","Indiana","IN",2021-02-07,2021-02-13,7,2021,"6",6732219,1512,397,1363,149,1115,5.8970155308376,2.21323756698943,0.10931768158474
"United States","Indiana","IN",2021-02-14,2021-02-20,7,2021,"7",6732219,1464,189,1344,120,1275,2.80739530309397,1.78247320831363,0.0892857142857142
"United States","Indiana","IN",2021-02-21,2021-02-27,7,2021,"8",6732219,1437,222,1332,105,1215,3.29757543538022,1.55966405727443,0.0788288288288288
"United States","Indiana","IN",2021-02-28,2021-03-06,7,2021,"9",6732219,1414,168,1330,84,1246,2.49546249163909,1.24773124581954,0.0631578947368421
"United States","Indiana","IN",2021-03-07,2021-03-13,7,2021,"10",6732219,1376,119,1321,55,1257,1.76761926491102,0.816966887143749,0.0416351249053748
"United States","Indiana","IN",2021-03-14,2021-03-20,7,2021,"11",6732219,1313,82,1330,-17,1231,1.21802335901432,-0.252517037844431,-0.012781954887218
"United States","Indiana","IN",2021-03-21,2021-03-27,7,2021,"12",6732219,1308,85,1324,-16,1223,1.26258518922216,-0.237663094441818,-0.0120845921450151
"United States","Indiana","IN",2021-03-28,2021-04-03,7,2021,"13",6732219,1287,64,1326,-39,1223,0.950652377767271,-0.579303792701931,-0.0294117647058824
"United States","Indiana","IN",2021-04-04,2021-04-10,7,2021,"14",6732219,1381,60,1311,70,1321,0.891236604156817,1.03977603818295,0.0533943554538521
"United States","Indiana","IN",2021-04-11,2021-04-17,7,2021,"15",6732219,1399,78,1300,99,1321,1.15860758540386,1.47054039685875,0.0761538461538462
"United States","Indiana","IN",2021-04-18,2021-04-24,7,2021,"16",6732219,1292,55,1277,15,1237,0.816966887143749,0.222809151039204,0.0117462803445576
"United States","Indiana","IN",2021-04-25,2021-05-01,7,2021,"17",6732219,1369,67,1278,91,1302,0.995214207975112,1.35170884963784,0.0712050078247262
"United States","Indiana","IN",2021-05-02,2021-05-08,7,2021,"18",6732219,1329,67,1266,63,1262,0.995214207975112,0.935798434364657,0.0497630331753554
"United States","Indiana","IN",2021-05-09,2021-05-15,7,2021,"19",6732219,1301,66,1250,51,1235,0.980360264572498,0.757551113533294,0.0407999999999999
"United States","Indiana","IN",2021-05-16,2021-05-22,7,2021,"20",6732219,1367,82,1237,130,1285,1.21802335901432,1.93101264233977,0.105092966855295
"United States","Indiana","IN",2021-05-23,2021-05-29,7,2021,"21",6732219,1334,62,1223,111,1272,0.920944490962044,1.64878771769011,0.0907604251839738
"United States","Indiana","IN",2021-05-30,2021-06-05,7,2021,"22",6732219,1404,70,1216,188,1334,1.03977603818295,2.79254135969136,0.154605263157895
"United States","Indiana","IN",2021-06-06,2021-06-12,7,2021,"23",6732219,1306,60,1209,97,1246,0.891236604156817,1.44083251005352,0.0802315963606286
"United States","Indiana","IN",2021-06-13,2021-06-19,7,2021,"24",6732219,1418,50,1212,206,1368,0.742697170130681,3.0599123409384,0.16996699669967
"United States","Indiana","IN",2021-06-20,2021-06-26,7,2021,"25",6732219,1274,27,1215,59,1247,0.401056471870568,0.876382660754203,0.0485596707818929
"United States","Indiana","IN",2021-06-27,2021-07-03,7,2021,"26",6732219,1292,41,1214,78,1251,0.609011679507158,1.15860758540386,0.0642504118616145
"United States","Indiana","IN",2021-07-04,2021-07-10,7,2021,"27",6732219,1318,51,1205,113,1267,0.757551113533294,1.67849560449534,0.0937759336099586
"United States","Indiana","IN",2021-07-11,2021-07-17,7,2021,"28",6732219,1281,26,1214,67,1255,0.386202528467954,0.995214207975112,0.0551894563426689
"United States","Indiana","IN",2021-07-18,2021-07-24,7,2021,"29",6732219,1217,25,1208,9,1192,0.37134858506534,0.133685490623523,0.00745033112582782
"United States","Indiana","IN",2021-07-25,2021-07-31,7,2021,"30",6732219,1288,40,1211,77,1248,0.594157736104544,1.14375364200125,0.0635838150289016
"United States","Indiana","IN",2021-08-01,2021-08-07,7,2021,"31",6732219,1286,49,1205,81,1237,0.727843226728067,1.2031694156117,0.0672199170124481
"United States","Indiana","IN",2021-08-08,2021-08-14,7,2021,"32",6732219,1354,74,1202,152,1280,1.09919181179341,2.25779939719727,0.126455906821964
"United States","Indiana","IN",2021-08-15,2021-08-21,7,2021,"33",6732219,1355,16,1219,136,1339,0.237663094441818,2.02013630275545,0.111566858080394
"United States","Iowa","IA",2019-12-29,2020-01-04,7,2020,"1",3155070,665,0,696,-31,665,0,-0.982545553664419,-0.0445402298850575
"United States","Iowa","IA",2020-01-05,2020-01-11,7,2020,"2",3155070,647,0,704,-57,647,0,-1.80661601802813,-0.0809659090909091
"United States","Iowa","IA",2020-01-12,2020-01-18,7,2020,"3",3155070,620,0,694,-74,620,0,-2.34543132165055,-0.106628242074928
"United States","Iowa","IA",2020-01-19,2020-01-25,7,2020,"4",3155070,640,0,684,-44,640,0,-1.39458078584627,-0.064327485380117
"United States","Iowa","IA",2020-01-26,2020-02-01,7,2020,"5",3155070,615,0,676,-61,615,0,-1.9333960894687,-0.0902366863905325
"United States","Iowa","IA",2020-02-02,2020-02-08,7,2020,"6",3155070,637,0,669,-32,637,0,-1.01424057152456,-0.0478325859491778
"United States","Iowa","IA",2020-02-09,2020-02-15,7,2020,"7",3155070,600,0,651,-51,600,0,-1.61644591086727,-0.0783410138248848
"United States","Iowa","IA",2020-02-16,2020-02-22,7,2020,"8",3155070,643,0,644,-1,643,0,-0.0316950178601426,-0.00155279503105588
"United States","Iowa","IA",2020-02-23,2020-02-29,7,2020,"9",3155070,642,0,637,5,642,0,0.158475089300713,0.00784929356357922
"United States","Iowa","IA",2020-03-01,2020-03-07,7,2020,"10",3155070,624,0,633,-9,624,0,-0.285255160741283,-0.014218009478673
"United States","Iowa","IA",2020-03-08,2020-03-14,7,2020,"11",3155070,636,0,623,13,636,0,0.412035232181853,0.0208667736757624
"United States","Iowa","IA",2020-03-15,2020-03-21,7,2020,"12",3155070,598,0,615,-17,598,0,-0.538815303622424,-0.0276422764227642
"United States","Iowa","IA",2020-03-22,2020-03-28,7,2020,"13",3155070,595,3,607,-12,592,0.0950850535804277,-0.380340214321711,-0.0197693574958814
"United States","Iowa","IA",2020-03-29,2020-04-04,7,2020,"14",3155070,608,8,601,7,600,0.25356014288114,0.221865125020998,0.0116472545757071
"United States","Iowa","IA",2020-04-05,2020-04-11,7,2020,"15",3155070,597,23,599,-2,574,0.728985410783279,-0.0633900357202851,-0.003338898163606
"United States","Iowa","IA",2020-04-12,2020-04-18,7,2020,"16",3155070,633,40,596,37,593,1.2678007144057,1.17271566082527,0.0620805369127517
"United States","Iowa","IA",2020-04-19,2020-04-25,7,2020,"17",3155070,587,38,596,-9,549,1.20441067868542,-0.285255160741283,-0.0151006711409396
"United States","Iowa","IA",2020-04-26,2020-05-02,7,2020,"18",3155070,673,63,588,85,610,1.99678612518898,2.69407651811212,0.144557823129252
"United States","Iowa","IA",2020-05-03,2020-05-09,7,2020,"19",3155070,702,76,582,120,626,2.40882135737083,3.80340214321711,0.206185567010309
"United States","Iowa","IA",2020-05-10,2020-05-16,7,2020,"20",3155070,674,95,563,111,579,3.01102669671354,3.51814698247582,0.197158081705151
"United States","Iowa","IA",2020-05-17,2020-05-23,7,2020,"21",3155070,619,98,548,71,521,3.10611175029397,2.25034626807012,0.12956204379562
"United States","Iowa","IA",2020-05-24,2020-05-30,7,2020,"22",3155070,632,83,545,87,549,2.63068648239183,2.7574665538324,0.159633027522936
"United States","Iowa","IA",2020-05-31,2020-06-06,7,2020,"23",3155070,600,71,543,57,529,2.25034626807012,1.80661601802813,0.104972375690608
"United States","Iowa","IA",2020-06-07,2020-06-13,7,2020,"24",3155070,589,51,541,48,538,1.61644591086727,1.52136085728684,0.088724584103512
"United States","Iowa","IA",2020-06-14,2020-06-20,7,2020,"25",3155070,575,32,549,26,543,1.01424057152456,0.824070464363707,0.0473588342440801
"United States","Iowa","IA",2020-06-21,2020-06-27,7,2020,"26",3155070,552,23,537,15,529,0.728985410783279,0.475425267902138,0.0279329608938548
"United States","Iowa","IA",2020-06-28,2020-07-04,7,2020,"27",3155070,596,17,527,69,579,0.538815303622424,2.18695623234984,0.130929791271347
"United States","Iowa","IA",2020-07-05,2020-07-11,7,2020,"28",3155070,567,27,521,46,540,0.855765482223849,1.45797082156656,0.0882917466410749
"United States","Iowa","IA",2020-07-12,2020-07-18,7,2020,"29",3155070,601,39,522,79,562,1.23610569654556,2.50390641095126,0.151340996168582
"United States","Iowa","IA",2020-07-19,2020-07-25,7,2020,"30",3155070,651,39,519,132,612,1.23610569654556,4.18374235753882,0.254335260115607
"United States","Iowa","IA",2020-07-26,2020-08-01,7,2020,"31",3155070,650,46,523,127,604,1.45797082156656,4.02526726823811,0.24282982791587
"United States","Iowa","IA",2020-08-02,2020-08-08,7,2020,"32",3155070,649,53,520,129,596,1.67983594658756,4.08865730395839,0.248076923076923
"United States","Iowa","IA",2020-08-09,2020-08-15,7,2020,"33",3155070,669,48,528,141,621,1.52136085728684,4.4689975182801,0.267045454545455
"United States","Iowa","IA",2020-08-16,2020-08-22,7,2020,"34",3155070,625,57,529,96,568,1.80661601802813,3.04272171457369,0.181474480151229
"United States","Iowa","IA",2020-08-23,2020-08-29,7,2020,"35",3155070,691,78,534,157,613,2.47221139309112,4.97611780404238,0.294007490636704
"United States","Iowa","IA",2020-08-30,2020-09-05,7,2020,"36",3155070,597,52,544,53,545,1.64814092872741,1.67983594658756,0.0974264705882353
"United States","Iowa","IA",2020-09-06,2020-09-12,7,2020,"37",3155070,637,48,545,92,589,1.52136085728684,2.91594164313312,0.168807339449541
"United States","Iowa","IA",2020-09-13,2020-09-19,7,2020,"38",3155070,642,56,542,100,586,1.77492100016798,3.16950178601426,0.18450184501845
"United States","Iowa","IA",2020-09-20,2020-09-26,7,2020,"39",3155070,641,47,544,97,594,1.4896658394267,3.07441673243383,0.178308823529412
"United States","Iowa","IA",2020-09-27,2020-10-03,7,2020,"40",3155070,680,66,555,125,614,2.09187117876941,3.96187723251782,0.225225225225225
"United States","Iowa","IA",2020-10-04,2020-10-10,7,2020,"41",3155070,733,77,575,158,656,2.44051637523098,5.00781282190253,0.274782608695652
"United States","Iowa","IA",2020-10-11,2020-10-17,7,2020,"42",3155070,688,72,569,119,616,2.28204128593026,3.77170712535697,0.209138840070299
"United States","Iowa","IA",2020-10-18,2020-10-24,7,2020,"43",3155070,750,103,558,192,647,3.26458683959468,6.08544342914737,0.344086021505376
"United States","Iowa","IA",2020-10-25,2020-10-31,7,2020,"44",3155070,759,86,566,193,673,2.72577153597226,6.11713844700752,0.340989399293286
"United States","Iowa","IA",2020-11-01,2020-11-07,7,2020,"45",3155070,860,100,568,292,760,3.16950178601426,9.25494521516163,0.514084507042254
"United States","Iowa","IA",2020-11-08,2020-11-14,7,2020,"46",3155070,905,154,575,330,751,4.88103275046196,10.459355893847,0.573913043478261
"United States","Iowa","IA",2020-11-15,2020-11-21,7,2020,"47",3155070,998,186,581,417,812,5.89527332198652,13.2168224476794,0.717728055077453
"United States","Iowa","IA",2020-11-22,2020-11-28,7,2020,"48",3155070,976,192,576,400,784,6.08544342914737,12.678007144057,0.694444444444444
"United States","Iowa","IA",2020-11-29,2020-12-05,7,2020,"49",3155070,1002,279,578,424,723,8.84290998297977,13.4386875727004,0.73356401384083
"United States","Iowa","IA",2020-12-06,2020-12-12,7,2020,"50",3155070,950,582,585,365,368,18.446500394603,11.568681518952,0.623931623931624
"United States","Iowa","IA",2020-12-13,2020-12-19,7,2020,"51",3155070,864,242,593,271,622,7.6701943221545,8.58934984009863,0.456998313659359
"United States","Iowa","IA",2020-12-20,2020-12-26,7,2020,"52",3155070,834,293,602,232,541,9.28664023302177,7.35324414355307,0.385382059800665
"United States","Iowa","IA",2020-12-27,2021-01-02,7,2020,"53",3155070,743,201,615,128,542,6.37069858988866,4.05696228609825,0.208130081300813
"United States","Iowa","IA",2021-01-03,2021-01-09,7,2021,"1",3155070,799,183,621,178,616,5.80018826840609,5.64171317910538,0.286634460547504
"United States","Iowa","IA",2021-01-10,2021-01-16,7,2021,"2",3155070,754,194,625,129,560,6.14883346486766,4.08865730395839,0.2064
"United States","Iowa","IA",2021-01-17,2021-01-23,7,2021,"3",3155070,747,165,624,123,582,5.22967794692352,3.89848719679754,0.197115384615385
"United States","Iowa","IA",2021-01-24,2021-01-30,7,2021,"4",3155070,645,165,621,24,480,5.22967794692352,0.760680428643422,0.038647342995169
"United States","Iowa","IA",2021-01-31,2021-02-06,7,2021,"5",3155070,648,457,623,25,191,14.4846231620852,0.792375446503564,0.0401284109149278
"United States","Iowa","IA",2021-02-07,2021-02-13,7,2021,"6",3155070,608,128,621,-13,480,4.05696228609825,-0.412035232181853,-0.0209339774557166
"United States","Iowa","IA",2021-02-14,2021-02-20,7,2021,"7",3155070,658,100,619,39,558,3.16950178601426,1.23610569654556,0.0630048465266559
"United States","Iowa","IA",2021-02-21,2021-02-27,7,2021,"8",3155070,584,135,628,-44,449,4.27882741111925,-1.39458078584627,-0.0700636942675159
"United States","Iowa","IA",2021-02-28,2021-03-06,7,2021,"9",3155070,616,79,625,-9,537,2.50390641095126,-0.285255160741283,-0.0144
"United States","Iowa","IA",2021-03-07,2021-03-13,7,2021,"10",3155070,557,84,613,-56,473,2.66238150025198,-1.77492100016798,-0.0913539967373572
"United States","Iowa","IA",2021-03-14,2021-03-20,7,2021,"11",3155070,507,40,601,-94,467,1.2678007144057,-2.9793316788534,-0.156405990016639
"United States","Iowa","IA",2021-03-21,2021-03-27,7,2021,"12",3155070,568,43,601,-33,525,1.36288576798613,-1.0459355893847,-0.0549084858569051
"United States","Iowa","IA",2021-03-28,2021-04-03,7,2021,"13",3155070,578,38,599,-21,540,1.20441067868542,-0.665595375062994,-0.0350584307178631
"United States","Iowa","IA",2021-04-04,2021-04-10,7,2021,"14",3155070,631,94,592,39,537,2.9793316788534,1.23610569654556,0.0658783783783783
"United States","Iowa","IA",2021-04-11,2021-04-17,7,2021,"15",3155070,575,32,593,-18,543,1.01424057152456,-0.570510321482566,-0.03035413153457
"United States","Iowa","IA",2021-04-18,2021-04-24,7,2021,"16",3155070,618,26,595,23,592,0.824070464363707,0.728985410783279,0.038655462184874
"United States","Iowa","IA",2021-04-25,2021-05-01,7,2021,"17",3155070,637,43,583,54,594,1.36288576798613,1.7115309644477,0.0926243567753002
"United States","Iowa","IA",2021-05-02,2021-05-08,7,2021,"18",3155070,571,33,582,-11,538,1.0459355893847,-0.348645196461568,-0.0189003436426117
"United States","Iowa","IA",2021-05-09,2021-05-15,7,2021,"19",3155070,560,15,584,-24,545,0.475425267902138,-0.760680428643422,-0.041095890410959
"United States","Iowa","IA",2021-05-16,2021-05-22,7,2021,"20",3155070,537,36,576,-39,501,1.14102064296513,-1.23610569654556,-0.0677083333333334
"United States","Iowa","IA",2021-05-23,2021-05-29,7,2021,"21",3155070,586,19,571,15,567,0.602205339342709,0.475425267902138,0.0262697022767076
"United States","Iowa","IA",2021-05-30,2021-06-05,7,2021,"22",3155070,557,14,571,-14,543,0.443730250041996,-0.443730250041996,-0.0245183887915937
"United States","Iowa","IA",2021-06-06,2021-06-12,7,2021,"23",3155070,577,30,569,8,547,0.950850535804277,0.25356014288114,0.0140597539543057
"United States","Iowa","IA",2021-06-13,2021-06-19,7,2021,"24",3155070,600,12,572,28,588,0.380340214321711,0.887460500083992,0.048951048951049
"United States","Iowa","IA",2021-06-20,2021-06-26,7,2021,"25",3155070,586,16,581,5,570,0.507120285762281,0.158475089300713,0.00860585197934594
"United States","Iowa","IA",2021-06-27,2021-07-03,7,2021,"26",3155070,542,17,565,-23,525,0.538815303622424,-0.728985410783279,-0.04070796460177
"United States","Iowa","IA",2021-07-04,2021-07-10,7,2021,"27",3155070,575,7,556,19,568,0.221865125020998,0.602205339342709,0.0341726618705036
"United States","Iowa","IA",2021-07-11,2021-07-17,7,2021,"28",3155070,563,9,557,6,554,0.285255160741283,0.190170107160855,0.0107719928186714
"United States","Iowa","IA",2021-07-18,2021-07-24,7,2021,"29",3155070,596,0,549,47,596,0,1.4896658394267,0.0856102003642987
"United States","Iowa","IA",2021-07-25,2021-07-31,7,2021,"30",3155070,524,12,551,-27,512,0.380340214321711,-0.855765482223849,-0.0490018148820327
"United States","Iowa","IA",2021-08-01,2021-08-07,7,2021,"31",3155070,589,23,555,34,566,0.728985410783279,1.07763060724485,0.0612612612612613
"United States","Iowa","IA",2021-08-08,2021-08-14,7,2021,"32",3155070,534,17,548,-14,517,0.538815303622424,-0.443730250041996,-0.0255474452554745
"United States","Iowa","IA",2021-08-15,2021-08-21,7,2021,"33",3155070,610,0,551,59,610,0,1.87000605374841,0.107078039927405
"United States","Kansas","KS",2019-12-29,2020-01-04,7,2020,"1",2913314,591,0,616,-25,591,0,-0.85812926447338,-0.0405844155844156
"United States","Kansas","KS",2020-01-05,2020-01-11,7,2020,"2",2913314,560,0,562,-2,560,0,-0.0686503411578704,-0.00355871886120995
"United States","Kansas","KS",2020-01-12,2020-01-18,7,2020,"3",2913314,576,0,611,-35,576,0,-1.20138097026273,-0.0572831423895254
"United States","Kansas","KS",2020-01-19,2020-01-25,7,2020,"4",2913314,571,0,600,-29,571,0,-0.995429946789121,-0.0483333333333333
"United States","Kansas","KS",2020-01-26,2020-02-01,7,2020,"5",2913314,549,0,593,-44,549,0,-1.51030750547315,-0.0741989881956155
"United States","Kansas","KS",2020-02-02,2020-02-08,7,2020,"6",2913314,503,0,591,-88,503,0,-3.0206150109463,-0.148900169204738
"United States","Kansas","KS",2020-02-09,2020-02-15,7,2020,"7",2913314,575,0,582,-7,575,0,-0.240276194052546,-0.0120274914089347
"United States","Kansas","KS",2020-02-16,2020-02-22,7,2020,"8",2913314,559,0,581,-22,559,0,-0.755153752736574,-0.0378657487091222
"United States","Kansas","KS",2020-02-23,2020-02-29,7,2020,"9",2913314,548,0,579,-31,548,0,-1.06408028794699,-0.0535405872193437
"United States","Kansas","KS",2020-03-01,2020-03-07,7,2020,"10",2913314,575,0,569,6,575,0,0.205951023473611,0.0105448154657293
"United States","Kansas","KS",2020-03-08,2020-03-14,7,2020,"11",2913314,522,1,563,-41,521,0.0343251705789352,-1.40733199373634,-0.0728241563055062
"United States","Kansas","KS",2020-03-15,2020-03-21,7,2020,"12",2913314,515,1,552,-37,514,0.0343251705789352,-1.2700313114206,-0.0670289855072463
"United States","Kansas","KS",2020-03-22,2020-03-28,7,2020,"13",2913314,523,3,543,-20,520,0.102975511736806,-0.686503411578704,-0.0368324125230203
"United States","Kansas","KS",2020-03-29,2020-04-04,7,2020,"14",2913314,550,16,528,22,534,0.549202729262963,0.755153752736574,0.0416666666666667
"United States","Kansas","KS",2020-04-05,2020-04-11,7,2020,"15",2913314,525,34,517,8,491,1.1670557996838,0.274601364631482,0.0154738878143132
"United States","Kansas","KS",2020-04-12,2020-04-18,7,2020,"16",2913314,546,32,504,42,514,1.09840545852593,1.44165716431528,0.0833333333333333
"United States","Kansas","KS",2020-04-19,2020-04-25,7,2020,"17",2913314,541,33,499,42,508,1.13273062910486,1.44165716431528,0.0841683366733468
"United States","Kansas","KS",2020-04-26,2020-05-02,7,2020,"18",2913314,526,22,498,28,504,0.755153752736574,0.961104776210185,0.0562248995983936
"United States","Kansas","KS",2020-05-03,2020-05-09,7,2020,"19",2913314,507,31,492,15,476,1.06408028794699,0.514877558684028,0.0304878048780488
"United States","Kansas","KS",2020-05-10,2020-05-16,7,2020,"20",2913314,530,21,483,47,509,0.720828582157639,1.61328301720995,0.0973084886128364
"United States","Kansas","KS",2020-05-17,2020-05-23,7,2020,"21",2913314,520,10,482,38,510,0.343251705789352,1.30435648199954,0.0788381742738589
"United States","Kansas","KS",2020-05-24,2020-05-30,7,2020,"22",2913314,506,9,480,26,497,0.308926535210417,0.892454435052315,0.0541666666666667
"United States","Kansas","KS",2020-05-31,2020-06-06,7,2020,"23",2913314,499,19,480,19,480,0.652178240999769,0.652178240999769,0.0395833333333333
"United States","Kansas","KS",2020-06-07,2020-06-13,7,2020,"24",2913314,516,11,483,33,505,0.377576876368287,1.13273062910486,0.0683229813664596
"United States","Kansas","KS",2020-06-14,2020-06-20,7,2020,"25",2913314,508,19,482,26,489,0.652178240999769,0.892454435052315,0.053941908713693
"United States","Kansas","KS",2020-06-21,2020-06-27,7,2020,"26",2913314,521,6,482,39,515,0.205951023473611,1.33868165257847,0.0809128630705394
"United States","Kansas","KS",2020-06-28,2020-07-04,7,2020,"27",2913314,562,7,479,83,555,0.240276194052546,2.84898915805162,0.173277661795407
"United States","Kansas","KS",2020-07-05,2020-07-11,7,2020,"28",2913314,504,13,483,21,491,0.446227217526157,0.720828582157639,0.0434782608695652
"United States","Kansas","KS",2020-07-12,2020-07-18,7,2020,"29",2913314,518,17,483,35,501,0.583527899841898,1.20138097026273,0.0724637681159421
"United States","Kansas","KS",2020-07-19,2020-07-25,7,2020,"30",2913314,540,19,478,62,521,0.652178240999769,2.12816057589398,0.129707112970711
"United States","Kansas","KS",2020-07-26,2020-08-01,7,2020,"31",2913314,543,34,477,66,509,1.1670557996838,2.26546125820972,0.138364779874214
"United States","Kansas","KS",2020-08-02,2020-08-08,7,2020,"32",2913314,601,22,477,124,579,0.755153752736574,4.25632115178796,0.259958071278826
"United States","Kansas","KS",2020-08-09,2020-08-15,7,2020,"33",2913314,577,27,471,106,550,0.92677960563125,3.63846808136713,0.225053078556263
"United States","Kansas","KS",2020-08-16,2020-08-22,7,2020,"34",2913314,514,23,472,42,491,0.78947892331551,1.44165716431528,0.0889830508474576
"United States","Kansas","KS",2020-08-23,2020-08-29,7,2020,"35",2913314,532,18,478,54,514,0.617853070420833,1.8535592112625,0.112970711297071
"United States","Kansas","KS",2020-08-30,2020-09-05,7,2020,"36",2913314,566,33,480,86,533,1.13273062910486,2.95196466978843,0.179166666666667
"United States","Kansas","KS",2020-09-06,2020-09-12,7,2020,"37",2913314,581,41,480,101,540,1.40733199373634,3.46684222847245,0.210416666666667
"United States","Kansas","KS",2020-09-13,2020-09-19,7,2020,"38",2913314,553,76,490,63,477,2.60871296399907,2.16248574647292,0.128571428571429
"United States","Kansas","KS",2020-09-20,2020-09-26,7,2020,"39",2913314,601,34,488,113,567,1.1670557996838,3.87874427541968,0.23155737704918
"United States","Kansas","KS",2020-09-27,2020-10-03,7,2020,"40",2913314,580,66,482,98,514,2.26546125820972,3.36386671673565,0.203319502074689
"United States","Kansas","KS",2020-10-04,2020-10-10,7,2020,"41",2913314,638,65,481,157,573,2.23113608763079,5.38905178089283,0.326403326403326
"United States","Kansas","KS",2020-10-11,2020-10-17,7,2020,"42",2913314,636,96,483,153,540,3.29521637557778,5.25175109857708,0.316770186335404
"United States","Kansas","KS",2020-10-18,2020-10-24,7,2020,"43",2913314,658,116,481,177,542,3.98171978715648,6.07555519247153,0.367983367983368
"United States","Kansas","KS",2020-10-25,2020-10-31,7,2020,"44",2913314,577,54,488,89,523,1.8535592112625,3.05494018152523,0.182377049180328
"United States","Kansas","KS",2020-11-01,2020-11-07,7,2020,"45",2913314,679,137,501,178,542,4.70254836931412,6.10988036305046,0.355289421157685
"United States","Kansas","KS",2020-11-08,2020-11-14,7,2020,"46",2913314,719,88,500,219,631,3.0206150109463,7.51721235678681,0.438
"United States","Kansas","KS",2020-11-15,2020-11-21,7,2020,"47",2913314,782,156,509,273,626,5.35472661031389,9.37077156804931,0.536345776031434
"United States","Kansas","KS",2020-11-22,2020-11-28,7,2020,"48",2913314,814,119,517,297,695,4.08469529889329,10.1945756619438,0.574468085106383
"United States","Kansas","KS",2020-11-29,2020-12-05,7,2020,"49",2913314,870,257,522,348,613,8.82156883878634,11.9451593614694,0.666666666666667
"United States","Kansas","KS",2020-12-06,2020-12-12,7,2020,"50",2913314,880,286,528,352,594,9.81699878557547,12.0824600437852,0.666666666666667
"United States","Kansas","KS",2020-12-13,2020-12-19,7,2020,"51",2913314,931,269,540,391,662,9.23347088573357,13.4211416963637,0.724074074074074
"United States","Kansas","KS",2020-12-20,2020-12-26,7,2020,"52",2913314,855,0,556,299,855,0,10.2632260031016,0.537769784172662
"United States","Kansas","KS",2020-12-27,2021-01-02,7,2020,"53",2913314,811,537,557,254,274,18.4326166008882,8.71859332704954,0.456014362657092
"United States","Kansas","KS",2021-01-03,2021-01-09,7,2021,"1",2913314,789,270,564,225,519,9.2677960563125,7.72316338026042,0.398936170212766
"United States","Kansas","KS",2021-01-10,2021-01-16,7,2021,"2",2913314,787,354,575,212,433,12.1511103849431,7.27693616273426,0.368695652173913
"United States","Kansas","KS",2021-01-17,2021-01-23,7,2021,"3",2913314,675,96,570,105,579,3.29521637557778,3.6041429107882,0.184210526315789
"United States","Kansas","KS",2021-01-24,2021-01-30,7,2021,"4",2913314,691,181,564,127,510,6.21285587478727,4.35929666352477,0.225177304964539
"United States","Kansas","KS",2021-01-31,2021-02-06,7,2021,"5",2913314,681,322,571,110,359,11.0527049264171,3.77576876368287,0.192644483362522
"United States","Kansas","KS",2021-02-07,2021-02-13,7,2021,"6",2913314,583,263,570,13,320,9.02751986225996,0.446227217526157,0.0228070175438597
"United States","Kansas","KS",2021-02-14,2021-02-20,7,2021,"7",2913314,588,266,564,24,322,9.13049537399676,0.823804093894445,0.0425531914893618
"United States","Kansas","KS",2021-02-21,2021-02-27,7,2021,"8",2913314,594,122,566,28,472,4.18767081063009,0.961104776210185,0.0494699646643109
"United States","Kansas","KS",2021-02-28,2021-03-06,7,2021,"9",2913314,552,94,569,-17,458,3.22656603441991,-0.583527899841898,-0.0298769771528998
"United States","Kansas","KS",2021-03-07,2021-03-13,7,2021,"10",2913314,528,52,566,-38,476,1.78490887010463,-1.30435648199954,-0.0671378091872792
"United States","Kansas","KS",2021-03-14,2021-03-20,7,2021,"11",2913314,510,15,557,-47,495,0.514877558684028,-1.61328301720995,-0.0843806104129264
"United States","Kansas","KS",2021-03-21,2021-03-27,7,2021,"12",2913314,526,-21,544,-18,547,-0.720828582157639,-0.617853070420833,-0.0330882352941176
"United States","Kansas","KS",2021-03-28,2021-04-03,7,2021,"13",2913314,527,41,535,-8,486,1.40733199373634,-0.274601364631482,-0.0149532710280373
"United States","Kansas","KS",2021-04-04,2021-04-10,7,2021,"14",2913314,512,5,525,-13,507,0.171625852894676,-0.446227217526157,-0.0247619047619048
"United States","Kansas","KS",2021-04-11,2021-04-17,7,2021,"15",2913314,500,18,519,-19,482,0.617853070420833,-0.652178240999769,-0.0366088631984586
"United States","Kansas","KS",2021-04-18,2021-04-24,7,2021,"16",2913314,533,12,511,22,521,0.411902046947222,0.755153752736574,0.0430528375733856
"United States","Kansas","KS",2021-04-25,2021-05-01,7,2021,"17",2913314,518,14,507,11,504,0.480552388105093,0.377576876368287,0.0216962524654833
"United States","Kansas","KS",2021-05-02,2021-05-08,7,2021,"18",2913314,518,34,499,19,484,1.1670557996838,0.652178240999769,0.0380761523046091
"United States","Kansas","KS",2021-05-09,2021-05-15,7,2021,"19",2913314,514,22,494,20,492,0.755153752736574,0.686503411578704,0.0404858299595141
"United States","Kansas","KS",2021-05-16,2021-05-22,7,2021,"20",2913314,560,19,498,62,541,0.652178240999769,2.12816057589398,0.124497991967871
"United States","Kansas","KS",2021-05-23,2021-05-29,7,2021,"21",2913314,487,19,495,-8,468,0.652178240999769,-0.274601364631482,-0.0161616161616162
"United States","Kansas","KS",2021-05-30,2021-06-05,7,2021,"22",2913314,522,8,496,26,514,0.274601364631482,0.892454435052315,0.0524193548387097
"United States","Kansas","KS",2021-06-06,2021-06-12,7,2021,"23",2913314,544,22,497,47,522,0.755153752736574,1.61328301720995,0.0945674044265594
"United States","Kansas","KS",2021-06-13,2021-06-19,7,2021,"24",2913314,509,23,498,11,486,0.78947892331551,0.377576876368287,0.0220883534136547
"United States","Kansas","KS",2021-06-20,2021-06-26,7,2021,"25",2913314,514,18,497,17,496,0.617853070420833,0.583527899841898,0.0342052313883299
"United States","Kansas","KS",2021-06-27,2021-07-03,7,2021,"26",2913314,537,12,493,44,525,0.411902046947222,1.51030750547315,0.0892494929006085
"United States","Kansas","KS",2021-07-04,2021-07-10,7,2021,"27",2913314,544,17,497,47,527,0.583527899841898,1.61328301720995,0.0945674044265594
"United States","Kansas","KS",2021-07-11,2021-07-17,7,2021,"28",2913314,547,21,489,58,526,0.720828582157639,1.99085989357824,0.118609406952965
"United States","Kansas","KS",2021-07-18,2021-07-24,7,2021,"29",2913314,539,42,485,54,497,1.44165716431528,1.8535592112625,0.111340206185567
"United States","Kansas","KS",2021-07-25,2021-07-31,7,2021,"30",2913314,533,16,481,52,517,0.549202729262963,1.78490887010463,0.108108108108108
"United States","Kansas","KS",2021-08-01,2021-08-07,7,2021,"31",2913314,607,44,485,122,563,1.51030750547315,4.18767081063009,0.251546391752577
"United States","Kansas","KS",2021-08-08,2021-08-14,7,2021,"32",2913314,575,86,475,100,489,2.95196466978843,3.43251705789352,0.210526315789474
"United States","Kansas","KS",2021-08-15,2021-08-21,7,2021,"33",2913314,627,9,480,147,618,0.308926535210417,5.04580007510347,0.30625
"United States","Kentucky","KY",2019-12-29,2020-01-04,7,2020,"1",4467673,1093,0,1056,37,1093,0,0.828171623124611,0.0350378787878789
"United States","Kentucky","KY",2020-01-05,2020-01-11,7,2020,"2",4467673,1058,0,1062,-4,1058,0,-0.0895320673648228,-0.00376647834274957
"United States","Kentucky","KY",2020-01-12,2020-01-18,7,2020,"3",4467673,1041,0,1045,-4,1041,0,-0.0895320673648228,-0.00382775119617229
"United States","Kentucky","KY",2020-01-19,2020-01-25,7,2020,"4",4467673,944,0,1031,-87,944,0,-1.9473224651849,-0.0843840931134821
"United States","Kentucky","KY",2020-01-26,2020-02-01,7,2020,"5",4467673,978,0,1016,-38,978,0,-0.850554639965817,-0.0374015748031497
"United States","Kentucky","KY",2020-02-02,2020-02-08,7,2020,"6",4467673,956,0,997,-41,956,0,-0.917703690489434,-0.041123370110331
"United States","Kentucky","KY",2020-02-09,2020-02-15,7,2020,"7",4467673,955,0,998,-43,955,0,-0.962469724171845,-0.0430861723446894
"United States","Kentucky","KY",2020-02-16,2020-02-22,7,2020,"8",4467673,992,0,994,-2,992,0,-0.0447660336824114,-0.00201207243460766
"United States","Kentucky","KY",2020-02-23,2020-02-29,7,2020,"9",4467673,1022,0,975,47,1022,0,1.05200179153667,0.0482051282051281
"United States","Kentucky","KY",2020-03-01,2020-03-07,7,2020,"10",4467673,1006,0,971,35,1006,0,0.7834055894422,0.0360453141091659
"United States","Kentucky","KY",2020-03-08,2020-03-14,7,2020,"11",4467673,1021,0,966,55,1021,0,1.23106592626631,0.0569358178053829
"United States","Kentucky","KY",2020-03-15,2020-03-21,7,2020,"12",4467673,949,3,959,-10,946,0.0671490505236171,-0.223830168412057,-0.0104275286757038
"United States","Kentucky","KY",2020-03-22,2020-03-28,7,2020,"13",4467673,937,7,951,-14,930,0.15668111788844,-0.31336223577688,-0.0147213459516299
"United States","Kentucky","KY",2020-03-29,2020-04-04,7,2020,"14",4467673,1048,30,946,102,1018,0.671490505236171,2.28306771780298,0.107822410147992
"United States","Kentucky","KY",2020-04-05,2020-04-11,7,2020,"15",4467673,1026,54,941,85,972,1.20868290942511,1.90255643150248,0.0903294367693943
"United States","Kentucky","KY",2020-04-12,2020-04-18,7,2020,"16",4467673,960,50,933,27,910,1.11915084206029,0.604341454712554,0.0289389067524115
"United States","Kentucky","KY",2020-04-19,2020-04-25,7,2020,"17",4467673,975,61,926,49,914,1.36536402731355,1.09676782521908,0.0529157667386608
"United States","Kentucky","KY",2020-04-26,2020-05-02,7,2020,"18",4467673,998,43,912,86,955,0.962469724171845,1.92493944834369,0.0942982456140351
"United States","Kentucky","KY",2020-05-03,2020-05-09,7,2020,"19",4467673,1006,56,895,111,950,1.25344894310752,2.48451486937383,0.124022346368715
"United States","Kentucky","KY",2020-05-10,2020-05-16,7,2020,"20",4467673,995,30,881,114,965,0.671490505236171,2.55166391989745,0.129398410896708
"United States","Kentucky","KY",2020-05-17,2020-05-23,7,2020,"21",4467673,998,57,868,130,941,1.27583195994872,2.90979218935674,0.149769585253456
"United States","Kentucky","KY",2020-05-24,2020-05-30,7,2020,"22",4467673,987,40,874,113,947,0.895320673648228,2.52928090305624,0.12929061784897
"United States","Kentucky","KY",2020-05-31,2020-06-06,7,2020,"23",4467673,918,38,868,50,880,0.850554639965817,1.11915084206029,0.0576036866359446
"United States","Kentucky","KY",2020-06-07,2020-06-13,7,2020,"24",4467673,1002,29,865,137,973,0.649107488394965,3.06647330724518,0.158381502890173
"United States","Kentucky","KY",2020-06-14,2020-06-20,7,2020,"25",4467673,966,26,870,96,940,0.581958437871348,2.14876961675575,0.110344827586207
"United States","Kentucky","KY",2020-06-21,2020-06-27,7,2020,"26",4467673,937,30,864,73,907,0.671490505236171,1.63396022940802,0.0844907407407407
"United States","Kentucky","KY",2020-06-28,2020-07-04,7,2020,"27",4467673,993,31,867,126,962,0.693873522077377,2.82026012199192,0.145328719723183
"United States","Kentucky","KY",2020-07-05,2020-07-11,7,2020,"28",4467673,1047,37,859,188,1010,0.828171623124611,4.20800716614667,0.218859138533178
"United States","Kentucky","KY",2020-07-12,2020-07-18,7,2020,"29",4467673,936,45,867,69,891,1.00723575785426,1.54442816204319,0.0795847750865053
"United States","Kentucky","KY",2020-07-19,2020-07-25,7,2020,"30",4467673,968,29,865,103,939,0.649107488394965,2.30545073464419,0.119075144508671
"United States","Kentucky","KY",2020-07-26,2020-08-01,7,2020,"31",4467673,1031,44,869,162,987,0.984852741013051,3.62604872827532,0.186421173762946
"United States","Kentucky","KY",2020-08-02,2020-08-08,7,2020,"32",4467673,1007,32,869,138,975,0.716256538918582,3.08885632408639,0.158803222094361
"United States","Kentucky","KY",2020-08-09,2020-08-15,7,2020,"33",4467673,1015,38,869,146,977,0.850554639965817,3.26792045881603,0.16800920598389
"United States","Kentucky","KY",2020-08-16,2020-08-22,7,2020,"34",4467673,1078,62,871,207,1016,1.38774704415475,4.63328448612958,0.237657864523536
"United States","Kentucky","KY",2020-08-23,2020-08-29,7,2020,"35",4467673,1007,49,870,137,958,1.09676782521908,3.06647330724518,0.157471264367816
"United States","Kentucky","KY",2020-08-30,2020-09-05,7,2020,"36",4467673,1055,72,878,177,983,1.61157721256681,3.96179398089341,0.201594533029613
"United States","Kentucky","KY",2020-09-06,2020-09-12,7,2020,"37",4467673,1020,64,875,145,956,1.43251307783716,3.24553744197483,0.165714285714286
"United States","Kentucky","KY",2020-09-13,2020-09-19,7,2020,"38",4467673,1017,51,880,137,966,1.14153385890149,3.06647330724518,0.155681818181818
"United States","Kentucky","KY",2020-09-20,2020-09-26,7,2020,"39",4467673,1069,46,881,188,1023,1.02961877469546,4.20800716614667,0.213393870601589
"United States","Kentucky","KY",2020-09-27,2020-10-03,7,2020,"40",4467673,1008,51,887,121,957,1.14153385890149,2.70834503778589,0.13641488162345
"United States","Kentucky","KY",2020-10-04,2020-10-10,7,2020,"41",4467673,1068,44,883,185,1024,0.984852741013051,4.14085811562305,0.20951302378256
"United States","Kentucky","KY",2020-10-11,2020-10-17,7,2020,"42",4467673,1127,63,884,243,1064,1.41013006099596,5.43907309241299,0.274886877828054
"United States","Kentucky","KY",2020-10-18,2020-10-24,7,2020,"43",4467673,1183,92,890,293,1091,2.05923754939092,6.55822393447327,0.329213483146067
"United States","Kentucky","KY",2020-10-25,2020-10-31,7,2020,"44",4467673,1125,79,895,230,1046,1.76825833045525,5.14809387347731,0.256983240223464
"United States","Kentucky","KY",2020-11-01,2020-11-07,7,2020,"45",4467673,1181,76,910,271,1105,1.70110927993163,6.06579756396675,0.297802197802198
"United States","Kentucky","KY",2020-11-08,2020-11-14,7,2020,"46",4467673,1187,98,916,271,1089,2.19353565043816,6.06579756396675,0.29585152838428
"United States","Kentucky","KY",2020-11-15,2020-11-21,7,2020,"47",4467673,1289,125,924,365,1164,2.79787710515071,8.16980114704008,0.395021645021645
"United States","Kentucky","KY",2020-11-22,2020-11-28,7,2020,"48",4467673,1332,102,934,398,1230,2.28306771780298,8.90844070279987,0.426124197002141
"United States","Kentucky","KY",2020-11-29,2020-12-05,7,2020,"49",4467673,1357,178,948,409,1179,3.98417699773462,9.15465388805313,0.431434599156118
"United States","Kentucky","KY",2020-12-06,2020-12-12,7,2020,"50",4467673,1410,130,956,454,1280,2.90979218935674,10.1618896459074,0.47489539748954
"United States","Kentucky","KY",2020-12-13,2020-12-19,7,2020,"51",4467673,1382,179,981,401,1203,4.00656001457582,8.97558975332349,0.408766564729867
"United States","Kentucky","KY",2020-12-20,2020-12-26,7,2020,"52",4467673,1485,163,1008,477,1322,3.64843174511653,10.6766990332551,0.473214285714286
"United States","Kentucky","KY",2020-12-27,2021-01-02,7,2020,"53",4467673,1409,164,1022,387,1245,3.67081476195774,8.66222751754661,0.37866927592955
"United States","Kentucky","KY",2021-01-03,2021-01-09,7,2021,"1",4467673,1292,178,1028,264,1114,3.98417699773462,5.9091164460783,0.256809338521401
"United States","Kentucky","KY",2021-01-10,2021-01-16,7,2021,"2",4467673,1399,216,1029,370,1183,4.83473163770043,8.28171623124611,0.359572400388727
"United States","Kentucky","KY",2021-01-17,2021-01-23,7,2021,"3",4467673,1321,294,1026,295,1027,6.58060695131448,6.60298996815568,0.287524366471735
"United States","Kentucky","KY",2021-01-24,2021-01-30,7,2021,"4",4467673,1258,328,1015,243,930,7.34162952391547,5.43907309241299,0.239408866995074
"United States","Kentucky","KY",2021-01-31,2021-02-06,7,2021,"5",4467673,1168,306,1014,154,862,6.84920315340894,3.44698459354568,0.151873767258383
"United States","Kentucky","KY",2021-02-07,2021-02-13,7,2021,"6",4467673,1165,252,1006,159,913,5.64052024398384,3.55889967775171,0.158051689860835
"United States","Kentucky","KY",2021-02-14,2021-02-20,7,2021,"7",4467673,1139,154,1006,133,985,3.44698459354568,2.97694123988036,0.13220675944334
"United States","Kentucky","KY",2021-02-21,2021-02-27,7,2021,"8",4467673,1113,199,1001,112,914,4.45422035139994,2.50689788621504,0.111888111888112
"United States","Kentucky","KY",2021-02-28,2021-03-06,7,2021,"9",4467673,1071,181,998,73,890,4.05132604825823,1.63396022940802,0.0731462925851702
"United States","Kentucky","KY",2021-03-07,2021-03-13,7,2021,"10",4467673,1132,160,995,137,972,3.58128269459291,3.06647330724518,0.137688442211055
"United States","Kentucky","KY",2021-03-14,2021-03-20,7,2021,"11",4467673,1030,754,988,42,276,16.8767946982691,0.940086707330639,0.0425101214574899
"United States","Kentucky","KY",2021-03-21,2021-03-27,7,2021,"12",4467673,1037,290,975,62,747,6.49107488394965,1.38774704415475,0.0635897435897437
"United States","Kentucky","KY",2021-03-28,2021-04-03,7,2021,"13",4467673,992,139,976,16,853,3.11123934092759,0.358128269459291,0.0163934426229508
"United States","Kentucky","KY",2021-04-04,2021-04-10,7,2021,"14",4467673,1069,92,962,107,977,2.05923754939092,2.39498280200901,0.111226611226611
"United States","Kentucky","KY",2021-04-11,2021-04-17,7,2021,"15",4467673,1048,89,958,90,959,1.99208849886731,2.01447151570851,0.0939457202505218
"United States","Kentucky","KY",2021-04-18,2021-04-24,7,2021,"16",4467673,1039,106,951,88,933,2.3725997851678,1.9697054820261,0.0925341745531021
"United States","Kentucky","KY",2021-04-25,2021-05-01,7,2021,"17",4467673,1015,77,945,70,938,1.72349229677284,1.5668111788844,0.0740740740740742
"United States","Kentucky","KY",2021-05-02,2021-05-08,7,2021,"18",4467673,974,65,936,38,909,1.45489609467837,0.850554639965817,0.0405982905982907
"United States","Kentucky","KY",2021-05-09,2021-05-15,7,2021,"19",4467673,953,70,926,27,883,1.5668111788844,0.604341454712554,0.029157667386609
"United States","Kentucky","KY",2021-05-16,2021-05-22,7,2021,"20",4467673,1049,57,911,138,992,1.27583195994872,3.08885632408639,0.151481888035126
"United States","Kentucky","KY",2021-05-23,2021-05-29,7,2021,"21",4467673,1041,77,910,131,964,1.72349229677284,2.93217520619795,0.143956043956044
"United States","Kentucky","KY",2021-05-30,2021-06-05,7,2021,"22",4467673,957,309,913,44,648,6.91635220393256,0.984852741013051,0.0481927710843373
"United States","Kentucky","KY",2021-06-06,2021-06-12,7,2021,"23",4467673,964,64,913,51,900,1.43251307783716,1.14153385890149,0.0558598028477546
"United States","Kentucky","KY",2021-06-13,2021-06-19,7,2021,"24",4467673,1000,25,911,89,975,0.559575421030143,1.99208849886731,0.0976948408342482
"United States","Kentucky","KY",2021-06-20,2021-06-26,7,2021,"25",4467673,973,24,917,56,949,0.537192404188937,1.25344894310752,0.0610687022900764
"United States","Kentucky","KY",2021-06-27,2021-07-03,7,2021,"26",4467673,973,25,912,61,948,0.559575421030143,1.36536402731355,0.0668859649122806
"United States","Kentucky","KY",2021-07-04,2021-07-10,7,2021,"27",4467673,970,26,904,66,944,0.581958437871348,1.47727911151958,0.0730088495575221
"United States","Kentucky","KY",2021-07-11,2021-07-17,7,2021,"28",4467673,985,29,900,85,956,0.649107488394965,1.90255643150248,0.0944444444444446
"United States","Kentucky","KY",2021-07-18,2021-07-24,7,2021,"29",4467673,986,28,892,94,958,0.62672447155376,2.10400358307334,0.105381165919282
"United States","Kentucky","KY",2021-07-25,2021-07-31,7,2021,"30",4467673,993,22,889,104,971,0.492426370506525,2.32783375148539,0.116985376827897
"United States","Kentucky","KY",2021-08-01,2021-08-07,7,2021,"31",4467673,994,38,897,97,956,0.850554639965817,2.17115263359695,0.108138238573021
"United States","Kentucky","KY",2021-08-08,2021-08-14,7,2021,"32",4467673,1004,54,892,112,950,1.20868290942511,2.50689788621504,0.125560538116592
"United States","Kentucky","KY",2021-08-15,2021-08-21,7,2021,"33",4467673,994,25,898,96,969,0.559575421030143,2.14876961675575,0.106904231625835
"United States","Louisiana","LA",2019-12-29,2020-01-04,7,2020,"1",4648794,927,0,1000,-73,927,0,-1.57029973795354,-0.073
"United States","Louisiana","LA",2020-01-05,2020-01-11,7,2020,"2",4648794,967,0,998,-31,967,0,-0.666839614747395,-0.031062124248497
"United States","Louisiana","LA",2020-01-12,2020-01-18,7,2020,"3",4648794,960,0,991,-31,960,0,-0.666839614747395,-0.0312815338042381
"United States","Louisiana","LA",2020-01-19,2020-01-25,7,2020,"4",4648794,970,0,1004,-34,970,0,-0.731372480690691,-0.0338645418326693
"United States","Louisiana","LA",2020-01-26,2020-02-01,7,2020,"5",4648794,977,0,997,-20,977,0,-0.430219106288642,-0.0200601805416248
"United States","Louisiana","LA",2020-02-02,2020-02-08,7,2020,"6",4648794,956,0,1002,-46,956,0,-0.989503944463876,-0.0459081836327345
"United States","Louisiana","LA",2020-02-09,2020-02-15,7,2020,"7",4648794,951,0,981,-30,951,0,-0.645328659432963,-0.0305810397553516
"United States","Louisiana","LA",2020-02-16,2020-02-22,7,2020,"8",4648794,950,0,961,-11,950,0,-0.236620508458753,-0.0114464099895941
"United States","Louisiana","LA",2020-02-23,2020-02-29,7,2020,"9",4648794,993,0,947,46,993,0,0.989503944463876,0.0485744456177402
"United States","Louisiana","LA",2020-03-01,2020-03-07,7,2020,"10",4648794,964,0,932,32,964,0,0.688350570061827,0.0343347639484979
"United States","Louisiana","LA",2020-03-08,2020-03-14,7,2020,"11",4648794,994,1,942,52,993,0.0215109553144321,1.11856967635047,0.0552016985138004
"United States","Louisiana","LA",2020-03-15,2020-03-21,7,2020,"12",4648794,955,19,948,7,936,0.40870815097421,0.150576687201025,0.0073839662447257
"United States","Louisiana","LA",2020-03-22,2020-03-28,7,2020,"13",4648794,1233,117,945,288,1116,2.51678177178855,6.19515513055644,0.304761904761905
"United States","Louisiana","LA",2020-03-29,2020-04-04,7,2020,"14",4648794,1390,271,934,456,1119,5.8294688902111,9.80899562338103,0.488222698072805
"United States","Louisiana","LA",2020-04-05,2020-04-11,7,2020,"15",4648794,1529,395,932,597,1134,8.49682734920067,12.842040322716,0.640557939914163
"United States","Louisiana","LA",2020-04-12,2020-04-18,7,2020,"16",4648794,1360,465,936,424,895,10.0025942212109,9.1206450533192,0.452991452991453
"United States","Louisiana","LA",2020-04-19,2020-04-25,7,2020,"17",4648794,1248,375,923,325,873,8.06660824291203,6.99106047719043,0.352112676056338
"United States","Louisiana","LA",2020-04-26,2020-05-02,7,2020,"18",4648794,1171,302,915,256,869,6.49630850495849,5.50680456049461,0.279781420765027
"United States","Louisiana","LA",2020-05-03,2020-05-09,7,2020,"19",4648794,1129,241,919,210,888,5.18414023077813,4.51730061603074,0.228509249183896
"United States","Louisiana","LA",2020-05-10,2020-05-16,7,2020,"20",4648794,1105,225,906,199,880,4.83996494574722,4.28068010757199,0.219646799116998
"United States","Louisiana","LA",2020-05-17,2020-05-23,7,2020,"21",4648794,1052,149,906,146,903,3.20513234185038,3.14059947590708,0.161147902869757
"United States","Louisiana","LA",2020-05-24,2020-05-30,7,2020,"22",4648794,1054,118,903,151,936,2.53829272710299,3.24815425247925,0.167220376522702
"United States","Louisiana","LA",2020-05-31,2020-06-06,7,2020,"23",4648794,1016,134,886,130,882,2.8824680121339,2.79642419087617,0.146726862302483
"United States","Louisiana","LA",2020-06-07,2020-06-13,7,2020,"24",4648794,951,78,869,82,873,1.6778545145257,1.76389833578343,0.094361334867664
"United States","Louisiana","LA",2020-06-14,2020-06-20,7,2020,"25",4648794,1004,99,865,139,905,2.12958457612878,2.99002278870606,0.160693641618497
"United States","Louisiana","LA",2020-06-21,2020-06-27,7,2020,"26",4648794,998,88,860,138,910,1.89296406767002,2.96851183339163,0.16046511627907
"United States","Louisiana","LA",2020-06-28,2020-07-04,7,2020,"27",4648794,985,92,849,136,893,1.97900788892775,2.92548992276276,0.160188457008245
"United States","Louisiana","LA",2020-07-05,2020-07-11,7,2020,"28",4648794,1061,126,851,210,935,2.71038036961844,4.51730061603074,0.246768507638073
"United States","Louisiana","LA",2020-07-12,2020-07-18,7,2020,"29",4648794,1152,104,851,301,1048,2.23713935270094,6.47479754964406,0.353701527614571
"United States","Louisiana","LA",2020-07-19,2020-07-25,7,2020,"30",4648794,1213,204,853,360,1009,4.38823488414415,7.74394391319555,0.422039859320047
"United States","Louisiana","LA",2020-07-26,2020-08-01,7,2020,"31",4648794,1205,232,857,348,973,4.99054163294824,7.48581244942237,0.406067677946324
"United States","Louisiana","LA",2020-08-02,2020-08-08,7,2020,"32",4648794,1243,254,870,373,989,5.46378264986575,8.02358633228317,0.428735632183908
"United States","Louisiana","LA",2020-08-09,2020-08-15,7,2020,"33",4648794,1181,218,861,320,963,4.6893882585462,6.88350570061827,0.371660859465738
"United States","Louisiana","LA",2020-08-16,2020-08-22,7,2020,"34",4648794,1132,239,860,272,893,5.14111832014927,5.85097984552553,0.316279069767442
"United States","Louisiana","LA",2020-08-23,2020-08-29,7,2020,"35",4648794,1098,195,861,237,903,4.19463628631426,5.0980964095204,0.275261324041812
"United States","Louisiana","LA",2020-08-30,2020-09-05,7,2020,"36",4648794,1110,131,876,234,979,2.8179351461906,5.03356354357711,0.267123287671233
"United States","Louisiana","LA",2020-09-06,2020-09-12,7,2020,"37",4648794,1027,160,868,159,867,3.44175285030913,3.4202418949947,0.183179723502304
"United States","Louisiana","LA",2020-09-13,2020-09-19,7,2020,"38",4648794,1040,140,862,178,900,3.01153374402049,3.82895004596891,0.206496519721578
"United States","Louisiana","LA",2020-09-20,2020-09-26,7,2020,"39",4648794,991,90,869,122,901,1.93598597829889,2.62433654836071,0.140391254315305
"United States","Louisiana","LA",2020-09-27,2020-10-03,7,2020,"40",4648794,1036,125,869,167,911,2.68886941430401,3.59232953751016,0.192174913693901
"United States","Louisiana","LA",2020-10-04,2020-10-10,7,2020,"41",4648794,1044,55,862,182,989,1.18310254229376,3.91499386722664,0.211136890951276
"United States","Louisiana","LA",2020-10-11,2020-10-17,7,2020,"42",4648794,991,85,868,123,906,1.82843120172673,2.64584750367515,0.141705069124424
"United States","Louisiana","LA",2020-10-18,2020-10-24,7,2020,"43",4648794,1008,87,883,125,921,1.87145311235559,2.68886941430401,0.141562853907135
"United States","Louisiana","LA",2020-10-25,2020-10-31,7,2020,"44",4648794,951,91,891,60,860,1.95749693361332,1.29065731886593,0.0673400673400673
"United States","Louisiana","LA",2020-11-01,2020-11-07,7,2020,"45",4648794,1052,82,902,150,970,1.76389833578343,3.22664329716481,0.16629711751663
"United States","Louisiana","LA",2020-11-08,2020-11-14,7,2020,"46",4648794,1056,98,905,151,958,2.10807362081434,3.24815425247925,0.166850828729282
"United States","Louisiana","LA",2020-11-15,2020-11-21,7,2020,"47",4648794,1068,348,923,145,720,7.48581244942237,3.11908852059265,0.157096424702059
"United States","Louisiana","LA",2020-11-22,2020-11-28,7,2020,"48",4648794,1084,174,933,151,910,3.74290622471118,3.24815425247925,0.161843515541265
"United States","Louisiana","LA",2020-11-29,2020-12-05,7,2020,"49",4648794,1103,139,940,163,964,2.99002278870606,3.50628571625243,0.173404255319149
"United States","Louisiana","LA",2020-12-06,2020-12-12,7,2020,"50",4648794,1238,220,951,287,1018,4.73241016917506,6.17364417524201,0.301787592008412
"United States","Louisiana","LA",2020-12-13,2020-12-19,7,2020,"51",4648794,1207,228,950,257,979,4.90449781169052,5.52831551580905,0.270526315789474
"United States","Louisiana","LA",2020-12-20,2020-12-26,7,2020,"52",4648794,1240,278,940,300,962,5.98004557741212,6.45328659432963,0.319148936170213
"United States","Louisiana","LA",2020-12-27,2021-01-02,7,2020,"53",4648794,1251,214,947,304,1037,4.60334443728847,6.53933041558735,0.321013727560718
"United States","Louisiana","LA",2021-01-03,2021-01-09,7,2021,"1",4648794,1397,347,952,445,1050,7.46430149410793,9.57237511492228,0.467436974789916
"United States","Louisiana","LA",2021-01-10,2021-01-16,7,2021,"2",4648794,1404,247,952,452,1157,5.31320596266473,9.7229518021233,0.474789915966387
"United States","Louisiana","LA",2021-01-17,2021-01-23,7,2021,"3",4648794,1362,403,953,409,959,8.66891499171613,8.79798072360272,0.429171038824764
"United States","Louisiana","LA",2021-01-24,2021-01-30,7,2021,"4",4648794,1248,318,952,296,930,6.8404837899894,6.3672427730719,0.310924369747899
"United States","Louisiana","LA",2021-01-31,2021-02-06,7,2021,"5",4648794,1196,275,938,258,921,5.91551271146882,5.54982647112348,0.275053304904051
"United States","Louisiana","LA",2021-02-07,2021-02-13,7,2021,"6",4648794,1163,200,927,236,963,4.30219106288642,5.07658545420597,0.254584681769148
"United States","Louisiana","LA",2021-02-14,2021-02-20,7,2021,"7",4648794,1161,165,908,253,996,3.54930762688129,5.44227169455132,0.27863436123348
"United States","Louisiana","LA",2021-02-21,2021-02-27,7,2021,"8",4648794,1101,148,889,212,953,3.18362138653595,4.5603225266596,0.238470191226097
"United States","Louisiana","LA",2021-02-28,2021-03-06,7,2021,"9",4648794,1072,127,880,192,945,2.73189132493288,4.13010342037096,0.218181818181818
"United States","Louisiana","LA",2021-03-07,2021-03-13,7,2021,"10",4648794,1043,145,876,167,898,3.11908852059265,3.59232953751016,0.190639269406393
"United States","Louisiana","LA",2021-03-14,2021-03-20,7,2021,"11",4648794,1013,127,869,144,886,2.73189132493288,3.09757756527822,0.165707710011507
"United States","Louisiana","LA",2021-03-21,2021-03-27,7,2021,"12",4648794,1029,100,879,150,929,2.15109553144321,3.22664329716481,0.170648464163823
"United States","Louisiana","LA",2021-03-28,2021-04-03,7,2021,"13",4648794,992,75,876,116,917,1.61332164858241,2.49527081647412,0.132420091324201
"United States","Louisiana","LA",2021-04-04,2021-04-10,7,2021,"14",4648794,974,53,862,112,921,1.1400806316649,2.40922699521639,0.129930394431555
"United States","Louisiana","LA",2021-04-11,2021-04-17,7,2021,"15",4648794,981,66,864,117,915,1.41972305075252,2.51678177178855,0.135416666666667
"United States","Louisiana","LA",2021-04-18,2021-04-24,7,2021,"16",4648794,999,54,856,143,945,1.16159158697933,3.07606660996379,0.167056074766355
"United States","Louisiana","LA",2021-04-25,2021-05-01,7,2021,"17",4648794,986,46,853,133,940,0.989503944463876,2.86095705681947,0.155920281359906
"United States","Louisiana","LA",2021-05-02,2021-05-08,7,2021,"18",4648794,936,51,860,76,885,1.09705872103604,1.63483260389684,0.0883720930232559
"United States","Louisiana","LA",2021-05-09,2021-05-15,7,2021,"19",4648794,933,45,856,77,888,0.967992989149444,1.65634355921127,0.0899532710280373
"United States","Louisiana","LA",2021-05-16,2021-05-22,7,2021,"20",4648794,946,44,856,90,902,0.946482033835012,1.93598597829889,0.105140186915888
"United States","Louisiana","LA",2021-05-23,2021-05-29,7,2021,"21",4648794,924,54,857,67,870,1.16159158697933,1.44123400606695,0.0781796966161026
"United States","Louisiana","LA",2021-05-30,2021-06-05,7,2021,"22",4648794,964,39,851,113,925,0.838927257262851,2.43073795053083,0.132784958871915
"United States","Louisiana","LA",2021-06-06,2021-06-12,7,2021,"23",4648794,960,33,847,113,927,0.709861525376259,2.43073795053083,0.133412042502952
"United States","Louisiana","LA",2021-06-13,2021-06-19,7,2021,"24",4648794,926,40,831,95,886,0.860438212577283,2.04354075487105,0.114320096269555
"United States","Louisiana","LA",2021-06-20,2021-06-26,7,2021,"25",4648794,939,35,833,106,904,0.752883436005123,2.2801612633298,0.127250900360144
"United States","Louisiana","LA",2021-06-27,2021-07-03,7,2021,"26",4648794,876,34,822,54,842,0.731372480690691,1.16159158697933,0.0656934306569343
"United States","Louisiana","LA",2021-07-04,2021-07-10,7,2021,"27",4648794,898,24,818,80,874,0.51626292754637,1.72087642515457,0.097799511002445
"United States","Louisiana","LA",2021-07-11,2021-07-17,7,2021,"28",4648794,955,47,822,133,908,1.01101489977831,2.86095705681947,0.161800486618005
"United States","Louisiana","LA",2021-07-18,2021-07-24,7,2021,"29",4648794,999,72,824,175,927,1.54878878263911,3.76441718002562,0.212378640776699
"United States","Louisiana","LA",2021-07-25,2021-07-31,7,2021,"30",4648794,1044,99,825,219,945,2.12958457612878,4.71089921386063,0.265454545454545
"United States","Louisiana","LA",2021-08-01,2021-08-07,7,2021,"31",4648794,1107,211,822,285,896,4.53881157134517,6.13062226461314,0.346715328467153
"United States","Louisiana","LA",2021-08-08,2021-08-14,7,2021,"32",4648794,1034,309,824,210,725,6.64688519215951,4.51730061603074,0.254854368932039
"United States","Louisiana","LA",2021-08-15,2021-08-21,7,2021,"33",4648794,549,65,837,-288,484,1.39821209543809,-6.19515513055644,-0.344086021505376
"United States","Maine","ME",2019-12-29,2020-01-04,7,2020,"1",1344212,320,0,306,14,320,0,1.04150238206473,0.0457516339869282
"United States","Maine","ME",2020-01-05,2020-01-11,7,2020,"2",1344212,318,0,309,9,318,0,0.669537245613043,0.029126213592233
"United States","Maine","ME",2020-01-12,2020-01-18,7,2020,"3",1344212,295,0,310,-15,295,0,-1.11589540935507,-0.0483870967741935
"United States","Maine","ME",2020-01-19,2020-01-25,7,2020,"4",1344212,308,0,305,3,308,0,0.223179081871014,0.00983606557377059
"United States","Maine","ME",2020-01-26,2020-02-01,7,2020,"5",1344212,288,0,300,-12,288,0,-0.892716327484057,-0.04
"United States","Maine","ME",2020-02-02,2020-02-08,7,2020,"6",1344212,316,0,299,17,316,0,1.26468146393575,0.0568561872909699
"United States","Maine","ME",2020-02-09,2020-02-15,7,2020,"7",1344212,329,0,293,36,329,0,2.67814898245217,0.122866894197952
"United States","Maine","ME",2020-02-16,2020-02-22,7,2020,"8",1344212,299,0,292,7,299,0,0.520751191032367,0.023972602739726
"United States","Maine","ME",2020-02-23,2020-02-29,7,2020,"9",1344212,292,0,294,-2,292,0,-0.148786054580676,-0.00680272108843538
"United States","Maine","ME",2020-03-01,2020-03-07,7,2020,"10",1344212,313,0,290,23,313,0,1.71103962767778,0.0793103448275863
"United States","Maine","ME",2020-03-08,2020-03-14,7,2020,"11",1344212,301,0,291,10,301,0,0.743930272903381,0.034364261168385
"United States","Maine","ME",2020-03-15,2020-03-21,7,2020,"12",1344212,277,0,291,-14,277,0,-1.04150238206473,-0.0481099656357389
"United States","Maine","ME",2020-03-22,2020-03-28,7,2020,"13",1344212,279,1,301,-22,278,0.0743930272903381,-1.63664660038744,-0.0730897009966778
"United States","Maine","ME",2020-03-29,2020-04-04,7,2020,"14",1344212,300,9,297,3,291,0.669537245613043,0.223179081871014,0.0101010101010102
"United States","Maine","ME",2020-04-05,2020-04-11,7,2020,"15",1344212,304,9,291,13,295,0.669537245613043,0.967109354774396,0.0446735395189004
"United States","Maine","ME",2020-04-12,2020-04-18,7,2020,"16",1344212,310,13,287,23,297,0.967109354774396,1.71103962767778,0.0801393728222997
"United States","Maine","ME",2020-04-19,2020-04-25,7,2020,"17",1344212,285,18,282,3,267,1.33907449122609,0.223179081871014,0.0106382978723405
"United States","Maine","ME",2020-04-26,2020-05-02,7,2020,"18",1344212,277,6,271,6,271,0.446358163742029,0.446358163742029,0.0221402214022139
"United States","Maine","ME",2020-05-03,2020-05-09,7,2020,"19",1344212,293,8,271,22,285,0.595144218322705,1.63664660038744,0.0811808118081181
"United States","Maine","ME",2020-05-10,2020-05-16,7,2020,"20",1344212,256,6,269,-13,250,0.446358163742029,-0.967109354774396,-0.0483271375464684
"United States","Maine","ME",2020-05-17,2020-05-23,7,2020,"21",1344212,267,7,263,4,260,0.520751191032367,0.297572109161353,0.0152091254752851
"United States","Maine","ME",2020-05-24,2020-05-30,7,2020,"22",1344212,302,12,264,38,290,0.892716327484057,2.82693503703285,0.143939393939394
"United States","Maine","ME",2020-05-31,2020-06-06,7,2020,"23",1344212,255,9,266,-11,246,0.669537245613043,-0.818323300193719,-0.0413533834586466
"United States","Maine","ME",2020-06-07,2020-06-13,7,2020,"24",1344212,254,2,267,-13,252,0.148786054580676,-0.967109354774396,-0.048689138576779
"United States","Maine","ME",2020-06-14,2020-06-20,7,2020,"25",1344212,275,2,268,7,273,0.148786054580676,0.520751191032367,0.0261194029850746
"United States","Maine","ME",2020-06-21,2020-06-27,7,2020,"26",1344212,299,2,270,29,297,0.148786054580676,2.15739779141981,0.107407407407407
"United States","Maine","ME",2020-06-28,2020-07-04,7,2020,"27",1344212,280,5,273,7,275,0.371965136451691,0.520751191032367,0.0256410256410255
"United States","Maine","ME",2020-07-05,2020-07-11,7,2020,"28",1344212,289,5,273,16,284,0.371965136451691,1.19028843664541,0.0586080586080586
"United States","Maine","ME",2020-07-12,2020-07-18,7,2020,"29",1344212,294,3,266,28,291,0.223179081871014,2.08300476412947,0.105263157894737
"United States","Maine","ME",2020-07-19,2020-07-25,7,2020,"30",1344212,282,2,269,13,280,0.148786054580676,0.967109354774396,0.0483271375464684
"United States","Maine","ME",2020-07-26,2020-08-01,7,2020,"31",1344212,283,4,273,10,279,0.297572109161353,0.743930272903381,0.0366300366300367
"United States","Maine","ME",2020-08-02,2020-08-08,7,2020,"32",1344212,276,2,274,2,274,0.148786054580676,0.148786054580676,0.0072992700729928
"United States","Maine","ME",2020-08-09,2020-08-15,7,2020,"33",1344212,280,2,271,9,278,0.148786054580676,0.669537245613043,0.033210332103321
"United States","Maine","ME",2020-08-16,2020-08-22,7,2020,"34",1344212,312,3,275,37,309,0.223179081871014,2.75254200974251,0.134545454545455
"United States","Maine","ME",2020-08-23,2020-08-29,7,2020,"35",1344212,285,2,269,16,283,0.148786054580676,1.19028843664541,0.0594795539033457
"United States","Maine","ME",2020-08-30,2020-09-05,7,2020,"36",1344212,289,2,270,19,287,0.148786054580676,1.41346751851642,0.0703703703703704
"United States","Maine","ME",2020-09-06,2020-09-12,7,2020,"37",1344212,319,0,272,47,319,0,3.49647228264589,0.172794117647059
"United States","Maine","ME",2020-09-13,2020-09-19,7,2020,"38",1344212,299,5,278,21,294,0.371965136451691,1.5622535730971,0.0755395683453237
"United States","Maine","ME",2020-09-20,2020-09-26,7,2020,"39",1344212,309,1,282,27,308,0.0743930272903381,2.00861173683913,0.0957446808510638
"United States","Maine","ME",2020-09-27,2020-10-03,7,2020,"40",1344212,289,2,290,-1,287,0.148786054580676,-0.0743930272903381,-0.00344827586206897
"United States","Maine","ME",2020-10-04,2020-10-10,7,2020,"41",1344212,302,1,287,15,301,0.0743930272903381,1.11589540935507,0.0522648083623694
"United States","Maine","ME",2020-10-11,2020-10-17,7,2020,"42",1344212,275,3,283,-8,272,0.223179081871014,-0.595144218322705,-0.0282685512367491
"United States","Maine","ME",2020-10-18,2020-10-24,7,2020,"43",1344212,275,0,285,-10,275,0,-0.743930272903381,-0.0350877192982456
"United States","Maine","ME",2020-10-25,2020-10-31,7,2020,"44",1344212,275,1,283,-8,274,0.0743930272903381,-0.595144218322705,-0.0282685512367491
"United States","Maine","ME",2020-11-01,2020-11-07,7,2020,"45",1344212,334,5,285,49,329,0.371965136451691,3.64525833722657,0.171929824561404
"United States","Maine","ME",2020-11-08,2020-11-14,7,2020,"46",1344212,323,11,286,37,312,0.818323300193719,2.75254200974251,0.129370629370629
"United States","Maine","ME",2020-11-15,2020-11-21,7,2020,"47",1344212,307,13,298,9,294,0.967109354774396,0.669537245613043,0.0302013422818792
"United States","Maine","ME",2020-11-22,2020-11-28,7,2020,"48",1344212,349,15,298,51,334,1.11589540935507,3.79404439180724,0.171140939597315
"United States","Maine","ME",2020-11-29,2020-12-05,7,2020,"49",1344212,342,35,304,38,307,2.60375595516183,2.82693503703285,0.125
"United States","Maine","ME",2020-12-06,2020-12-12,7,2020,"50",1344212,353,31,306,47,322,2.30618384600048,3.49647228264589,0.15359477124183
"United States","Maine","ME",2020-12-13,2020-12-19,7,2020,"51",1344212,324,35,304,20,289,2.60375595516183,1.48786054580676,0.0657894736842106
"United States","Maine","ME",2020-12-20,2020-12-26,7,2020,"52",1344212,347,27,302,45,320,2.00861173683913,3.34768622806522,0.149006622516556
"United States","Maine","ME",2020-12-27,2021-01-02,7,2020,"53",1344212,355,116,304,51,239,8.62959116567922,3.79404439180724,0.167763157894737
"United States","Maine","ME",2021-01-03,2021-01-09,7,2021,"1",1344212,345,42,307,38,303,3.1245071461942,2.82693503703285,0.123778501628665
"United States","Maine","ME",2021-01-10,2021-01-16,7,2021,"2",1344212,362,62,307,55,300,4.61236769200096,4.0916165009686,0.179153094462541
"United States","Maine","ME",2021-01-17,2021-01-23,7,2021,"3",1344212,335,52,307,28,283,3.86843741909758,2.08300476412947,0.0912052117263844
"United States","Maine","ME",2021-01-24,2021-01-30,7,2021,"4",1344212,356,36,304,52,320,2.67814898245217,3.86843741909758,0.171052631578947
"United States","Maine","ME",2021-01-31,2021-02-06,7,2021,"5",1344212,302,8,304,-2,294,0.595144218322705,-0.148786054580676,-0.00657894736842102
"United States","Maine","ME",2021-02-07,2021-02-13,7,2021,"6",1344212,327,13,299,28,314,0.967109354774396,2.08300476412947,0.0936454849498327
"United States","Maine","ME",2021-02-14,2021-02-20,7,2021,"7",1344212,289,11,300,-11,278,0.818323300193719,-0.818323300193719,-0.0366666666666666
"United States","Maine","ME",2021-02-21,2021-02-27,7,2021,"8",1344212,280,44,301,-21,236,3.27329320077488,-1.5622535730971,-0.0697674418604651
"United States","Maine","ME",2021-02-28,2021-03-06,7,2021,"9",1344212,327,4,307,20,323,0.297572109161353,1.48786054580676,0.0651465798045603
"United States","Maine","ME",2021-03-07,2021-03-13,7,2021,"10",1344212,284,17,305,-21,267,1.26468146393575,-1.5622535730971,-0.0688524590163935
"United States","Maine","ME",2021-03-14,2021-03-20,7,2021,"11",1344212,249,4,311,-62,245,0.297572109161353,-4.61236769200096,-0.19935691318328
"United States","Maine","ME",2021-03-21,2021-03-27,7,2021,"12",1344212,269,8,307,-38,261,0.595144218322705,-2.82693503703285,-0.123778501628665
"United States","Maine","ME",2021-03-28,2021-04-03,7,2021,"13",1344212,312,9,311,1,303,0.669537245613043,0.0743930272903381,0.00321543408360125
"United States","Maine","ME",2021-04-04,2021-04-10,7,2021,"14",1344212,289,5,306,-17,284,0.371965136451691,-1.26468146393575,-0.0555555555555556
"United States","Maine","ME",2021-04-11,2021-04-17,7,2021,"15",1344212,310,14,304,6,296,1.04150238206473,0.446358163742029,0.0197368421052631
"United States","Maine","ME",2021-04-18,2021-04-24,7,2021,"16",1344212,293,8,300,-7,285,0.595144218322705,-0.520751191032367,-0.0233333333333333
"United States","Maine","ME",2021-04-25,2021-05-01,7,2021,"17",1344212,306,17,291,15,289,1.26468146393575,1.11589540935507,0.0515463917525774
"United States","Maine","ME",2021-05-02,2021-05-08,7,2021,"18",1344212,299,6,286,13,293,0.446358163742029,0.967109354774396,0.0454545454545454
"United States","Maine","ME",2021-05-09,2021-05-15,7,2021,"19",1344212,296,6,283,13,290,0.446358163742029,0.967109354774396,0.0459363957597174
"United States","Maine","ME",2021-05-16,2021-05-22,7,2021,"20",1344212,340,18,276,64,322,1.33907449122609,4.76115374658164,0.231884057971014
"United States","Maine","ME",2021-05-23,2021-05-29,7,2021,"21",1344212,315,6,272,43,309,0.446358163742029,3.19890017348454,0.158088235294118
"United States","Maine","ME",2021-05-30,2021-06-05,7,2021,"22",1344212,298,14,277,21,284,1.04150238206473,1.5622535730971,0.075812274368231
"United States","Maine","ME",2021-06-06,2021-06-12,7,2021,"23",1344212,327,6,278,49,321,0.446358163742029,3.64525833722657,0.176258992805755
"United States","Maine","ME",2021-06-13,2021-06-19,7,2021,"24",1344212,296,9,280,16,287,0.669537245613043,1.19028843664541,0.0571428571428572
"United States","Maine","ME",2021-06-20,2021-06-26,7,2021,"25",1344212,318,4,278,40,314,0.297572109161353,2.97572109161353,0.143884892086331
"United States","Maine","ME",2021-06-27,2021-07-03,7,2021,"26",1344212,317,2,279,38,315,0.148786054580676,2.82693503703285,0.136200716845878
"United States","Maine","ME",2021-07-04,2021-07-10,7,2021,"27",1344212,322,2,283,39,320,0.148786054580676,2.90132806432319,0.137809187279152
"United States","Maine","ME",2021-07-11,2021-07-17,7,2021,"28",1344212,309,20,283,26,289,1.48786054580676,1.93421870954879,0.0918727915194346
"United States","Maine","ME",2021-07-18,2021-07-24,7,2021,"29",1344212,289,15,278,11,274,1.11589540935507,0.818323300193719,0.039568345323741
"United States","Maine","ME",2021-07-25,2021-07-31,7,2021,"30",1344212,285,3,285,0,282,0.223179081871014,0,0
"United States","Maine","ME",2021-08-01,2021-08-07,7,2021,"31",1344212,275,1,285,-10,274,0.0743930272903381,-0.743930272903381,-0.0350877192982456
"United States","Maine","ME",2021-08-08,2021-08-14,7,2021,"32",1344212,322,3,282,40,319,0.223179081871014,2.97572109161353,0.141843971631206
"United States","Maine","ME",2021-08-15,2021-08-21,7,2021,"33",1344212,312,0,279,33,312,0,2.45496990058116,0.118279569892473
"United States","Maryland","MD",2019-12-29,2020-01-04,7,2020,"1",6045680,1049,0,1107,-58,1049,0,-0.959362718503129,-0.052393857271906
"United States","Maryland","MD",2020-01-05,2020-01-11,7,2020,"2",6045680,1035,0,1097,-62,1035,0,-1.02552566460679,-0.0565177757520511
"United States","Maryland","MD",2020-01-12,2020-01-18,7,2020,"3",6045680,988,0,1097,-109,988,0,-1.80294028132485,-0.0993618960802187
"United States","Maryland","MD",2020-01-19,2020-01-25,7,2020,"4",6045680,1003,0,1092,-89,1003,0,-1.47212555080653,-0.0815018315018315
"United States","Maryland","MD",2020-01-26,2020-02-01,7,2020,"5",6045680,1034,0,1084,-50,1034,0,-0.827036826295801,-0.0461254612546126
"United States","Maryland","MD",2020-02-02,2020-02-08,7,2020,"6",6045680,1004,0,1073,-69,1004,0,-1.14131082028821,-0.0643056849953402
"United States","Maryland","MD",2020-02-09,2020-02-15,7,2020,"7",6045680,1019,0,1057,-38,1019,0,-0.628547987984809,-0.0359508041627247
"United States","Maryland","MD",2020-02-16,2020-02-22,7,2020,"8",6045680,973,0,1056,-83,973,0,-1.37288113165103,-0.0785984848484849
"United States","Maryland","MD",2020-02-23,2020-02-29,7,2020,"9",6045680,1082,0,1038,44,1082,0,0.727792407140305,0.0423892100192678
"United States","Maryland","MD",2020-03-01,2020-03-07,7,2020,"10",6045680,1049,0,1018,31,1049,0,0.512762832303397,0.0304518664047151
"United States","Maryland","MD",2020-03-08,2020-03-14,7,2020,"11",6045680,1005,0,999,6,1005,0,0.0992444191554961,0.00600600600600609
"United States","Maryland","MD",2020-03-15,2020-03-21,7,2020,"12",6045680,1064,3,995,69,1061,0.0496222095777481,1.14131082028821,0.0693467336683418
"United States","Maryland","MD",2020-03-22,2020-03-28,7,2020,"13",6045680,1092,7,994,98,1085,0.115785155681412,1.62099217953977,0.0985915492957747
"United States","Maryland","MD",2020-03-29,2020-04-04,7,2020,"14",6045680,1191,43,988,203,1148,0.711251670614389,3.35776951476095,0.205465587044534
"United States","Maryland","MD",2020-04-05,2020-04-11,7,2020,"15",6045680,1353,149,982,371,1204,2.46456974236149,6.13661325111485,0.377800407331976
"United States","Maryland","MD",2020-04-12,2020-04-18,7,2020,"16",6045680,1357,172,971,386,1185,2.84500668245756,6.38472429900359,0.397528321318229
"United States","Maryland","MD",2020-04-19,2020-04-25,7,2020,"17",6045680,1538,321,958,580,1217,5.30957642481904,9.59362718503129,0.605427974947808
"United States","Maryland","MD",2020-04-26,2020-05-02,7,2020,"18",6045680,1523,397,935,588,1126,6.56667240078866,9.72595307723862,0.628877005347594
"United States","Maryland","MD",2020-05-03,2020-05-09,7,2020,"19",6045680,1445,337,926,519,1108,5.5742282092337,8.58464225695042,0.560475161987041
"United States","Maryland","MD",2020-05-10,2020-05-16,7,2020,"20",6045680,1431,343,919,512,1088,5.6734726283892,8.46885710126901,0.557127312295974
"United States","Maryland","MD",2020-05-17,2020-05-23,7,2020,"21",6045680,1336,315,919,417,1021,5.21033200566355,6.89748713130698,0.453754080522307
"United States","Maryland","MD",2020-05-24,2020-05-30,7,2020,"22",6045680,1265,320,909,356,945,5.29303568829313,5.88850220322611,0.391639163916392
"United States","Maryland","MD",2020-05-31,2020-06-06,7,2020,"23",6045680,1167,361,917,250,806,5.97120588585569,4.13518413147901,0.272628135223555
"United States","Maryland","MD",2020-06-07,2020-06-13,7,2020,"24",6045680,1158,184,910,248,974,3.04349552076855,4.10210265842717,0.272527472527472
"United States","Maryland","MD",2020-06-14,2020-06-20,7,2020,"25",6045680,1070,141,919,151,929,2.33224385015416,2.49765121541332,0.164309031556039
"United States","Maryland","MD",2020-06-21,2020-06-27,7,2020,"26",6045680,1031,108,914,117,923,1.78639954479893,1.93526617353218,0.12800875273523
"United States","Maryland","MD",2020-06-28,2020-07-04,7,2020,"27",6045680,1051,79,922,129,972,1.30671818554737,2.13375501184317,0.139913232104121
"United States","Maryland","MD",2020-07-05,2020-07-11,7,2020,"28",6045680,1031,79,919,112,952,1.30671818554737,1.8525624909026,0.121871599564744
"United States","Maryland","MD",2020-07-12,2020-07-18,7,2020,"29",6045680,1026,69,918,108,957,1.14131082028821,1.78639954479893,0.117647058823529
"United States","Maryland","MD",2020-07-19,2020-07-25,7,2020,"30",6045680,1002,63,905,97,939,1.04206640113271,1.60445144301385,0.107182320441989
"United States","Maryland","MD",2020-07-26,2020-08-01,7,2020,"31",6045680,1067,66,907,160,1001,1.09168861071046,2.64651784414656,0.176405733186328
"United States","Maryland","MD",2020-08-02,2020-08-08,7,2020,"32",6045680,1007,69,903,104,938,1.14131082028821,1.72023659869527,0.115171650055371
"United States","Maryland","MD",2020-08-09,2020-08-15,7,2020,"33",6045680,1064,65,915,149,999,1.07514787418454,2.46456974236149,0.162841530054645
"United States","Maryland","MD",2020-08-16,2020-08-22,7,2020,"34",6045680,1002,48,912,90,954,0.793955353243969,1.48866628733244,0.0986842105263157
"United States","Maryland","MD",2020-08-23,2020-08-29,7,2020,"35",6045680,1040,62,921,119,978,1.02552566460679,1.96834764658401,0.129207383279045
"United States","Maryland","MD",2020-08-30,2020-09-05,7,2020,"36",6045680,1046,53,939,107,993,0.876659035873549,1.76985880827301,0.11395101171459
"United States","Maryland","MD",2020-09-06,2020-09-12,7,2020,"37",6045680,996,38,922,74,958,0.628547987984809,1.22401450291779,0.0802603036876355
"United States","Maryland","MD",2020-09-13,2020-09-19,7,2020,"38",6045680,991,40,925,66,951,0.661629461036641,1.09168861071046,0.0713513513513513
"United States","Maryland","MD",2020-09-20,2020-09-26,7,2020,"39",6045680,1071,49,935,136,1022,0.810496089769885,2.24954016752458,0.145454545454546
"United States","Maryland","MD",2020-09-27,2020-10-03,7,2020,"40",6045680,1074,31,936,138,1043,0.512762832303397,2.28262164057641,0.147435897435897
"United States","Maryland","MD",2020-10-04,2020-10-10,7,2020,"41",6045680,1086,34,942,144,1052,0.562385041881145,2.38186605973191,0.152866242038217
"United States","Maryland","MD",2020-10-11,2020-10-17,7,2020,"42",6045680,1052,49,965,87,1003,0.810496089769885,1.43904407775469,0.0901554404145077
"United States","Maryland","MD",2020-10-18,2020-10-24,7,2020,"43",6045680,1101,45,956,145,1056,0.744333143666221,2.39840679625782,0.151673640167364
"United States","Maryland","MD",2020-10-25,2020-10-31,7,2020,"44",6045680,1071,58,962,109,1013,0.959362718503129,1.80294028132485,0.113305613305613
"United States","Maryland","MD",2020-11-01,2020-11-07,7,2020,"45",6045680,1088,56,965,123,1032,0.926281245451298,2.03451059268767,0.127461139896373
"United States","Maryland","MD",2020-11-08,2020-11-14,7,2020,"46",6045680,1106,80,976,130,1026,1.32325892207328,2.15029574836908,0.133196721311475
"United States","Maryland","MD",2020-11-15,2020-11-21,7,2020,"47",6045680,1224,130,978,246,1094,2.15029574836908,4.06902118537534,0.251533742331288
"United States","Maryland","MD",2020-11-22,2020-11-28,7,2020,"48",6045680,1185,161,991,194,1024,2.66305858067248,3.20890288602771,0.195761856710394
"United States","Maryland","MD",2020-11-29,2020-12-05,7,2020,"49",6045680,1258,221,989,269,1037,3.65550277222744,4.44945812547141,0.271991911021234
"United States","Maryland","MD",2020-12-06,2020-12-12,7,2020,"50",6045680,1378,276,1018,360,1102,4.56524328115282,5.95466514932977,0.353634577603143
"United States","Maryland","MD",2020-12-13,2020-12-19,7,2020,"51",6045680,1432,305,1035,397,1127,5.04492464040439,6.56667240078866,0.383574879227053
"United States","Maryland","MD",2020-12-20,2020-12-26,7,2020,"52",6045680,1337,280,1044,293,1057,4.63140622725649,4.8464358020934,0.280651340996169
"United States","Maryland","MD",2020-12-27,2021-01-02,7,2020,"53",6045680,1478,275,1057,421,1203,4.54870254462691,6.96365007741065,0.398297067171239
"United States","Maryland","MD",2021-01-03,2021-01-09,7,2021,"1",6045680,1364,287,1058,306,1077,4.7471913829379,5.0614653769303,0.289224952741021
"United States","Maryland","MD",2021-01-10,2021-01-16,7,2021,"2",6045680,1426,271,1077,349,1155,4.48253959852324,5.77271704754469,0.324048282265552
"United States","Maryland","MD",2021-01-17,2021-01-23,7,2021,"3",6045680,1366,309,1071,295,1057,5.11108758650805,4.87951727514523,0.275443510737628
"United States","Maryland","MD",2021-01-24,2021-01-30,7,2021,"4",6045680,1321,286,1065,256,1035,4.73065064641198,4.2344285506345,0.24037558685446
"United States","Maryland","MD",2021-01-31,2021-02-06,7,2021,"5",6045680,1272,147,1065,207,1125,2.43148826930966,3.42393246086462,0.194366197183099
"United States","Maryland","MD",2021-02-07,2021-02-13,7,2021,"6",6045680,1295,202,1067,228,1093,3.34122877823504,3.77128792790885,0.213683223992502
"United States","Maryland","MD",2021-02-14,2021-02-20,7,2021,"7",6045680,1170,159,1049,121,1011,2.62997710762065,2.00142911963584,0.11534795042898
"United States","Maryland","MD",2021-02-21,2021-02-27,7,2021,"8",6045680,1176,164,1049,127,1012,2.71268079025023,2.10067353879134,0.121067683508103
"United States","Maryland","MD",2021-02-28,2021-03-06,7,2021,"9",6045680,1146,86,1049,97,1060,1.42250334122878,1.60445144301385,0.0924690181124881
"United States","Maryland","MD",2021-03-07,2021-03-13,7,2021,"10",6045680,1095,102,1047,48,993,1.68715512564343,0.793955353243969,0.0458452722063036
"United States","Maryland","MD",2021-03-14,2021-03-20,7,2021,"11",6045680,1149,122,1031,118,1027,2.01796985616176,1.95180691005809,0.114451988360815
"United States","Maryland","MD",2021-03-21,2021-03-27,7,2021,"12",6045680,1118,81,1024,94,1037,1.3397996585992,1.55482923343611,0.091796875
"United States","Maryland","MD",2021-03-28,2021-04-03,7,2021,"13",6045680,1069,81,1024,45,988,1.3397996585992,0.744333143666221,0.0439453125
"United States","Maryland","MD",2021-04-04,2021-04-10,7,2021,"14",6045680,1165,103,1006,159,1062,1.70369586216935,2.62997710762065,0.158051689860835
"United States","Maryland","MD",2021-04-11,2021-04-17,7,2021,"15",6045680,1042,101,1003,39,941,1.67061438911752,0.645088724510725,0.0388833499501495
"United States","Maryland","MD",2021-04-18,2021-04-24,7,2021,"16",6045680,1110,109,982,128,1001,1.80294028132485,2.11721427531725,0.130346232179226
"United States","Maryland","MD",2021-04-25,2021-05-01,7,2021,"17",6045680,1086,97,974,112,989,1.60445144301385,1.8525624909026,0.114989733059548
"United States","Maryland","MD",2021-05-02,2021-05-08,7,2021,"18",6045680,1023,110,953,70,913,1.81948101785076,1.15785155681412,0.0734522560335782
"United States","Maryland","MD",2021-05-09,2021-05-15,7,2021,"19",6045680,1058,71,947,111,987,1.17439229334004,1.83602175437668,0.117212249208025
"United States","Maryland","MD",2021-05-16,2021-05-22,7,2021,"20",6045680,1018,80,928,90,938,1.32325892207328,1.48866628733244,0.0969827586206897
"United States","Maryland","MD",2021-05-23,2021-05-29,7,2021,"21",6045680,1036,612,936,100,424,10.1229307538606,1.6540736525916,0.106837606837607
"United States","Maryland","MD",2021-05-30,2021-06-05,7,2021,"22",6045680,1028,41,933,95,987,0.678170197562557,1.57136996996202,0.101822079314041
"United States","Maryland","MD",2021-06-06,2021-06-12,7,2021,"23",6045680,903,48,934,-31,855,0.793955353243969,-0.512762832303397,-0.0331905781584583
"United States","Maryland","MD",2021-06-13,2021-06-19,7,2021,"24",6045680,956,33,936,20,923,0.545844305355229,0.330814730518321,0.0213675213675213
"United States","Maryland","MD",2021-06-20,2021-06-26,7,2021,"25",6045680,922,30,943,-21,892,0.496222095777481,-0.347355467044237,-0.0222693531283139
"United States","Maryland","MD",2021-06-27,2021-07-03,7,2021,"26",6045680,987,17,935,52,970,0.281192520940572,0.860118299347633,0.0556149732620321
"United States","Maryland","MD",2021-07-04,2021-07-10,7,2021,"27",6045680,890,15,940,-50,875,0.24811104788874,-0.827036826295801,-0.0531914893617021
"United States","Maryland","MD",2021-07-11,2021-07-17,7,2021,"28",6045680,941,18,935,6,923,0.297733257466488,0.0992444191554961,0.00641711229946518
"United States","Maryland","MD",2021-07-18,2021-07-24,7,2021,"29",6045680,937,23,934,3,914,0.380436940096069,0.0496222095777481,0.00321199143468953
"United States","Maryland","MD",2021-07-25,2021-07-31,7,2021,"30",6045680,952,15,929,23,937,0.24811104788874,0.380436940096069,0.0247578040904197
"United States","Maryland","MD",2021-08-01,2021-08-07,7,2021,"31",6045680,955,27,928,27,928,0.446599886199733,0.446599886199733,0.0290948275862069
"United States","Maryland","MD",2021-08-08,2021-08-14,7,2021,"32",6045680,973,31,927,46,942,0.512762832303397,0.760873880192137,0.0496224379719525
"United States","Maryland","MD",2021-08-15,2021-08-21,7,2021,"33",6045680,925,3,928,-3,922,0.0496222095777481,-0.0496222095777481,-0.00323275862068961
"United States","Massachusetts","MA",2019-12-29,2020-01-04,7,2020,"1",6949503,1242,0,1378,-136,1242,0,-1.95697447716765,-0.0986937590711175
"United States","Massachusetts","MA",2020-01-05,2020-01-11,7,2020,"2",6949503,1266,0,1378,-112,1266,0,-1.61162604002042,-0.081277213352685
"United States","Massachusetts","MA",2020-01-12,2020-01-18,7,2020,"3",6949503,1189,0,1405,-216,1189,0,-3.10813593432509,-0.15373665480427
"United States","Massachusetts","MA",2020-01-19,2020-01-25,7,2020,"4",6949503,1303,0,1360,-57,1303,0,-0.820202538224676,-0.0419117647058823
"United States","Massachusetts","MA",2020-01-26,2020-02-01,7,2020,"5",6949503,1204,0,1342,-138,1204,0,-1.98575351359658,-0.102831594634873
"United States","Massachusetts","MA",2020-02-02,2020-02-08,7,2020,"6",6949503,1233,0,1305,-72,1233,0,-1.0360453114417,-0.0551724137931034
"United States","Massachusetts","MA",2020-02-09,2020-02-15,7,2020,"7",6949503,1251,0,1296,-45,1251,0,-0.64752831965106,-0.0347222222222222
"United States","Massachusetts","MA",2020-02-16,2020-02-22,7,2020,"8",6949503,1166,0,1282,-116,1166,0,-1.66918411287829,-0.0904836193447738
"United States","Massachusetts","MA",2020-02-23,2020-02-29,7,2020,"9",6949503,1278,0,1256,22,1278,0,0.316569400718296,0.0175159235668789
"United States","Massachusetts","MA",2020-03-01,2020-03-07,7,2020,"10",6949503,1216,0,1250,-34,1216,0,-0.489243619291912,-0.0272
"United States","Massachusetts","MA",2020-03-08,2020-03-14,7,2020,"11",6949503,1311,0,1238,73,1311,0,1.05043482965616,0.0589660743134088
"United States","Massachusetts","MA",2020-03-15,2020-03-21,7,2020,"12",6949503,1170,2,1236,-66,1168,0.028779036428936,-0.949708202154888,-0.0533980582524272
"United States","Massachusetts","MA",2020-03-22,2020-03-28,7,2020,"13",6949503,1290,42,1231,59,1248,0.604359765007656,0.848981574653612,0.0479285134037368
"United States","Massachusetts","MA",2020-03-29,2020-04-04,7,2020,"14",6949503,1549,172,1218,331,1377,2.4749971328885,4.76293052898891,0.27175697865353
"United States","Massachusetts","MA",2020-04-05,2020-04-11,7,2020,"15",6949503,2038,470,1199,839,1568,6.76307356079996,12.0728057819387,0.699749791492911
"United States","Massachusetts","MA",2020-04-12,2020-04-18,7,2020,"16",6949503,2494,874,1198,1296,1620,12.576438919445,18.6488156059505,1.08180300500835
"United States","Massachusetts","MA",2020-04-19,2020-04-25,7,2020,"17",6949503,2535,1170,1184,1351,1365,16.8357363109276,19.4402391077463,1.1410472972973
"United States","Massachusetts","MA",2020-04-26,2020-05-02,7,2020,"18",6949503,2310,1116,1166,1144,1194,16.0587023273463,16.4616088373514,0.981132075471698
"United States","Massachusetts","MA",2020-05-03,2020-05-09,7,2020,"19",6949503,2071,994,1137,934,1077,14.3031811051812,13.4398100123131,0.821459982409851
"United States","Massachusetts","MA",2020-05-10,2020-05-16,7,2020,"20",6949503,1886,865,1135,751,1021,12.4469332555148,10.8065281790655,0.661674008810573
"United States","Massachusetts","MA",2020-05-17,2020-05-23,7,2020,"21",6949503,1578,599,1124,454,979,8.61932141046633,6.53284126936847,0.403914590747331
"United States","Massachusetts","MA",2020-05-24,2020-05-30,7,2020,"22",6949503,1360,464,1112,248,896,6.67673645151315,3.56860051718806,0.223021582733813
"United States","Massachusetts","MA",2020-05-31,2020-06-06,7,2020,"23",6949503,1236,521,1113,123,715,7.49693898973783,1.76991074037956,0.110512129380054
"United States","Massachusetts","MA",2020-06-07,2020-06-13,7,2020,"24",6949503,1140,287,1103,37,853,4.12979172755232,0.532412173935316,0.0335448776065277
"United States","Massachusetts","MA",2020-06-14,2020-06-20,7,2020,"25",6949503,1129,251,1104,25,878,3.61176907183147,0.3597379553617,0.0226449275362319
"United States","Massachusetts","MA",2020-06-21,2020-06-27,7,2020,"26",6949503,1084,214,1099,-15,870,3.07935689789615,-0.21584277321702,-0.013648771610555
"United States","Massachusetts","MA",2020-06-28,2020-07-04,7,2020,"27",6949503,1048,130,1100,-52,918,1.87063736788084,-0.748254947152336,-0.0472727272727272
"United States","Massachusetts","MA",2020-07-05,2020-07-11,7,2020,"28",6949503,1047,139,1093,-46,908,2.00014303181105,-0.661917837865528,-0.0420860018298261
"United States","Massachusetts","MA",2020-07-12,2020-07-18,7,2020,"29",6949503,1060,109,1091,-31,951,1.56845748537701,-0.446075064648508,-0.0284142988084326
"United States","Massachusetts","MA",2020-07-19,2020-07-25,7,2020,"30",6949503,1089,91,1086,3,998,1.30944615751659,0.043168554643404,0.00276243093922646
"United States","Massachusetts","MA",2020-07-26,2020-08-01,7,2020,"31",6949503,1022,116,1078,-56,906,1.66918411287829,-0.805813020010208,-0.051948051948052
"United States","Massachusetts","MA",2020-08-02,2020-08-08,7,2020,"32",6949503,996,95,1080,-84,901,1.36700423037446,-1.20871953001531,-0.0777777777777777
"United States","Massachusetts","MA",2020-08-09,2020-08-15,7,2020,"33",6949503,1049,99,1074,-25,950,1.42456230323233,-0.3597379553617,-0.0232774674115456
"United States","Massachusetts","MA",2020-08-16,2020-08-22,7,2020,"34",6949503,1037,101,1079,-42,936,1.45334133966127,-0.604359765007656,-0.0389249304911955
"United States","Massachusetts","MA",2020-08-23,2020-08-29,7,2020,"35",6949503,1059,115,1074,-15,944,1.65479459466382,-0.21584277321702,-0.0139664804469274
"United States","Massachusetts","MA",2020-08-30,2020-09-05,7,2020,"36",6949503,1014,80,1083,-69,934,1.15116145715744,-0.992876756798292,-0.0637119113573407
"United States","Massachusetts","MA",2020-09-06,2020-09-12,7,2020,"37",6949503,1012,80,1074,-62,932,1.15116145715744,-0.892150129297016,-0.0577281191806331
"United States","Massachusetts","MA",2020-09-13,2020-09-19,7,2020,"38",6949503,1094,99,1079,15,995,1.42456230323233,0.21584277321702,0.0139017608897127
"United States","Massachusetts","MA",2020-09-20,2020-09-26,7,2020,"39",6949503,1125,96,1093,32,1029,1.38139374858893,0.460464582862976,0.0292772186642269
"United States","Massachusetts","MA",2020-09-27,2020-10-03,7,2020,"40",6949503,1105,116,1101,4,989,1.66918411287829,0.057558072857872,0.00363306085376935
"United States","Massachusetts","MA",2020-10-04,2020-10-10,7,2020,"41",6949503,1101,80,1107,-6,1021,1.15116145715744,-0.086337109286808,-0.00542005420054203
"United States","Massachusetts","MA",2020-10-11,2020-10-17,7,2020,"42",6949503,1131,136,1123,8,995,1.95697447716765,0.115116145715744,0.00712377560106847
"United States","Massachusetts","MA",2020-10-18,2020-10-24,7,2020,"43",6949503,1196,116,1132,64,1080,1.66918411287829,0.920929165725952,0.0565371024734982
"United States","Massachusetts","MA",2020-10-25,2020-10-31,7,2020,"44",6949503,1089,152,1142,-53,937,2.18720676859914,-0.762644465366804,-0.0464098073555166
"United States","Massachusetts","MA",2020-11-01,2020-11-07,7,2020,"45",6949503,1218,134,1152,66,1084,1.92819544073871,0.949708202154888,0.0572916666666667
"United States","Massachusetts","MA",2020-11-08,2020-11-14,7,2020,"46",6949503,1234,168,1151,83,1066,2.41743906003062,1.19433001180084,0.0721112076455257
"United States","Massachusetts","MA",2020-11-15,2020-11-21,7,2020,"47",6949503,1214,195,1163,51,1019,2.80595605182126,0.733865428937868,0.0438521066208082
"United States","Massachusetts","MA",2020-11-22,2020-11-28,7,2020,"48",6949503,1261,188,1156,105,1073,2.70522942431998,1.51089941251914,0.0908304498269896
"United States","Massachusetts","MA",2020-11-29,2020-12-05,7,2020,"49",6949503,1331,277,1167,164,1054,3.98589654540764,2.35988098717275,0.140531276778063
"United States","Massachusetts","MA",2020-12-06,2020-12-12,7,2020,"50",6949503,1351,354,1183,168,997,5.09388944792167,2.41743906003062,0.142011834319527
"United States","Massachusetts","MA",2020-12-13,2020-12-19,7,2020,"51",6949503,1426,350,1207,219,1076,5.0363313750638,3.15130448896849,0.181441590720795
"United States","Massachusetts","MA",2020-12-20,2020-12-26,7,2020,"52",6949503,1552,60,1201,351,1492,0.86337109286808,5.05072089327827,0.29225645295587
"United States","Massachusetts","MA",2020-12-27,2021-01-02,7,2020,"53",6949503,1524,785,1245,279,739,11.2957717983574,4.01467558183657,0.224096385542169
"United States","Massachusetts","MA",2021-01-03,2021-01-09,7,2021,"1",6949503,1556,572,1256,300,984,8.2308044186757,4.3168554643404,0.238853503184713
"United States","Massachusetts","MA",2021-01-10,2021-01-16,7,2021,"2",6949503,1558,509,1260,298,1049,7.32426477116421,4.28807642791146,0.236507936507937
"United States","Massachusetts","MA",2021-01-17,2021-01-23,7,2021,"3",6949503,1524,481,1273,251,1043,6.92135826115911,3.61176907183147,0.197172034564022
"United States","Massachusetts","MA",2021-01-24,2021-01-30,7,2021,"4",6949503,1569,467,1264,305,1102,6.71990500615656,4.38880305541274,0.24129746835443
"United States","Massachusetts","MA",2021-01-31,2021-02-06,7,2021,"5",6949503,1502,390,1246,256,1112,5.61191210364252,3.68371666290381,0.20545746388443
"United States","Massachusetts","MA",2021-02-07,2021-02-13,7,2021,"6",6949503,1362,503,1244,118,859,7.2379276618774,1.69796314930722,0.094855305466238
"United States","Massachusetts","MA",2021-02-14,2021-02-20,7,2021,"7",6949503,1342,355,1239,103,987,5.10827896613614,1.4821203760902,0.0831315577078289
"United States","Massachusetts","MA",2021-02-21,2021-02-27,7,2021,"8",6949503,1267,288,1224,43,979,4.14418124576678,0.618749283222124,0.0351307189542485
"United States","Massachusetts","MA",2021-02-28,2021-03-06,7,2021,"9",6949503,1217,307,1197,20,910,4.41758209184168,0.28779036428936,0.0167084377610693
"United States","Massachusetts","MA",2021-03-07,2021-03-13,7,2021,"10",6949503,1211,206,1183,28,1005,2.96424075218041,0.402906510005104,0.0236686390532543
"United States","Massachusetts","MA",2021-03-14,2021-03-20,7,2021,"11",6949503,1211,252,1182,29,959,3.62615859004594,0.417296028219572,0.0245346869712353
"United States","Massachusetts","MA",2021-03-21,2021-03-27,7,2021,"12",6949503,1172,219,1177,-5,953,3.15130448896849,-0.07194759107234,-0.00424808836023793
"United States","Massachusetts","MA",2021-03-28,2021-04-03,7,2021,"13",6949503,1128,230,1174,-46,898,3.30958918932764,-0.661917837865528,-0.0391822827938672
"United States","Massachusetts","MA",2021-04-04,2021-04-10,7,2021,"14",6949503,1122,98,1172,-50,1024,1.41017278501786,-0.7194759107234,-0.0426621160409556
"United States","Massachusetts","MA",2021-04-11,2021-04-17,7,2021,"15",6949503,1145,76,1149,-4,1069,1.09360338429957,-0.057558072857872,-0.00348128807658832
"United States","Massachusetts","MA",2021-04-18,2021-04-24,7,2021,"16",6949503,1109,89,1142,-33,1020,1.28066712108765,-0.474854101077444,-0.0288966725043783
"United States","Massachusetts","MA",2021-04-25,2021-05-01,7,2021,"17",6949503,1122,73,1118,4,1049,1.05043482965616,0.057558072857872,0.00357781753130593
"United States","Massachusetts","MA",2021-05-02,2021-05-08,7,2021,"18",6949503,1145,59,1100,45,1086,0.848981574653612,0.64752831965106,0.040909090909091
"United States","Massachusetts","MA",2021-05-09,2021-05-15,7,2021,"19",6949503,1109,66,1095,14,1043,0.949708202154888,0.201453255002552,0.0127853881278539
"United States","Massachusetts","MA",2021-05-16,2021-05-22,7,2021,"20",6949503,1169,76,1091,78,1093,1.09360338429957,1.1223824207285,0.0714940421631531
"United States","Massachusetts","MA",2021-05-23,2021-05-29,7,2021,"21",6949503,1076,50,1082,-6,1026,0.7194759107234,-0.086337109286808,-0.00554528650646946
"United States","Massachusetts","MA",2021-05-30,2021-06-05,7,2021,"22",6949503,1084,39,1080,4,1045,0.561191210364252,0.057558072857872,0.00370370370370376
"United States","Massachusetts","MA",2021-06-06,2021-06-12,7,2021,"23",6949503,1089,30,1078,11,1059,0.43168554643404,0.158284700359148,0.010204081632653
"United States","Massachusetts","MA",2021-06-13,2021-06-19,7,2021,"24",6949503,1023,23,1078,-55,1000,0.330958918932764,-0.79142350179574,-0.0510204081632653
"United States","Massachusetts","MA",2021-06-20,2021-06-26,7,2021,"25",6949503,1068,25,1073,-5,1043,0.3597379553617,-0.07194759107234,-0.00465983224603916
"United States","Massachusetts","MA",2021-06-27,2021-07-03,7,2021,"26",6949503,1063,12,1078,-15,1051,0.172674218573616,-0.21584277321702,-0.0139146567717996
"United States","Massachusetts","MA",2021-07-04,2021-07-10,7,2021,"27",6949503,1141,15,1074,67,1126,0.21584277321702,0.964097720369356,0.0623836126629422
"United States","Massachusetts","MA",2021-07-11,2021-07-17,7,2021,"28",6949503,1034,8,1066,-32,1026,0.115116145715744,-0.460464582862976,-0.0300187617260788
"United States","Massachusetts","MA",2021-07-18,2021-07-24,7,2021,"29",6949503,1124,26,1070,54,1098,0.374127473576168,0.777033983581272,0.0504672897196261
"United States","Massachusetts","MA",2021-07-25,2021-07-31,7,2021,"30",6949503,1122,36,1056,66,1086,0.518022655720848,0.949708202154888,0.0625
"United States","Massachusetts","MA",2021-08-01,2021-08-07,7,2021,"31",6949503,1147,13,1066,81,1134,0.187063736788084,1.16555097537191,0.075984990619137
"United States","Massachusetts","MA",2021-08-08,2021-08-14,7,2021,"32",6949503,1099,47,1064,35,1052,0.676307356079996,0.50363313750638,0.0328947368421053
"United States","Massachusetts","MA",2021-08-15,2021-08-21,7,2021,"33",6949503,1100,5,1069,31,1095,0.07194759107234,0.446075064648508,0.028999064546305
"United States","Michigan","MI",2019-12-29,2020-01-04,7,2020,"1",9986857,2015,0,2132,-117,2015,0,-1.1715397546996,-0.0548780487804879
"United States","Michigan","MI",2020-01-05,2020-01-11,7,2020,"2",9986857,2065,0,2153,-88,2065,0,-0.881158106098846,-0.0408732001857873
"United States","Michigan","MI",2020-01-12,2020-01-18,7,2020,"3",9986857,1936,0,2143,-207,1936,0,-2.0727241813916,-0.0965935604293047
"United States","Michigan","MI",2020-01-19,2020-01-25,7,2020,"4",9986857,2012,0,2120,-108,2012,0,-1.0814213120304,-0.0509433962264151
"United States","Michigan","MI",2020-01-26,2020-02-01,7,2020,"5",9986857,2004,0,2090,-86,2004,0,-0.86113178550569,-0.0411483253588517
"United States","Michigan","MI",2020-02-02,2020-02-08,7,2020,"6",9986857,1940,0,2068,-128,1940,0,-1.28168451796196,-0.0618955512572534
"United States","Michigan","MI",2020-02-09,2020-02-15,7,2020,"7",9986857,2014,0,2054,-40,2014,0,-0.400526411863112,-0.0194741966893865
"United States","Michigan","MI",2020-02-16,2020-02-22,7,2020,"8",9986857,2056,0,2047,9,2056,0,0.0901184426692001,0.00439667806546162
"United States","Michigan","MI",2020-02-23,2020-02-29,7,2020,"9",9986857,1973,0,2027,-54,1973,0,-0.540710656015201,-0.0266403552047361
"United States","Michigan","MI",2020-03-01,2020-03-07,7,2020,"10",9986857,1988,0,2016,-28,1988,0,-0.280368488304178,-0.0138888888888888
"United States","Michigan","MI",2020-03-08,2020-03-14,7,2020,"11",9986857,1955,0,2010,-55,1955,0,-0.550723816311779,-0.027363184079602
"United States","Michigan","MI",2020-03-15,2020-03-21,7,2020,"12",9986857,2036,5,2006,30,2031,0.050065801482889,0.300394808897334,0.0149551345962113
"United States","Michigan","MI",2020-03-22,2020-03-28,7,2020,"13",9986857,2432,99,2009,423,2333,0.991302869361201,4.23556680545241,0.210552513688402
"United States","Michigan","MI",2020-03-29,2020-04-04,7,2020,"14",9986857,3117,436,1992,1125,2681,4.36573788930792,11.26480533365,0.564759036144578
"United States","Michigan","MI",2020-04-05,2020-04-11,7,2020,"15",9986857,3385,851,1969,1416,2534,8.5211994123877,14.1786349799542,0.719146775012697
"United States","Michigan","MI",2020-04-12,2020-04-18,7,2020,"16",9986857,3159,918,1950,1209,2241,9.19208115225841,12.1059107985626,0.62
"United States","Michigan","MI",2020-04-19,2020-04-25,7,2020,"17",9986857,2806,966,1922,884,1840,9.67271284649415,8.85163370217477,0.45993756503642
"United States","Michigan","MI",2020-04-26,2020-05-02,7,2020,"18",9986857,2588,745,1888,700,1843,7.45980442095046,7.00921220760446,0.370762711864407
"United States","Michigan","MI",2020-05-03,2020-05-09,7,2020,"19",9986857,2241,505,1841,400,1736,5.05664594977179,4.00526411863112,0.217273221075502
"United States","Michigan","MI",2020-05-10,2020-05-16,7,2020,"20",9986857,2160,354,1830,330,1806,3.54465874498854,3.30434289787067,0.180327868852459
"United States","Michigan","MI",2020-05-17,2020-05-23,7,2020,"21",9986857,2012,340,1811,201,1672,3.40447450083645,2.01264521961214,0.110988404196577
"United States","Michigan","MI",2020-05-24,2020-05-30,7,2020,"22",9986857,1962,244,1809,153,1718,2.44321111236498,1.5320135253764,0.0845771144278606
"United States","Michigan","MI",2020-05-31,2020-06-06,7,2020,"23",9986857,2000,426,1808,192,1574,4.26560628634214,1.92252677694294,0.106194690265487
"United States","Michigan","MI",2020-06-07,2020-06-13,7,2020,"24",9986857,1860,122,1792,68,1738,1.22160555618249,0.68089490016729,0.0379464285714286
"United States","Michigan","MI",2020-06-14,2020-06-20,7,2020,"25",9986857,1885,75,1797,88,1810,0.750987022243334,0.881158106098846,0.0489705063995549
"United States","Michigan","MI",2020-06-21,2020-06-27,7,2020,"26",9986857,1918,67,1792,126,1851,0.670881739870712,1.2616581973688,0.0703125
"United States","Michigan","MI",2020-06-28,2020-07-04,7,2020,"27",9986857,1984,65,1779,205,1919,0.650855419277557,2.05269786079845,0.115233277121979
"United States","Michigan","MI",2020-07-05,2020-07-11,7,2020,"28",9986857,1890,95,1764,126,1795,0.95125022817489,1.2616581973688,0.0714285714285714
"United States","Michigan","MI",2020-07-12,2020-07-18,7,2020,"29",9986857,1879,51,1758,121,1828,0.510671175125467,1.21159239588591,0.0688282138794085
"United States","Michigan","MI",2020-07-19,2020-07-25,7,2020,"30",9986857,1891,36,1760,131,1855,0.360473770676801,1.31172399885169,0.0744318181818182
"United States","Michigan","MI",2020-07-26,2020-08-01,7,2020,"31",9986857,1969,57,1767,202,1912,0.570750136904934,2.02265837990871,0.11431805319751
"United States","Michigan","MI",2020-08-02,2020-08-08,7,2020,"32",9986857,1868,63,1777,91,1805,0.630829098684401,0.911197586988579,0.0512099043331458
"United States","Michigan","MI",2020-08-09,2020-08-15,7,2020,"33",9986857,2025,66,1768,257,1959,0.660868579574134,2.57338219622049,0.145361990950226
"United States","Michigan","MI",2020-08-16,2020-08-22,7,2020,"34",9986857,1926,69,1765,161,1857,0.690908060463868,1.61211880774902,0.0912181303116146
"United States","Michigan","MI",2020-08-23,2020-08-29,7,2020,"35",9986857,1936,57,1759,177,1879,0.570750136904934,1.77232937249427,0.10062535531552
"United States","Michigan","MI",2020-08-30,2020-09-05,7,2020,"36",9986857,1959,94,1761,198,1865,0.941237067878313,1.9826057387224,0.112436115843271
"United States","Michigan","MI",2020-09-06,2020-09-12,7,2020,"37",9986857,1942,105,1761,181,1837,1.05138183114067,1.81238201368058,0.102782509937535
"United States","Michigan","MI",2020-09-13,2020-09-19,7,2020,"38",9986857,1905,58,1781,124,1847,0.580763297201512,1.24163187677565,0.0696238068500843
"United States","Michigan","MI",2020-09-20,2020-09-26,7,2020,"39",9986857,2006,75,1790,216,1931,0.750987022243334,2.1628426240608,0.120670391061453
"United States","Michigan","MI",2020-09-27,2020-10-03,7,2020,"40",9986857,2033,80,1805,228,1953,0.801052823726223,2.28300054761974,0.126315789473684
"United States","Michigan","MI",2020-10-04,2020-10-10,7,2020,"41",9986857,2146,95,1813,333,2051,0.95125022817489,3.3343823787604,0.183673469387755
"United States","Michigan","MI",2020-10-11,2020-10-17,7,2020,"42",9986857,2029,121,1825,204,1908,1.21159239588591,2.04268470050187,0.111780821917808
"United States","Michigan","MI",2020-10-18,2020-10-24,7,2020,"43",9986857,2207,182,1841,366,2025,1.82239517397716,3.66481666854747,0.198804997284085
"United States","Michigan","MI",2020-10-25,2020-10-31,7,2020,"44",9986857,2176,174,1834,342,2002,1.74228989160454,3.4245008214296,0.186477644492912
"United States","Michigan","MI",2020-11-01,2020-11-07,7,2020,"45",9986857,2347,181,1842,505,2166,1.81238201368058,5.05664594977179,0.274158523344191
"United States","Michigan","MI",2020-11-08,2020-11-14,7,2020,"46",9986857,2427,494,1843,584,1933,4.94650118650943,5.84768561320143,0.316874660879002
"United States","Michigan","MI",2020-11-15,2020-11-21,7,2020,"47",9986857,2623,503,1855,768,2120,5.03661962917863,7.69010710777174,0.414016172506739
"United States","Michigan","MI",2020-11-22,2020-11-28,7,2020,"48",9986857,2661,588,1858,803,2073,5.88773825438774,8.04056771815197,0.432185145317546
"United States","Michigan","MI",2020-11-29,2020-12-05,7,2020,"49",9986857,2805,855,1871,934,1950,8.56125205357401,9.35229171700366,0.499198289684661
"United States","Michigan","MI",2020-12-06,2020-12-12,7,2020,"50",9986857,2958,878,1872,1086,2080,8.7915547403953,10.8742920820835,0.580128205128205
"United States","Michigan","MI",2020-12-13,2020-12-19,7,2020,"51",9986857,2766,878,1888,878,1888,8.7915547403953,8.7915547403953,0.465042372881356
"United States","Michigan","MI",2020-12-20,2020-12-26,7,2020,"52",9986857,2633,616,1912,721,2017,6.16810674269192,7.21948857383259,0.377092050209205
"United States","Michigan","MI",2020-12-27,2021-01-02,7,2020,"53",9986857,2553,615,1939,614,1938,6.15809358239534,6.14808042209876,0.316658071170707
"United States","Michigan","MI",2021-01-03,2021-01-09,7,2021,"1",9986857,2354,841,1970,384,1513,8.42106780942192,3.84505355388587,0.19492385786802
"United States","Michigan","MI",2021-01-10,2021-01-16,7,2021,"2",9986857,2391,509,1990,401,1882,5.0966985909581,4.01527727892769,0.201507537688442
"United States","Michigan","MI",2021-01-17,2021-01-23,7,2021,"3",9986857,2342,524,1988,354,1818,5.24689599540676,3.54465874498854,0.178068410462777
"United States","Michigan","MI",2021-01-24,2021-01-30,7,2021,"4",9986857,2188,347,1993,195,1841,3.47456662291249,1.95256625783267,0.0978424485699949
"United States","Michigan","MI",2021-01-31,2021-02-06,7,2021,"5",9986857,2287,331,1982,305,1956,3.31435605816725,3.05401389045623,0.153884964682139
"United States","Michigan","MI",2021-02-07,2021-02-13,7,2021,"6",9986857,2080,265,1976,104,1815,2.65348747859312,1.04136867084409,0.0526315789473684
"United States","Michigan","MI",2021-02-14,2021-02-20,7,2021,"7",9986857,2099,222,1967,132,1877,2.22292158584027,1.32173715914827,0.067107269954245
"United States","Michigan","MI",2021-02-21,2021-02-27,7,2021,"8",9986857,2062,166,1966,96,1896,1.66218460923191,0.961263388471468,0.0488301119023398
"United States","Michigan","MI",2021-02-28,2021-03-06,7,2021,"9",9986857,2019,151,1967,52,1868,1.51198720478325,0.520684335422045,0.0264361972547027
"United States","Michigan","MI",2021-03-07,2021-03-13,7,2021,"10",9986857,1861,115,1953,-92,1746,1.15151343410645,-0.921210747285157,-0.0471070148489503
"United States","Michigan","MI",2021-03-14,2021-03-20,7,2021,"11",9986857,2031,134,1939,92,1897,1.34176347974142,0.921210747285157,0.0474471376998453
"United States","Michigan","MI",2021-03-21,2021-03-27,7,2021,"12",9986857,2109,141,1943,166,1968,1.41185560181747,1.66218460923191,0.0854348944930521
"United States","Michigan","MI",2021-03-28,2021-04-03,7,2021,"13",9986857,2071,210,1940,131,1861,2.10276366228134,1.31172399885169,0.0675257731958763
"United States","Michigan","MI",2021-04-04,2021-04-10,7,2021,"14",9986857,2353,303,1929,424,2050,3.03398756986307,4.24557996574898,0.219803006739243
"United States","Michigan","MI",2021-04-11,2021-04-17,7,2021,"15",9986857,2302,371,1924,378,1931,3.71488247003036,3.78497459210641,0.196465696465697
"United States","Michigan","MI",2021-04-18,2021-04-24,7,2021,"16",9986857,2433,475,1905,528,1958,4.75625114087445,5.28694863659307,0.277165354330709
"United States","Michigan","MI",2021-04-25,2021-05-01,7,2021,"17",9986857,2356,484,1883,473,1872,4.84636958354365,4.7362248202813,0.251194901752523
"United States","Michigan","MI",2021-05-02,2021-05-08,7,2021,"18",9986857,2283,484,1866,417,1799,4.84636958354365,4.17548784367294,0.223472668810289
"United States","Michigan","MI",2021-05-09,2021-05-15,7,2021,"19",9986857,2205,413,1835,370,1792,4.13543520248663,3.70486930973378,0.201634877384196
"United States","Michigan","MI",2021-05-16,2021-05-22,7,2021,"20",9986857,2248,350,1832,416,1898,3.50460610380223,4.16547468337636,0.22707423580786
"United States","Michigan","MI",2021-05-23,2021-05-29,7,2021,"21",9986857,2048,236,1809,239,1812,2.36310582999236,2.39314531088209,0.132117191818684
"United States","Michigan","MI",2021-05-30,2021-06-05,7,2021,"22",9986857,2012,212,1808,204,1800,2.12278998287449,2.04268470050187,0.11283185840708
"United States","Michigan","MI",2021-06-06,2021-06-12,7,2021,"23",9986857,2029,190,1806,223,1839,1.90250045634978,2.23293474613685,0.123477297895902
"United States","Michigan","MI",2021-06-13,2021-06-19,7,2021,"24",9986857,1949,84,1811,138,1865,0.841105464912534,1.38181612092774,0.0762009939260078
"United States","Michigan","MI",2021-06-20,2021-06-26,7,2021,"25",9986857,2001,97,1817,184,1904,0.971276548768046,1.84242149457031,0.10126582278481
"United States","Michigan","MI",2021-06-27,2021-07-03,7,2021,"26",9986857,1967,50,1821,146,1917,0.50065801482889,1.46192140330036,0.0801757276221857
"United States","Michigan","MI",2021-07-04,2021-07-10,7,2021,"27",9986857,2026,50,1813,213,1976,0.50065801482889,2.13280314317107,0.117484831770546
"United States","Michigan","MI",2021-07-11,2021-07-17,7,2021,"28",9986857,1998,50,1796,202,1948,0.50065801482889,2.02265837990871,0.112472160356347
"United States","Michigan","MI",2021-07-18,2021-07-24,7,2021,"29",9986857,2040,37,1804,236,2003,0.370486930973378,2.36310582999236,0.130820399113082
"United States","Michigan","MI",2021-07-25,2021-07-31,7,2021,"30",9986857,2017,42,1794,223,1975,0.420552732456267,2.23293474613685,0.124303232998885
"United States","Michigan","MI",2021-08-01,2021-08-07,7,2021,"31",9986857,2104,33,1795,309,2071,0.330434289787067,3.09406653164254,0.172144846796657
"United States","Michigan","MI",2021-08-08,2021-08-14,7,2021,"32",9986857,2094,63,1775,319,2031,0.630829098684401,3.19419813460832,0.179718309859155
"United States","Michigan","MI",2021-08-15,2021-08-21,7,2021,"33",9986857,2107,20,1789,318,2087,0.200263205931556,3.18418497431174,0.177752934600335
"United States","Minnesota","MN",2019-12-29,2020-01-04,7,2020,"1",5639632,1009,0,1004,5,1009,0,0.088658267064234,0.0049800796812749
"United States","Minnesota","MN",2020-01-05,2020-01-11,7,2020,"2",5639632,950,0,993,-43,950,0,-0.762461096752412,-0.0433031218529708
"United States","Minnesota","MN",2020-01-12,2020-01-18,7,2020,"3",5639632,946,0,989,-43,946,0,-0.762461096752412,-0.0434782608695652
"United States","Minnesota","MN",2020-01-19,2020-01-25,7,2020,"4",5639632,955,0,963,-8,955,0,-0.141853227302774,-0.00830737279335414
"United States","Minnesota","MN",2020-01-26,2020-02-01,7,2020,"5",5639632,942,0,959,-17,942,0,-0.301438108018395,-0.0177267987486965
"United States","Minnesota","MN",2020-02-02,2020-02-08,7,2020,"6",5639632,919,0,957,-38,919,0,-0.673802829688178,-0.0397074190177639
"United States","Minnesota","MN",2020-02-09,2020-02-15,7,2020,"7",5639632,941,0,944,-3,941,0,-0.0531949602385404,-0.00317796610169496
"United States","Minnesota","MN",2020-02-16,2020-02-22,7,2020,"8",5639632,913,0,933,-20,913,0,-0.354633068256936,-0.0214362272240086
"United States","Minnesota","MN",2020-02-23,2020-02-29,7,2020,"9",5639632,933,0,926,7,933,0,0.124121573889928,0.00755939524838012
"United States","Minnesota","MN",2020-03-01,2020-03-07,7,2020,"10",5639632,944,0,917,27,944,0,0.478754642146863,0.029443838604144
"United States","Minnesota","MN",2020-03-08,2020-03-14,7,2020,"11",5639632,882,0,905,-23,882,0,-0.407828028495476,-0.025414364640884
"United States","Minnesota","MN",2020-03-15,2020-03-21,7,2020,"12",5639632,894,1,895,-1,893,0.0177316534128468,-0.0177316534128468,-0.00111731843575424
"United States","Minnesota","MN",2020-03-22,2020-03-28,7,2020,"13",5639632,909,4,902,7,905,0.0709266136513872,0.124121573889928,0.0077605321507761
"United States","Minnesota","MN",2020-03-29,2020-04-04,7,2020,"14",5639632,928,19,906,22,909,0.336901414844089,0.390096375082629,0.0242825607064017
"United States","Minnesota","MN",2020-04-05,2020-04-11,7,2020,"15",5639632,943,40,905,38,903,0.709266136513872,0.673802829688178,0.0419889502762432
"United States","Minnesota","MN",2020-04-12,2020-04-18,7,2020,"16",5639632,955,57,893,62,898,1.01070424453227,1.0993625115965,0.0694288913773795
"United States","Minnesota","MN",2020-04-19,2020-04-25,7,2020,"17",5639632,1016,122,889,127,894,2.16326171636731,2.25191998343154,0.142857142857143
"United States","Minnesota","MN",2020-04-26,2020-05-02,7,2020,"18",5639632,1042,150,867,175,892,2.65974801192702,3.10303934724819,0.201845444059977
"United States","Minnesota","MN",2020-05-03,2020-05-09,7,2020,"19",5639632,1057,164,860,197,893,2.90799115970687,3.49313572233082,0.22906976744186
"United States","Minnesota","MN",2020-05-10,2020-05-16,7,2020,"20",5639632,1000,141,852,148,859,2.5001631312114,2.62428470510133,0.173708920187793
"United States","Minnesota","MN",2020-05-17,2020-05-23,7,2020,"21",5639632,1005,150,850,155,855,2.65974801192702,2.74840627899125,0.182352941176471
"United States","Minnesota","MN",2020-05-24,2020-05-30,7,2020,"22",5639632,1017,176,841,176,841,3.12077100066104,3.12077100066104,0.209274673008323
"United States","Minnesota","MN",2020-05-31,2020-06-06,7,2020,"23",5639632,1038,143,827,211,895,2.53562643803709,3.74137887011067,0.255139056831923
"United States","Minnesota","MN",2020-06-07,2020-06-13,7,2020,"24",5639632,973,114,813,160,859,2.02140848906453,2.83706454605549,0.19680196801968
"United States","Minnesota","MN",2020-06-14,2020-06-20,7,2020,"25",5639632,941,91,823,118,850,1.61358046056906,2.09233510271592,0.143377885783718
"United States","Minnesota","MN",2020-06-21,2020-06-27,7,2020,"26",5639632,840,45,823,17,795,0.797924403578106,0.301438108018395,0.0206561360874848
"United States","Minnesota","MN",2020-06-28,2020-07-04,7,2020,"27",5639632,876,49,819,57,827,0.868851017229493,1.01070424453227,0.0695970695970696
"United States","Minnesota","MN",2020-07-05,2020-07-11,7,2020,"28",5639632,865,33,830,35,832,0.585144562623944,0.620607869449638,0.0421686746987953
"United States","Minnesota","MN",2020-07-12,2020-07-18,7,2020,"29",5639632,869,39,831,38,830,0.691534483101025,0.673802829688178,0.0457280385078218
"United States","Minnesota","MN",2020-07-19,2020-07-25,7,2020,"30",5639632,878,7,841,37,871,0.124121573889928,0.656071176275331,0.0439952437574316
"United States","Minnesota","MN",2020-07-26,2020-08-01,7,2020,"31",5639632,818,61,843,-25,757,1.08163085818365,-0.44329133532117,-0.0296559905100831
"United States","Minnesota","MN",2020-08-02,2020-08-08,7,2020,"32",5639632,897,42,845,52,855,0.744729443339565,0.922045977468033,0.0615384615384615
"United States","Minnesota","MN",2020-08-09,2020-08-15,7,2020,"33",5639632,888,51,843,45,837,0.904314324055187,0.797924403578106,0.0533807829181494
"United States","Minnesota","MN",2020-08-16,2020-08-22,7,2020,"34",5639632,907,62,840,67,845,1.0993625115965,1.18802077866074,0.0797619047619047
"United States","Minnesota","MN",2020-08-23,2020-08-29,7,2020,"35",5639632,919,53,843,76,866,0.93977763088088,1.34760565937636,0.0901542111506524
"United States","Minnesota","MN",2020-08-30,2020-09-05,7,2020,"36",5639632,895,37,850,45,858,0.656071176275331,0.797924403578106,0.0529411764705883
"United States","Minnesota","MN",2020-09-06,2020-09-12,7,2020,"37",5639632,893,55,852,41,838,0.975240937706574,0.726997789926719,0.0481220657276995
"United States","Minnesota","MN",2020-09-13,2020-09-19,7,2020,"38",5639632,957,57,865,92,900,1.01070424453227,1.63131211398191,0.10635838150289
"United States","Minnesota","MN",2020-09-20,2020-09-26,7,2020,"39",5639632,969,41,874,95,928,0.726997789926719,1.68450707422045,0.108695652173913
"United States","Minnesota","MN",2020-09-27,2020-10-03,7,2020,"40",5639632,886,69,882,4,817,1.22348408548643,0.0709266136513872,0.00453514739229033
"United States","Minnesota","MN",2020-10-04,2020-10-10,7,2020,"41",5639632,1013,58,885,128,955,1.02843589794511,2.26965163684439,0.144632768361582
"United States","Minnesota","MN",2020-10-11,2020-10-17,7,2020,"42",5639632,953,20,894,59,933,0.354633068256936,1.04616755135796,0.0659955257270695
"United States","Minnesota","MN",2020-10-18,2020-10-24,7,2020,"43",5639632,1030,95,908,122,935,1.68450707422045,2.16326171636731,0.134361233480176
"United States","Minnesota","MN",2020-10-25,2020-10-31,7,2020,"44",5639632,1075,229,908,167,846,4.06054863154192,2.96118611994542,0.183920704845815
"United States","Minnesota","MN",2020-11-01,2020-11-07,7,2020,"45",5639632,1145,149,907,238,996,2.64201635851417,4.22013351225754,0.262403528114664
"United States","Minnesota","MN",2020-11-08,2020-11-14,7,2020,"46",5639632,1196,281,898,298,915,4.98259460900995,5.28403271702834,0.33184855233853
"United States","Minnesota","MN",2020-11-15,2020-11-21,7,2020,"47",5639632,1326,336,895,431,990,5.95783554671652,7.64234262093697,0.481564245810056
"United States","Minnesota","MN",2020-11-22,2020-11-28,7,2020,"48",5639632,1397,280,882,515,1117,4.9648629555971,9.1318015076161,0.58390022675737
"United States","Minnesota","MN",2020-11-29,2020-12-05,7,2020,"49",5639632,1334,398,872,462,936,7.05719805831303,8.19202387673522,0.529816513761468
"United States","Minnesota","MN",2020-12-06,2020-12-12,7,2020,"50",5639632,1382,440,886,496,942,7.80192750165259,8.79490009277201,0.559819413092551
"United States","Minnesota","MN",2020-12-13,2020-12-19,7,2020,"51",5639632,1269,421,898,371,848,7.4650260868085,6.57844341616616,0.413140311804009
"United States","Minnesota","MN",2020-12-20,2020-12-26,7,2020,"52",5639632,1203,327,913,290,876,5.7982506660009,5.14217948972557,0.31763417305586
"United States","Minnesota","MN",2020-12-27,2021-01-02,7,2020,"53",5639632,1194,270,934,260,924,4.78754642146863,4.61022988734017,0.278372591006424
"United States","Minnesota","MN",2021-01-03,2021-01-09,7,2021,"1",5639632,1140,286,936,204,854,5.07125287607418,3.61725729622075,0.217948717948718
"United States","Minnesota","MN",2021-01-10,2021-01-16,7,2021,"2",5639632,1078,224,947,131,854,3.97189036447768,2.32284659708293,0.138331573389652
"United States","Minnesota","MN",2021-01-17,2021-01-23,7,2021,"3",5639632,948,176,948,0,772,3.12077100066104,0,0
"United States","Minnesota","MN",2021-01-24,2021-01-30,7,2021,"4",5639632,924,124,932,-8,800,2.198725023193,-0.141853227302774,-0.00858369098712441
"United States","Minnesota","MN",2021-01-31,2021-02-06,7,2021,"5",5639632,983,103,923,60,880,1.82636030152322,1.06389920477081,0.0650054171180932
"United States","Minnesota","MN",2021-02-07,2021-02-13,7,2021,"6",5639632,913,80,919,-6,833,1.41853227302774,-0.106389920477081,-0.0065288356909684
"United States","Minnesota","MN",2021-02-14,2021-02-20,7,2021,"7",5639632,904,54,911,-7,850,0.957509284293727,-0.124121573889928,-0.00768386388583975
"United States","Minnesota","MN",2021-02-21,2021-02-27,7,2021,"8",5639632,968,53,892,76,915,0.93977763088088,1.34760565937636,0.0852017937219731
"United States","Minnesota","MN",2021-02-28,2021-03-06,7,2021,"9",5639632,931,69,880,51,862,1.22348408548643,0.904314324055187,0.0579545454545454
"United States","Minnesota","MN",2021-03-07,2021-03-13,7,2021,"10",5639632,864,195,881,-17,669,3.45767241550513,-0.301438108018395,-0.0192962542565267
"United States","Minnesota","MN",2021-03-14,2021-03-20,7,2021,"11",5639632,870,37,877,-7,833,0.656071176275331,-0.124121573889928,-0.00798175598631701
"United States","Minnesota","MN",2021-03-21,2021-03-27,7,2021,"12",5639632,867,47,877,-10,820,0.833387710403799,-0.177316534128468,-0.0114025085518814
"United States","Minnesota","MN",2021-03-28,2021-04-03,7,2021,"13",5639632,875,50,882,-7,825,0.88658267064234,-0.124121573889928,-0.00793650793650791
"United States","Minnesota","MN",2021-04-04,2021-04-10,7,2021,"14",5639632,877,69,884,-7,808,1.22348408548643,-0.124121573889928,-0.00791855203619907
"United States","Minnesota","MN",2021-04-11,2021-04-17,7,2021,"15",5639632,897,61,884,13,836,1.08163085818365,0.230511494367008,0.0147058823529411
"United States","Minnesota","MN",2021-04-18,2021-04-24,7,2021,"16",5639632,940,67,888,52,873,1.18802077866074,0.922045977468033,0.0585585585585586
"United States","Minnesota","MN",2021-04-25,2021-05-01,7,2021,"17",5639632,973,82,894,79,891,1.45399557985344,1.4008006196149,0.0883668903803132
"United States","Minnesota","MN",2021-05-02,2021-05-08,7,2021,"18",5639632,902,70,877,25,832,1.24121573889928,0.44329133532117,0.0285062713797035
"United States","Minnesota","MN",2021-05-09,2021-05-15,7,2021,"19",5639632,942,62,886,56,880,1.0993625115965,0.99297259111942,0.0632054176072234
"United States","Minnesota","MN",2021-05-16,2021-05-22,7,2021,"20",5639632,894,77,884,10,817,1.3653373127892,0.177316534128468,0.0113122171945701
"United States","Minnesota","MN",2021-05-23,2021-05-29,7,2021,"21",5639632,878,55,850,28,823,0.975240937706574,0.49648629555971,0.0329411764705883
"United States","Minnesota","MN",2021-05-30,2021-06-05,7,2021,"22",5639632,855,43,841,14,812,0.762461096752412,0.248243147779855,0.0166468489892984
"United States","Minnesota","MN",2021-06-06,2021-06-12,7,2021,"23",5639632,923,42,833,90,881,0.744729443339565,1.59584880715621,0.108043217286915
"United States","Minnesota","MN",2021-06-13,2021-06-19,7,2021,"24",5639632,852,33,828,24,819,0.585144562623944,0.425559681908323,0.0289855072463767
"United States","Minnesota","MN",2021-06-20,2021-06-26,7,2021,"25",5639632,888,42,840,48,846,0.744729443339565,0.851119363816646,0.0571428571428572
"United States","Minnesota","MN",2021-06-27,2021-07-03,7,2021,"26",5639632,875,32,835,40,843,0.567412909211097,0.709266136513872,0.0479041916167664
"United States","Minnesota","MN",2021-07-04,2021-07-10,7,2021,"27",5639632,874,12,834,40,862,0.212779840954162,0.709266136513872,0.0479616306954436
"United States","Minnesota","MN",2021-07-11,2021-07-17,7,2021,"28",5639632,852,13,842,10,839,0.230511494367008,0.177316534128468,0.0118764845605701
"United States","Minnesota","MN",2021-07-18,2021-07-24,7,2021,"29",5639632,801,15,846,-45,786,0.265974801192702,-0.797924403578106,-0.0531914893617021
"United States","Minnesota","MN",2021-07-25,2021-07-31,7,2021,"30",5639632,849,18,861,-12,831,0.319169761431242,-0.212779840954162,-0.0139372822299652
"United States","Minnesota","MN",2021-08-01,2021-08-07,7,2021,"31",5639632,862,26,849,13,836,0.461022988734017,0.230511494367008,0.0153121319199059
"United States","Minnesota","MN",2021-08-08,2021-08-14,7,2021,"32",5639632,905,35,855,50,870,0.620607869449638,0.88658267064234,0.0584795321637428
"United States","Minnesota","MN",2021-08-15,2021-08-21,7,2021,"33",5639632,825,5,852,-27,820,0.088658267064234,-0.478754642146863,-0.0316901408450704
"United States","Mississippi","MS",2019-12-29,2020-01-04,7,2020,"1",2976149,673,0,718,-45,673,0,-1.51202107152565,-0.0626740947075209
"United States","Mississippi","MS",2020-01-05,2020-01-11,7,2020,"2",2976149,648,0,719,-71,648,0,-2.38563324618492,-0.0987482614742698
"United States","Mississippi","MS",2020-01-12,2020-01-18,7,2020,"3",2976149,624,0,712,-88,624,0,-2.95684120653905,-0.123595505617977
"United States","Mississippi","MS",2020-01-19,2020-01-25,7,2020,"4",2976149,612,0,682,-70,612,0,-2.35203277792879,-0.102639296187683
"United States","Mississippi","MS",2020-01-26,2020-02-01,7,2020,"5",2976149,608,0,677,-69,608,0,-2.31843230967267,-0.10192023633678
"United States","Mississippi","MS",2020-02-02,2020-02-08,7,2020,"6",2976149,703,0,682,21,703,0,0.705609833378638,0.030791788856305
"United States","Mississippi","MS",2020-02-09,2020-02-15,7,2020,"7",2976149,648,0,670,-22,648,0,-0.739210301634764,-0.0328358208955224
"United States","Mississippi","MS",2020-02-16,2020-02-22,7,2020,"8",2976149,625,0,660,-35,625,0,-1.1760163889644,-0.053030303030303
"United States","Mississippi","MS",2020-02-23,2020-02-29,7,2020,"9",2976149,665,0,650,15,665,0,0.504007023841884,0.023076923076923
"United States","Mississippi","MS",2020-03-01,2020-03-07,7,2020,"10",2976149,663,0,651,12,663,0,0.403205619073507,0.0184331797235022
"United States","Mississippi","MS",2020-03-08,2020-03-14,7,2020,"11",2976149,623,0,650,-27,623,0,-0.907212642915392,-0.0415384615384615
"United States","Mississippi","MS",2020-03-15,2020-03-21,7,2020,"12",2976149,625,1,642,-17,624,0.0336004682561256,-0.571207960354135,-0.0264797507788161
"United States","Mississippi","MS",2020-03-22,2020-03-28,7,2020,"13",2976149,698,5,634,64,693,0.168002341280628,2.15042996839204,0.100946372239748
"United States","Mississippi","MS",2020-03-29,2020-04-04,7,2020,"14",2976149,707,29,626,81,678,0.974413579427643,2.72163792874617,0.129392971246006
"United States","Mississippi","MS",2020-04-05,2020-04-11,7,2020,"15",2976149,699,57,622,77,642,1.91522669059916,2.58723605572167,0.12379421221865
"United States","Mississippi","MS",2020-04-12,2020-04-18,7,2020,"16",2976149,732,59,614,118,673,1.98242762711141,3.96485525422282,0.192182410423453
"United States","Mississippi","MS",2020-04-19,2020-04-25,7,2020,"17",2976149,750,69,615,135,681,2.31843230967267,4.53606321457696,0.219512195121951
"United States","Mississippi","MS",2020-04-26,2020-05-02,7,2020,"18",2976149,751,71,602,149,680,2.38563324618492,5.00646977016272,0.24750830564784
"United States","Mississippi","MS",2020-05-03,2020-05-09,7,2020,"19",2976149,748,128,597,151,620,4.30085993678408,5.07367070667497,0.252931323283082
"United States","Mississippi","MS",2020-05-10,2020-05-16,7,2020,"20",2976149,775,91,591,184,684,3.05764261130743,6.18248615912711,0.311336717428088
"United States","Mississippi","MS",2020-05-17,2020-05-23,7,2020,"21",2976149,725,106,599,126,619,3.56164963514932,4.23365900027183,0.210350584307179
"United States","Mississippi","MS",2020-05-24,2020-05-30,7,2020,"22",2976149,750,107,603,147,643,3.59525010340544,4.93926883365047,0.243781094527363
"United States","Mississippi","MS",2020-05-31,2020-06-06,7,2020,"23",2976149,728,88,598,130,640,2.95684120653905,4.36806087329633,0.217391304347826
"United States","Mississippi","MS",2020-06-07,2020-06-13,7,2020,"24",2976149,702,78,594,108,624,2.6208365239778,3.62885057166157,0.181818181818182
"United States","Mississippi","MS",2020-06-14,2020-06-20,7,2020,"25",2976149,743,49,597,146,694,1.64642294455016,4.90566836539434,0.244556113902848
"United States","Mississippi","MS",2020-06-21,2020-06-27,7,2020,"26",2976149,721,97,600,121,624,3.25924542084418,4.0656566589912,0.201666666666667
"United States","Mississippi","MS",2020-06-28,2020-07-04,7,2020,"27",2976149,711,72,593,118,639,2.41923371444104,3.96485525422282,0.198988195615514
"United States","Mississippi","MS",2020-07-05,2020-07-11,7,2020,"28",2976149,797,123,590,207,674,4.13285759550345,6.955296929018,0.350847457627119
"United States","Mississippi","MS",2020-07-12,2020-07-18,7,2020,"29",2976149,784,116,577,207,668,3.89765431771057,6.955296929018,0.358752166377816
"United States","Mississippi","MS",2020-07-19,2020-07-25,7,2020,"30",2976149,885,134,585,300,751,4.50246274632083,10.0801404768377,0.512820512820513
"United States","Mississippi","MS",2020-07-26,2020-08-01,7,2020,"31",2976149,872,212,586,286,660,7.12329927029863,9.60973392125193,0.488054607508532
"United States","Mississippi","MS",2020-08-02,2020-08-08,7,2020,"32",2976149,915,165,587,328,750,5.54407726226073,11.0209535880092,0.558773424190801
"United States","Mississippi","MS",2020-08-09,2020-08-15,7,2020,"33",2976149,860,223,581,279,637,7.49290442111601,9.37453064345905,0.480206540447504
"United States","Mississippi","MS",2020-08-16,2020-08-22,7,2020,"34",2976149,813,155,586,227,658,5.20807257969947,7.62730629414051,0.387372013651877
"United States","Mississippi","MS",2020-08-23,2020-08-29,7,2020,"35",2976149,813,190,579,234,623,6.38408896866387,7.8625095719334,0.404145077720207
"United States","Mississippi","MS",2020-08-30,2020-09-05,7,2020,"36",2976149,736,144,590,146,592,4.83846742888209,4.90566836539434,0.247457627118644
"United States","Mississippi","MS",2020-09-06,2020-09-12,7,2020,"37",2976149,745,112,588,157,633,3.76325244468607,5.27527351621172,0.267006802721088
"United States","Mississippi","MS",2020-09-13,2020-09-19,7,2020,"38",2976149,738,128,592,146,610,4.30085993678408,4.90566836539434,0.246621621621622
"United States","Mississippi","MS",2020-09-20,2020-09-26,7,2020,"39",2976149,723,102,593,130,621,3.42724776212481,4.36806087329633,0.219224283305228
"United States","Mississippi","MS",2020-09-27,2020-10-03,7,2020,"40",2976149,728,104,590,138,624,3.49444869863706,4.63686461934534,0.233898305084746
"United States","Mississippi","MS",2020-10-04,2020-10-10,7,2020,"41",2976149,761,81,591,170,680,2.72163792874617,5.71207960354136,0.287648054145516
"United States","Mississippi","MS",2020-10-11,2020-10-17,7,2020,"42",2976149,680,75,593,87,605,2.52003511920942,2.92324073828293,0.146711635750422
"United States","Mississippi","MS",2020-10-18,2020-10-24,7,2020,"43",2976149,727,84,599,128,643,2.82243933351455,4.30085993678408,0.213689482470785
"United States","Mississippi","MS",2020-10-25,2020-10-31,7,2020,"44",2976149,716,93,606,110,623,3.12484354781968,3.69605150817382,0.181518151815182
"United States","Mississippi","MS",2020-11-01,2020-11-07,7,2020,"45",2976149,750,94,613,137,656,3.15844401607581,4.60326415108921,0.223491027732463
"United States","Mississippi","MS",2020-11-08,2020-11-14,7,2020,"46",2976149,785,98,617,168,687,3.29284588910031,5.6448786670291,0.272285251215559
"United States","Mississippi","MS",2020-11-15,2020-11-21,7,2020,"47",2976149,793,117,628,165,676,3.9312547859667,5.54407726226073,0.262738853503185
"United States","Mississippi","MS",2020-11-22,2020-11-28,7,2020,"48",2976149,820,122,637,183,698,4.09925712724733,6.14888569087099,0.287284144427002
"United States","Mississippi","MS",2020-11-29,2020-12-05,7,2020,"49",2976149,850,170,640,210,680,5.71207960354136,7.05609833378638,0.328125
"United States","Mississippi","MS",2020-12-06,2020-12-12,7,2020,"50",2976149,959,231,644,315,728,7.76170816716502,10.5841475006796,0.489130434782609
"United States","Mississippi","MS",2020-12-13,2020-12-19,7,2020,"51",2976149,923,210,650,273,713,7.05609833378638,9.17292783392229,0.42
"United States","Mississippi","MS",2020-12-20,2020-12-26,7,2020,"52",2976149,995,175,657,338,820,5.88008194482198,11.3569582705705,0.514459665144597
"United States","Mississippi","MS",2020-12-27,2021-01-02,7,2020,"53",2976149,1068,275,662,406,793,9.24012877043454,13.641790111987,0.613293051359517
"United States","Mississippi","MS",2021-01-03,2021-01-09,7,2021,"1",2976149,1046,-262,657,389,1308,-8.80332268310491,13.0705821516329,0.592085235920852
"United States","Mississippi","MS",2021-01-10,2021-01-16,7,2021,"2",2976149,1059,903,680,379,156,30.3412228352814,12.7345774690716,0.557352941176471
"United States","Mississippi","MS",2021-01-17,2021-01-23,7,2021,"3",2976149,1021,271,678,343,750,9.10572689741004,11.5249606118511,0.505899705014749
"United States","Mississippi","MS",2021-01-24,2021-01-30,7,2021,"4",2976149,918,267,677,241,651,8.97132502438554,8.09771284972627,0.355982274741507
"United States","Mississippi","MS",2021-01-31,2021-02-06,7,2021,"5",2976149,866,247,671,195,619,8.29931565926303,6.5520913099445,0.290611028315946
"United States","Mississippi","MS",2021-02-07,2021-02-13,7,2021,"6",2976149,790,196,673,117,594,6.58569177820062,3.9312547859667,0.173848439821694
"United States","Mississippi","MS",2021-02-14,2021-02-20,7,2021,"7",2976149,806,92,661,145,714,3.09124307956356,4.87206789713821,0.219364599092284
"United States","Mississippi","MS",2021-02-21,2021-02-27,7,2021,"8",2976149,843,116,654,189,727,3.89765431771057,6.35048850040774,0.288990825688073
"United States","Mississippi","MS",2021-02-28,2021-03-06,7,2021,"9",2976149,718,136,644,74,582,4.56966368283308,2.4864346509533,0.114906832298137
"United States","Mississippi","MS",2021-03-07,2021-03-13,7,2021,"10",2976149,750,91,635,115,659,3.05764261130743,3.86405384945445,0.181102362204724
"United States","Mississippi","MS",2021-03-14,2021-03-20,7,2021,"11",2976149,677,60,625,52,617,2.01602809536754,1.74722434931853,0.0831999999999999
"United States","Mississippi","MS",2021-03-21,2021-03-27,7,2021,"12",2976149,672,45,629,43,627,1.51202107152565,1.4448201350134,0.068362480127186
"United States","Mississippi","MS",2021-03-28,2021-04-03,7,2021,"13",2976149,650,55,622,28,595,1.84802575408691,0.940813111171517,0.045016077170418
"United States","Mississippi","MS",2021-04-04,2021-04-10,7,2021,"14",2976149,664,38,617,47,626,1.27681779373277,1.5792220080379,0.0761750405186385
"United States","Mississippi","MS",2021-04-11,2021-04-17,7,2021,"15",2976149,656,58,619,37,598,1.94882715885529,1.24321732547665,0.0597738287560581
"United States","Mississippi","MS",2021-04-18,2021-04-24,7,2021,"16",2976149,668,22,613,55,646,0.739210301634764,1.84802575408691,0.0897226753670473
"United States","Mississippi","MS",2021-04-25,2021-05-01,7,2021,"17",2976149,693,24,608,85,669,0.806411238147015,2.85603980177068,0.139802631578947
"United States","Mississippi","MS",2021-05-02,2021-05-08,7,2021,"18",2976149,636,29,615,21,607,0.974413579427643,0.705609833378638,0.0341463414634147
"United States","Mississippi","MS",2021-05-09,2021-05-15,7,2021,"19",2976149,628,26,609,19,602,0.873612174659266,0.638408896866387,0.0311986863711002
"United States","Mississippi","MS",2021-05-16,2021-05-22,7,2021,"20",2976149,680,25,603,77,655,0.84001170640314,2.58723605572167,0.127694859038143
"United States","Mississippi","MS",2021-05-23,2021-05-29,7,2021,"21",2976149,688,31,602,86,657,1.04161451593989,2.8896402700268,0.142857142857143
"United States","Mississippi","MS",2021-05-30,2021-06-05,7,2021,"22",2976149,629,15,595,34,614,0.504007023841884,1.14241592070827,0.0571428571428572
"United States","Mississippi","MS",2021-06-06,2021-06-12,7,2021,"23",2976149,699,28,597,102,671,0.940813111171517,3.42724776212481,0.170854271356784
"United States","Mississippi","MS",2021-06-13,2021-06-19,7,2021,"24",2976149,650,18,593,57,632,0.604808428610261,1.91522669059916,0.0961214165261384
"United States","Mississippi","MS",2021-06-20,2021-06-26,7,2021,"25",2976149,654,24,591,63,630,0.806411238147015,2.11682950013591,0.106598984771574
"United States","Mississippi","MS",2021-06-27,2021-07-03,7,2021,"26",2976149,622,24,583,39,598,0.806411238147015,1.3104182619889,0.0668953687821612
"United States","Mississippi","MS",2021-07-04,2021-07-10,7,2021,"27",2976149,653,20,575,78,633,0.672009365122512,2.6208365239778,0.135652173913043
"United States","Mississippi","MS",2021-07-11,2021-07-17,7,2021,"28",2976149,700,26,579,121,674,0.873612174659266,4.0656566589912,0.208981001727116
"United States","Mississippi","MS",2021-07-18,2021-07-24,7,2021,"29",2976149,736,37,585,151,699,1.24321732547665,5.07367070667497,0.258119658119658
"United States","Mississippi","MS",2021-07-25,2021-07-31,7,2021,"30",2976149,744,41,580,164,703,1.37761919850115,5.5104767940046,0.282758620689655
"United States","Mississippi","MS",2021-08-01,2021-08-07,7,2021,"31",2976149,829,78,579,250,751,2.6208365239778,8.4001170640314,0.431778929188256
"United States","Mississippi","MS",2021-08-08,2021-08-14,7,2021,"32",2976149,895,140,577,318,755,4.70406555585759,10.6849489054479,0.551126516464471
"United States","Mississippi","MS",2021-08-15,2021-08-21,7,2021,"33",2976149,953,52,576,377,901,1.74722434931853,12.6673765325594,0.654513888888889
"United States","Missouri","MO",2019-12-29,2020-01-04,7,2020,"1",6137428,1327,0,1560,-233,1327,0,-3.79637854814753,-0.149358974358974
"United States","Missouri","MO",2020-01-05,2020-01-11,7,2020,"2",6137428,1333,0,1575,-242,1333,0,-3.94301977962104,-0.153650793650794
"United States","Missouri","MO",2020-01-12,2020-01-18,7,2020,"3",6137428,1334,0,1581,-247,1334,0,-4.02448713043966,-0.156230234029096
"United States","Missouri","MO",2020-01-19,2020-01-25,7,2020,"4",6137428,1352,0,1529,-177,1352,0,-2.88394421897902,-0.115761935905821
"United States","Missouri","MO",2020-01-26,2020-02-01,7,2020,"5",6137428,1364,0,1501,-137,1364,0,-2.23220541243009,-0.0912724850099933
"United States","Missouri","MO",2020-02-02,2020-02-08,7,2020,"6",6137428,1334,0,1488,-154,1334,0,-2.50919440521339,-0.103494623655914
"United States","Missouri","MO",2020-02-09,2020-02-15,7,2020,"7",6137428,1348,0,1456,-108,1348,0,-1.75969477768212,-0.0741758241758241
"United States","Missouri","MO",2020-02-16,2020-02-22,7,2020,"8",6137428,1361,0,1437,-76,1361,0,-1.23830373244297,-0.0528879610299234
"United States","Missouri","MO",2020-02-23,2020-02-29,7,2020,"9",6137428,1370,0,1410,-40,1370,0,-0.651738806548932,-0.0283687943262412
"United States","Missouri","MO",2020-03-01,2020-03-07,7,2020,"10",6137428,1394,0,1387,7,1394,0,0.114054291146063,0.00504686373467922
"United States","Missouri","MO",2020-03-08,2020-03-14,7,2020,"11",6137428,1301,0,1381,-80,1301,0,-1.30347761309786,-0.057929036929761
"United States","Missouri","MO",2020-03-15,2020-03-21,7,2020,"12",6137428,1272,3,1364,-92,1269,0.0488804104911699,-1.49899925506254,-0.0674486803519062
"United States","Missouri","MO",2020-03-22,2020-03-28,7,2020,"13",6137428,1343,7,1342,1,1336,0.114054291146063,0.0162934701637233,0.000745156482861331
"United States","Missouri","MO",2020-03-29,2020-04-04,7,2020,"14",6137428,1301,13,1322,-21,1288,0.211815112128403,-0.342162873438189,-0.0158850226928896
"United States","Missouri","MO",2020-04-05,2020-04-11,7,2020,"15",6137428,1466,87,1303,163,1379,1.41753190424393,2.6558356366869,0.125095932463546
"United States","Missouri","MO",2020-04-12,2020-04-18,7,2020,"16",6137428,1358,67,1288,70,1291,1.09166250096946,1.14054291146063,0.0543478260869565
"United States","Missouri","MO",2020-04-19,2020-04-25,7,2020,"17",6137428,1448,98,1282,166,1350,1.59676007604488,2.70471604717807,0.129485179407176
"United States","Missouri","MO",2020-04-26,2020-05-02,7,2020,"18",6137428,1393,78,1266,127,1315,1.27089067277042,2.06927071079286,0.100315955766193
"United States","Missouri","MO",2020-05-03,2020-05-09,7,2020,"19",6137428,1427,121,1243,184,1306,1.97150988981052,2.99799851012509,0.148028962188254
"United States","Missouri","MO",2020-05-10,2020-05-16,7,2020,"20",6137428,1343,116,1233,110,1227,1.8900425389919,1.79228171800956,0.089213300892133
"United States","Missouri","MO",2020-05-17,2020-05-23,7,2020,"21",6137428,1304,86,1236,68,1218,1.4012384340802,1.10795597113318,0.0550161812297734
"United States","Missouri","MO",2020-05-24,2020-05-30,7,2020,"22",6137428,1244,94,1232,12,1150,1.53158619538999,0.19552164196468,0.00974025974025983
"United States","Missouri","MO",2020-05-31,2020-06-06,7,2020,"23",6137428,1293,37,1224,69,1256,0.602858396057762,1.12424944129691,0.0563725490196079
"United States","Missouri","MO",2020-06-07,2020-06-13,7,2020,"24",6137428,1263,70,1214,49,1193,1.14054291146063,0.798380038022442,0.0403624382207579
"United States","Missouri","MO",2020-06-14,2020-06-20,7,2020,"25",6137428,1228,78,1220,8,1150,1.27089067277042,0.130347761309786,0.00655737704918025
"United States","Missouri","MO",2020-06-21,2020-06-27,7,2020,"26",6137428,1284,41,1214,70,1243,0.668032276712656,1.14054291146063,0.0576606260296539
"United States","Missouri","MO",2020-06-28,2020-07-04,7,2020,"27",6137428,1284,26,1220,64,1258,0.423630224256806,1.04278209047829,0.0524590163934426
"United States","Missouri","MO",2020-07-05,2020-07-11,7,2020,"28",6137428,1295,47,1228,67,1248,0.765793097694995,1.09166250096946,0.0545602605863191
"United States","Missouri","MO",2020-07-12,2020-07-18,7,2020,"29",6137428,1367,61,1216,151,1306,0.993901679987122,2.46031399472222,0.124177631578947
"United States","Missouri","MO",2020-07-19,2020-07-25,7,2020,"30",6137428,1355,52,1212,143,1303,0.847260448513612,2.32996623341243,0.117986798679868
"United States","Missouri","MO",2020-07-26,2020-08-01,7,2020,"31",6137428,1366,71,1236,130,1295,1.15683638162435,2.11815112128403,0.105177993527508
"United States","Missouri","MO",2020-08-02,2020-08-08,7,2020,"32",6137428,1355,48,1233,122,1307,0.782086567858719,1.98780335997424,0.0989456609894566
"United States","Missouri","MO",2020-08-09,2020-08-15,7,2020,"33",6137428,1380,45,1226,154,1335,0.733206157367549,2.50919440521339,0.125611745513866
"United States","Missouri","MO",2020-08-16,2020-08-22,7,2020,"34",6137428,1402,79,1219,183,1323,1.28718414293414,2.98170503996137,0.150123051681706
"United States","Missouri","MO",2020-08-23,2020-08-29,7,2020,"35",6137428,1382,71,1210,172,1311,1.15683638162435,2.80247686816041,0.142148760330578
"United States","Missouri","MO",2020-08-30,2020-09-05,7,2020,"36",6137428,1410,143,1205,205,1267,2.32996623341243,3.34016138356328,0.170124481327801
"United States","Missouri","MO",2020-09-06,2020-09-12,7,2020,"37",6137428,1369,65,1207,162,1304,1.05907556064201,2.63954216652318,0.134217067108534
"United States","Missouri","MO",2020-09-13,2020-09-19,7,2020,"38",6137428,1445,89,1202,243,1356,1.45011884457137,3.95931324978476,0.20216306156406
"United States","Missouri","MO",2020-09-20,2020-09-26,7,2020,"39",6137428,1465,270,1201,264,1195,4.39923694420529,4.30147612322295,0.219816819317236
"United States","Missouri","MO",2020-09-27,2020-10-03,7,2020,"40",6137428,1522,107,1192,330,1415,1.74340130751839,5.37684515402869,0.276845637583893
"United States","Missouri","MO",2020-10-04,2020-10-10,7,2020,"41",6137428,1531,253,1194,337,1278,4.122247951422,5.49089944517475,0.282244556113903
"United States","Missouri","MO",2020-10-11,2020-10-17,7,2020,"42",6137428,1519,162,1199,320,1357,2.63954216652318,5.21391045239146,0.266889074228524
"United States","Missouri","MO",2020-10-18,2020-10-24,7,2020,"43",6137428,1577,253,1202,375,1324,4.122247951422,6.11005131139624,0.31198003327787
"United States","Missouri","MO",2020-10-25,2020-10-31,7,2020,"44",6137428,1611,221,1211,400,1390,3.60085690618285,6.51738806548932,0.330305532617671
"United States","Missouri","MO",2020-11-01,2020-11-07,7,2020,"45",6137428,1790,94,1218,572,1696,1.53158619538999,9.31986493364973,0.469622331691297
"United States","Missouri","MO",2020-11-08,2020-11-14,7,2020,"46",6137428,1839,219,1204,635,1620,3.5682699658554,10.3463535539643,0.527408637873754
"United States","Missouri","MO",2020-11-15,2020-11-21,7,2020,"47",6137428,1858,180,1204,654,1678,2.9328246294702,10.655929487075,0.543189368770764
"United States","Missouri","MO",2020-11-22,2020-11-28,7,2020,"48",6137428,1908,269,1215,693,1639,4.38294347404157,11.2913748234603,0.57037037037037
"United States","Missouri","MO",2020-11-29,2020-12-05,7,2020,"49",6137428,1962,360,1230,732,1602,5.86564925894039,11.9268201598455,0.595121951219512
"United States","Missouri","MO",2020-12-06,2020-12-12,7,2020,"50",6137428,2017,329,1245,772,1688,5.36055168386497,12.5785589663944,0.62008032128514
"United States","Missouri","MO",2020-12-13,2020-12-19,7,2020,"51",6137428,1890,427,1266,624,1463,6.95731175990985,10.1671253821633,0.492890995260663
"United States","Missouri","MO",2020-12-20,2020-12-26,7,2020,"52",6137428,1830,357,1290,540,1473,5.81676884844922,8.79847388841059,0.418604651162791
"United States","Missouri","MO",2020-12-27,2021-01-02,7,2020,"53",6137428,1837,249,1308,529,1588,4.0570740707671,8.61924571660963,0.404434250764526
"United States","Missouri","MO",2021-01-03,2021-01-09,7,2021,"1",6137428,1752,401,1325,427,1351,6.53368153565305,6.95731175990985,0.322264150943396
"United States","Missouri","MO",2021-01-10,2021-01-16,7,2021,"2",6137428,1785,306,1350,435,1479,4.98580187009933,7.08765952121964,0.322222222222222
"United States","Missouri","MO",2021-01-17,2021-01-23,7,2021,"3",6137428,1724,291,1365,359,1433,4.74139981764348,5.84935578877667,0.263003663003663
"United States","Missouri","MO",2021-01-24,2021-01-30,7,2021,"4",6137428,1617,207,1363,254,1410,3.37274832389072,4.13854142158572,0.186353631694791
"United States","Missouri","MO",2021-01-31,2021-02-06,7,2021,"5",6137428,1524,394,1375,149,1130,6.41962724450698,2.42772705439477,0.108363636363636
"United States","Missouri","MO",2021-02-07,2021-02-13,7,2021,"6",6137428,1426,311,1372,54,1115,5.06726922091795,0.879847388841059,0.0393586005830904
"United States","Missouri","MO",2021-02-14,2021-02-20,7,2021,"7",6137428,1512,268,1340,172,1244,4.36665000387785,2.80247686816041,0.128358208955224
"United States","Missouri","MO",2021-02-21,2021-02-27,7,2021,"8",6137428,1399,199,1329,70,1200,3.24240056258094,1.14054291146063,0.052671181339353
"United States","Missouri","MO",2021-02-28,2021-03-06,7,2021,"9",6137428,1366,248,1318,48,1118,4.04078060060338,0.782086567858719,0.0364188163884673
"United States","Missouri","MO",2021-03-07,2021-03-13,7,2021,"10",6137428,1312,149,1327,-15,1163,2.42772705439477,-0.24440205245585,-0.0113036925395629
"United States","Missouri","MO",2021-03-14,2021-03-20,7,2021,"11",6137428,1260,63,1318,-58,1197,1.02648862031457,-0.945021269495952,-0.0440060698027314
"United States","Missouri","MO",2021-03-21,2021-03-27,7,2021,"12",6137428,1405,74,1291,114,1331,1.20571679211552,1.85745559866446,0.088303640588691
"United States","Missouri","MO",2021-03-28,2021-04-03,7,2021,"13",6137428,1297,61,1267,30,1236,0.993901679987122,0.488804104911699,0.0236779794790845
"United States","Missouri","MO",2021-04-04,2021-04-10,7,2021,"14",6137428,1402,0,1268,134,1402,0,2.18332500193892,0.105678233438486
"United States","Missouri","MO",2021-04-11,2021-04-17,7,2021,"15",6137428,1317,120,1259,58,1197,1.9552164196468,0.945021269495952,0.0460683081810962
"United States","Missouri","MO",2021-04-18,2021-04-24,7,2021,"16",6137428,1311,60,1255,56,1251,0.977608209823398,0.912434329168505,0.0446215139442232
"United States","Missouri","MO",2021-04-25,2021-05-01,7,2021,"17",6137428,1312,50,1253,59,1262,0.814673508186165,0.961314739659675,0.0470869912210694
"United States","Missouri","MO",2021-05-02,2021-05-08,7,2021,"18",6137428,1238,78,1224,14,1160,1.27089067277042,0.228108582292126,0.011437908496732
"United States","Missouri","MO",2021-05-09,2021-05-15,7,2021,"19",6137428,1333,36,1218,115,1297,0.586564925894039,1.87374906882818,0.0944170771756978
"United States","Missouri","MO",2021-05-16,2021-05-22,7,2021,"20",6137428,1285,147,1206,79,1138,2.39514011406733,1.28718414293414,0.0655058043117744
"United States","Missouri","MO",2021-05-23,2021-05-29,7,2021,"21",6137428,1258,74,1206,52,1184,1.20571679211552,0.847260448513612,0.0431177446102819
"United States","Missouri","MO",2021-05-30,2021-06-05,7,2021,"22",6137428,1326,60,1190,136,1266,0.977608209823398,2.21591194226637,0.114285714285714
"United States","Missouri","MO",2021-06-06,2021-06-12,7,2021,"23",6137428,1335,56,1178,157,1279,0.912434329168505,2.55807481570456,0.133276740237691
"United States","Missouri","MO",2021-06-13,2021-06-19,7,2021,"24",6137428,1285,34,1190,95,1251,0.553977985566592,1.54787966555371,0.0798319327731092
"United States","Missouri","MO",2021-06-20,2021-06-26,7,2021,"25",6137428,1396,27,1198,198,1369,0.439923694420529,3.22610709241721,0.165275459098498
"United States","Missouri","MO",2021-06-27,2021-07-03,7,2021,"26",6137428,1292,82,1188,104,1210,1.33606455342531,1.69452089702722,0.0875420875420876
"United States","Missouri","MO",2021-07-04,2021-07-10,7,2021,"27",6137428,1397,48,1189,208,1349,0.782086567858719,3.38904179405445,0.174936921783011
"United States","Missouri","MO",2021-07-11,2021-07-17,7,2021,"28",6137428,1466,87,1177,289,1379,1.41753190424393,4.70881287731604,0.24553950722175
"United States","Missouri","MO",2021-07-18,2021-07-24,7,2021,"29",6137428,1437,83,1172,265,1354,1.35235802358903,4.31776959338668,0.226109215017065
"United States","Missouri","MO",2021-07-25,2021-07-31,7,2021,"30",6137428,1481,110,1182,299,1371,1.79228171800956,4.87174757895327,0.252961082910321
"United States","Missouri","MO",2021-08-01,2021-08-07,7,2021,"31",6137428,1621,160,1190,431,1461,2.60695522619573,7.02248564056474,0.36218487394958
"United States","Missouri","MO",2021-08-08,2021-08-14,7,2021,"32",6137428,1618,200,1175,443,1418,3.25869403274466,7.21800728252942,0.377021276595745
"United States","Missouri","MO",2021-08-15,2021-08-21,7,2021,"33",6137428,1593,1,1167,426,1592,0.0162934701637233,6.94101828974613,0.365038560411311
"United States","Montana","MT",2019-12-29,2020-01-04,7,2020,"1",1068778,231,0,210,21,231,0,1.96486080364678,0.1
"United States","Montana","MT",2020-01-05,2020-01-11,7,2020,"2",1068778,211,0,210,1,211,0,0.0935648001736563,0.00476190476190474
"United States","Montana","MT",2020-01-12,2020-01-18,7,2020,"3",1068778,202,0,207,-5,202,0,-0.467824000868281,-0.0241545893719807
"United States","Montana","MT",2020-01-19,2020-01-25,7,2020,"4",1068778,197,0,206,-9,197,0,-0.842083201562906,-0.0436893203883495
"United States","Montana","MT",2020-01-26,2020-02-01,7,2020,"5",1068778,218,0,205,13,218,0,1.21634240225753,0.0634146341463415
"United States","Montana","MT",2020-02-02,2020-02-08,7,2020,"6",1068778,202,0,204,-2,202,0,-0.187129600347313,-0.00980392156862742
"United States","Montana","MT",2020-02-09,2020-02-15,7,2020,"7",1068778,198,0,202,-4,198,0,-0.374259200694625,-0.0198019801980198
"United States","Montana","MT",2020-02-16,2020-02-22,7,2020,"8",1068778,217,0,203,14,217,0,1.30990720243119,0.0689655172413792
"United States","Montana","MT",2020-02-23,2020-02-29,7,2020,"9",1068778,236,0,201,35,236,0,3.27476800607797,0.174129353233831
"United States","Montana","MT",2020-03-01,2020-03-07,7,2020,"10",1068778,221,0,194,27,221,0,2.52624960468872,0.139175257731959
"United States","Montana","MT",2020-03-08,2020-03-14,7,2020,"11",1068778,218,0,190,28,218,0,2.61981440486238,0.147368421052632
"United States","Montana","MT",2020-03-15,2020-03-21,7,2020,"12",1068778,229,0,190,39,229,0,3.64902720677259,0.205263157894737
"United States","Montana","MT",2020-03-22,2020-03-28,7,2020,"13",1068778,205,1,188,17,204,0.0935648001736563,1.59060160295216,0.0904255319148937
"United States","Montana","MT",2020-03-29,2020-04-04,7,2020,"14",1068778,177,4,185,-8,173,0.374259200694625,-0.74851840138925,-0.0432432432432432
"United States","Montana","MT",2020-04-05,2020-04-11,7,2020,"15",1068778,216,1,186,30,215,0.0935648001736563,2.80694400520969,0.161290322580645
"United States","Montana","MT",2020-04-12,2020-04-18,7,2020,"16",1068778,191,6,185,6,185,0.561388801041938,0.561388801041938,0.0324324324324323
"United States","Montana","MT",2020-04-19,2020-04-25,7,2020,"17",1068778,187,4,182,5,183,0.374259200694625,0.467824000868281,0.0274725274725274
"United States","Montana","MT",2020-04-26,2020-05-02,7,2020,"18",1068778,204,2,180,24,202,0.187129600347313,2.24555520416775,0.133333333333333
"United States","Montana","MT",2020-05-03,2020-05-09,7,2020,"19",1068778,177,0,177,0,177,0,0,0
"United States","Montana","MT",2020-05-10,2020-05-16,7,2020,"20",1068778,205,0,175,30,205,0,2.80694400520969,0.171428571428571
"United States","Montana","MT",2020-05-17,2020-05-23,7,2020,"21",1068778,181,0,174,7,181,0,0.654953601215594,0.0402298850574712
"United States","Montana","MT",2020-05-24,2020-05-30,7,2020,"22",1068778,180,1,179,1,179,0.0935648001736563,0.0935648001736563,0.005586592178771
"United States","Montana","MT",2020-05-31,2020-06-06,7,2020,"23",1068778,178,1,176,2,177,0.0935648001736563,0.187129600347313,0.0113636363636365
"United States","Montana","MT",2020-06-07,2020-06-13,7,2020,"24",1068778,223,0,176,47,223,0,4.39754560816184,0.267045454545455
"United States","Montana","MT",2020-06-14,2020-06-20,7,2020,"25",1068778,198,2,176,22,196,0.187129600347313,2.05842560382044,0.125
"United States","Montana","MT",2020-06-21,2020-06-27,7,2020,"26",1068778,199,2,180,19,197,0.187129600347313,1.77773120329947,0.105555555555556
"United States","Montana","MT",2020-06-28,2020-07-04,7,2020,"27",1068778,175,1,178,-3,174,0.0935648001736563,-0.280694400520969,-0.0168539325842697
"United States","Montana","MT",2020-07-05,2020-07-11,7,2020,"28",1068778,190,6,183,7,184,0.561388801041938,0.654953601215594,0.0382513661202186
"United States","Montana","MT",2020-07-12,2020-07-18,7,2020,"29",1068778,203,8,185,18,195,0.74851840138925,1.68416640312581,0.0972972972972972
"United States","Montana","MT",2020-07-19,2020-07-25,7,2020,"30",1068778,224,9,190,34,215,0.842083201562906,3.18120320590431,0.178947368421053
"United States","Montana","MT",2020-07-26,2020-08-01,7,2020,"31",1068778,216,15,189,27,201,1.40347200260484,2.52624960468872,0.142857142857143
"United States","Montana","MT",2020-08-02,2020-08-08,7,2020,"32",1068778,216,14,192,24,202,1.30990720243119,2.24555520416775,0.125
"United States","Montana","MT",2020-08-09,2020-08-15,7,2020,"33",1068778,204,7,188,16,197,0.654953601215594,1.4970368027785,0.0851063829787233
"United States","Montana","MT",2020-08-16,2020-08-22,7,2020,"34",1068778,240,8,181,59,232,0.74851840138925,5.52032321024572,0.325966850828729
"United States","Montana","MT",2020-08-23,2020-08-29,7,2020,"35",1068778,195,14,178,17,181,1.30990720243119,1.59060160295216,0.095505617977528
"United States","Montana","MT",2020-08-30,2020-09-05,7,2020,"36",1068778,233,12,178,55,221,1.12277760208388,5.14606400955109,0.308988764044944
"United States","Montana","MT",2020-09-06,2020-09-12,7,2020,"37",1068778,221,17,174,47,204,1.59060160295216,4.39754560816184,0.270114942528736
"United States","Montana","MT",2020-09-13,2020-09-19,7,2020,"38",1068778,235,23,176,59,212,2.15199040399409,5.52032321024572,0.335227272727273
"United States","Montana","MT",2020-09-20,2020-09-26,7,2020,"39",1068778,236,15,179,57,221,1.40347200260484,5.33319360989841,0.318435754189944
"United States","Montana","MT",2020-09-27,2020-10-03,7,2020,"40",1068778,240,15,180,60,225,1.40347200260484,5.61388801041938,0.333333333333333
"United States","Montana","MT",2020-10-04,2020-10-10,7,2020,"41",1068778,282,23,184,98,259,2.15199040399409,9.16935041701831,0.532608695652174
"United States","Montana","MT",2020-10-11,2020-10-17,7,2020,"42",1068778,267,31,187,80,236,2.90050880538334,7.4851840138925,0.427807486631016
"United States","Montana","MT",2020-10-18,2020-10-24,7,2020,"43",1068778,295,54,188,107,241,5.05249920937744,10.0114336185812,0.569148936170213
"United States","Montana","MT",2020-10-25,2020-10-31,7,2020,"44",1068778,317,81,185,132,236,7.57874881406616,12.3505536229226,0.713513513513514
"United States","Montana","MT",2020-11-01,2020-11-07,7,2020,"45",1068778,299,70,189,110,229,6.54953601215594,10.2921280191022,0.582010582010582
"United States","Montana","MT",2020-11-08,2020-11-14,7,2020,"46",1068778,323,66,189,134,257,6.17527681146131,12.5376832232699,0.708994708994709
"United States","Montana","MT",2020-11-15,2020-11-21,7,2020,"47",1068778,332,87,191,141,245,8.1401376151081,13.1926368244855,0.738219895287958
"United States","Montana","MT",2020-11-22,2020-11-28,7,2020,"48",1068778,307,71,188,119,236,6.6431008123296,11.1342112206651,0.632978723404255
"United States","Montana","MT",2020-11-29,2020-12-05,7,2020,"49",1068778,270,64,189,81,206,5.988147211114,7.57874881406616,0.428571428571429
"United States","Montana","MT",2020-12-06,2020-12-12,7,2020,"50",1068778,303,83,188,115,220,7.76587841441347,10.7599520199705,0.611702127659574
"United States","Montana","MT",2020-12-13,2020-12-19,7,2020,"51",1068778,271,48,193,78,223,4.4911104083355,7.29805441354519,0.404145077720207
"United States","Montana","MT",2020-12-20,2020-12-26,7,2020,"52",1068778,308,55,196,112,253,5.14606400955109,10.4792576194495,0.571428571428571
"United States","Montana","MT",2020-12-27,2021-01-02,7,2020,"53",1068778,274,52,206,68,222,4.86536960903013,6.36240641180863,0.330097087378641
"United States","Montana","MT",2021-01-03,2021-01-09,7,2021,"1",1068778,248,82,205,43,166,7.67231361423981,4.02328640746722,0.209756097560976
"United States","Montana","MT",2021-01-10,2021-01-16,7,2021,"2",1068778,253,35,209,44,218,3.27476800607797,4.11685120764088,0.210526315789474
"United States","Montana","MT",2021-01-17,2021-01-23,7,2021,"3",1068778,247,53,210,37,194,4.95893440920378,3.46189760642528,0.176190476190476
"United States","Montana","MT",2021-01-24,2021-01-30,7,2021,"4",1068778,199,91,213,-14,108,8.51439681580272,-1.30990720243119,-0.0657276995305164
"United States","Montana","MT",2021-01-31,2021-02-06,7,2021,"5",1068778,216,78,216,0,138,7.29805441354519,0,0
"United States","Montana","MT",2021-02-07,2021-02-13,7,2021,"6",1068778,222,17,220,2,205,1.59060160295216,0.187129600347313,0.00909090909090904
"United States","Montana","MT",2021-02-14,2021-02-20,7,2021,"7",1068778,211,12,222,-11,199,1.12277760208388,-1.02921280191022,-0.0495495495495496
"United States","Montana","MT",2021-02-21,2021-02-27,7,2021,"8",1068778,224,16,225,-1,208,1.4970368027785,-0.0935648001736563,-0.00444444444444447
"United States","Montana","MT",2021-02-28,2021-03-06,7,2021,"9",1068778,188,24,222,-34,164,2.24555520416775,-3.18120320590431,-0.153153153153153
"United States","Montana","MT",2021-03-07,2021-03-13,7,2021,"10",1068778,199,12,217,-18,187,1.12277760208388,-1.68416640312581,-0.0829493087557603
"United States","Montana","MT",2021-03-14,2021-03-20,7,2021,"11",1068778,224,22,213,11,202,2.05842560382044,1.02921280191022,0.051643192488263
"United States","Montana","MT",2021-03-21,2021-03-27,7,2021,"12",1068778,208,22,209,-1,186,2.05842560382044,-0.0935648001736563,-0.00478468899521534
"United States","Montana","MT",2021-03-28,2021-04-03,7,2021,"13",1068778,170,29,208,-38,141,2.71337920503603,-3.55546240659894,-0.182692307692308
"United States","Montana","MT",2021-04-04,2021-04-10,7,2021,"14",1068778,207,57,206,1,150,5.33319360989841,0.0935648001736563,0.00485436893203883
"United States","Montana","MT",2021-04-11,2021-04-17,7,2021,"15",1068778,235,22,207,28,213,2.05842560382044,2.61981440486238,0.135265700483092
"United States","Montana","MT",2021-04-18,2021-04-24,7,2021,"16",1068778,208,18,207,1,190,1.68416640312581,0.0935648001736563,0.00483091787439616
"United States","Montana","MT",2021-04-25,2021-05-01,7,2021,"17",1068778,225,11,202,23,214,1.02921280191022,2.15199040399409,0.113861386138614
"United States","Montana","MT",2021-05-02,2021-05-08,7,2021,"18",1068778,200,18,198,2,182,1.68416640312581,0.187129600347313,0.0101010101010102
"United States","Montana","MT",2021-05-09,2021-05-15,7,2021,"19",1068778,199,6,198,1,193,0.561388801041938,0.0935648001736563,0.00505050505050497
"United States","Montana","MT",2021-05-16,2021-05-22,7,2021,"20",1068778,224,5,195,29,219,0.467824000868281,2.71337920503603,0.148717948717949
"United States","Montana","MT",2021-05-23,2021-05-29,7,2021,"21",1068778,213,10,197,16,203,0.935648001736563,1.4970368027785,0.0812182741116751
"United States","Montana","MT",2021-05-30,2021-06-05,7,2021,"22",1068778,204,19,197,7,185,1.77773120329947,0.654953601215594,0.0355329949238579
"United States","Montana","MT",2021-06-06,2021-06-12,7,2021,"23",1068778,232,9,200,32,223,0.842083201562906,2.994073605557,0.16
"United States","Montana","MT",2021-06-13,2021-06-19,7,2021,"24",1068778,236,10,202,34,226,0.935648001736563,3.18120320590431,0.168316831683168
"United States","Montana","MT",2021-06-20,2021-06-26,7,2021,"25",1068778,217,11,204,13,206,1.02921280191022,1.21634240225753,0.0637254901960784
"United States","Montana","MT",2021-06-27,2021-07-03,7,2021,"26",1068778,230,4,204,26,226,0.374259200694625,2.43268480451506,0.127450980392157
"United States","Montana","MT",2021-07-04,2021-07-10,7,2021,"27",1068778,200,7,208,-8,193,0.654953601215594,-0.74851840138925,-0.0384615384615384
"United States","Montana","MT",2021-07-11,2021-07-17,7,2021,"28",1068778,222,18,209,13,204,1.68416640312581,1.21634240225753,0.062200956937799
"United States","Montana","MT",2021-07-18,2021-07-24,7,2021,"29",1068778,210,4,214,-4,206,0.374259200694625,-0.374259200694625,-0.0186915887850467
"United States","Montana","MT",2021-07-25,2021-07-31,7,2021,"30",1068778,256,9,214,42,247,0.842083201562906,3.92972160729356,0.196261682242991
"United States","Montana","MT",2021-08-01,2021-08-07,7,2021,"31",1068778,243,18,212,31,225,1.68416640312581,2.90050880538334,0.14622641509434
"United States","Montana","MT",2021-08-08,2021-08-14,7,2021,"32",1068778,256,8,212,44,248,0.74851840138925,4.11685120764088,0.207547169811321
"United States","Montana","MT",2021-08-15,2021-08-21,7,2021,"33",1068778,282,6,211,71,276,0.561388801041938,6.6431008123296,0.336492890995261
"United States","Nebraska","NE",2019-12-29,2020-01-04,7,2020,"1",1934408,346,0,404,-58,346,0,-2.99833334022605,-0.143564356435644
"United States","Nebraska","NE",2020-01-05,2020-01-11,7,2020,"2",1934408,362,0,401,-39,362,0,-2.01612069428993,-0.0972568578553616
"United States","Nebraska","NE",2020-01-12,2020-01-18,7,2020,"3",1934408,333,0,405,-72,333,0,-3.72206897407372,-0.177777777777778
"United States","Nebraska","NE",2020-01-19,2020-01-25,7,2020,"4",1934408,358,0,385,-27,358,0,-1.39577586527765,-0.0701298701298702
"United States","Nebraska","NE",2020-01-26,2020-02-01,7,2020,"5",1934408,373,0,378,-5,373,0,-0.258477012088453,-0.0132275132275133
"United States","Nebraska","NE",2020-02-02,2020-02-08,7,2020,"6",1934408,345,0,369,-24,345,0,-1.24068965802457,-0.0650406504065041
"United States","Nebraska","NE",2020-02-09,2020-02-15,7,2020,"7",1934408,327,0,363,-36,327,0,-1.86103448703686,-0.0991735537190083
"United States","Nebraska","NE",2020-02-16,2020-02-22,7,2020,"8",1934408,318,0,357,-39,318,0,-2.01612069428993,-0.109243697478992
"United States","Nebraska","NE",2020-02-23,2020-02-29,7,2020,"9",1934408,341,0,358,-17,341,0,-0.87882184110074,-0.0474860335195531
"United States","Nebraska","NE",2020-03-01,2020-03-07,7,2020,"10",1934408,355,0,357,-2,355,0,-0.103390804835381,-0.00560224089635852
"United States","Nebraska","NE",2020-03-08,2020-03-14,7,2020,"11",1934408,343,0,357,-14,343,0,-0.723735633847668,-0.0392156862745098
"United States","Nebraska","NE",2020-03-15,2020-03-21,7,2020,"12",1934408,350,0,361,-11,350,0,-0.568649426594596,-0.0304709141274239
"United States","Nebraska","NE",2020-03-22,2020-03-28,7,2020,"13",1934408,331,2,359,-28,329,0.103390804835381,-1.44747126769534,-0.0779944289693594
"United States","Nebraska","NE",2020-03-29,2020-04-04,7,2020,"14",1934408,310,4,351,-41,306,0.206781609670762,-2.11951149912531,-0.116809116809117
"United States","Nebraska","NE",2020-04-05,2020-04-11,7,2020,"15",1934408,343,8,341,2,335,0.413563219341525,0.103390804835381,0.00586510263929618
"United States","Nebraska","NE",2020-04-12,2020-04-18,7,2020,"16",1934408,353,0,340,13,353,0,0.672040231429978,0.0382352941176471
"United States","Nebraska","NE",2020-04-19,2020-04-25,7,2020,"17",1934408,353,0,336,17,353,0,0.87882184110074,0.0505952380952381
"United States","Nebraska","NE",2020-04-26,2020-05-02,7,2020,"18",1934408,344,64,330,14,280,3.3085057547322,0.723735633847668,0.0424242424242425
"United States","Nebraska","NE",2020-05-03,2020-05-09,7,2020,"19",1934408,338,18,326,12,320,0.93051724351843,0.620344829012287,0.0368098159509203
"United States","Nebraska","NE",2020-05-10,2020-05-16,7,2020,"20",1934408,352,26,326,26,326,1.34408046285996,1.34408046285996,0.0797546012269938
"United States","Nebraska","NE",2020-05-17,2020-05-23,7,2020,"21",1934408,347,23,323,24,324,1.18899425560688,1.24068965802457,0.0743034055727554
"United States","Nebraska","NE",2020-05-24,2020-05-30,7,2020,"22",1934408,375,21,325,50,354,1.0856034507715,2.58477012088453,0.153846153846154
"United States","Nebraska","NE",2020-05-31,2020-06-06,7,2020,"23",1934408,319,21,323,-4,298,1.0856034507715,-0.206781609670762,-0.0123839009287926
"United States","Nebraska","NE",2020-06-07,2020-06-13,7,2020,"24",1934408,319,29,330,-11,290,1.49916667011303,-0.568649426594596,-0.0333333333333333
"United States","Nebraska","NE",2020-06-14,2020-06-20,7,2020,"25",1934408,371,28,329,42,343,1.44747126769534,2.171206901543,0.127659574468085
"United States","Nebraska","NE",2020-06-21,2020-06-27,7,2020,"26",1934408,320,23,330,-10,297,1.18899425560688,-0.516954024176906,-0.0303030303030303
"United States","Nebraska","NE",2020-06-28,2020-07-04,7,2020,"27",1934408,308,17,327,-19,291,0.87882184110074,-0.982212645936121,-0.0581039755351682
"United States","Nebraska","NE",2020-07-05,2020-07-11,7,2020,"28",1934408,317,1,324,-7,316,0.0516954024176906,-0.361867816923834,-0.0216049382716049
"United States","Nebraska","NE",2020-07-12,2020-07-18,7,2020,"29",1934408,325,15,313,12,310,0.775431036265359,0.620344829012287,0.0383386581469649
"United States","Nebraska","NE",2020-07-19,2020-07-25,7,2020,"30",1934408,361,17,312,49,344,0.87882184110074,2.53307471846684,0.157051282051282
"United States","Nebraska","NE",2020-07-26,2020-08-01,7,2020,"31",1934408,358,16,310,48,342,0.827126438683049,2.48137931604915,0.154838709677419
"United States","Nebraska","NE",2020-08-02,2020-08-08,7,2020,"32",1934408,381,13,311,70,368,0.672040231429978,3.61867816923834,0.22508038585209
"United States","Nebraska","NE",2020-08-09,2020-08-15,7,2020,"33",1934408,354,16,310,44,338,0.827126438683049,2.27459770637839,0.141935483870968
"United States","Nebraska","NE",2020-08-16,2020-08-22,7,2020,"34",1934408,363,15,311,52,348,0.775431036265359,2.68816092571991,0.167202572347267
"United States","Nebraska","NE",2020-08-23,2020-08-29,7,2020,"35",1934408,323,15,312,11,308,0.775431036265359,0.568649426594596,0.0352564102564104
"United States","Nebraska","NE",2020-08-30,2020-09-05,7,2020,"36",1934408,350,12,317,33,338,0.620344829012287,1.70594827978379,0.10410094637224
"United States","Nebraska","NE",2020-09-06,2020-09-12,7,2020,"37",1934408,339,31,317,22,308,1.60255747494841,1.13729885318919,0.0694006309148265
"United States","Nebraska","NE",2020-09-13,2020-09-19,7,2020,"38",1934408,328,8,317,11,320,0.413563219341525,0.568649426594596,0.0347003154574133
"United States","Nebraska","NE",2020-09-20,2020-09-26,7,2020,"39",1934408,378,27,320,58,351,1.39577586527765,2.99833334022605,0.18125
"United States","Nebraska","NE",2020-09-27,2020-10-03,7,2020,"40",1934408,373,28,317,56,345,1.44747126769534,2.89494253539067,0.176656151419558
"United States","Nebraska","NE",2020-10-04,2020-10-10,7,2020,"41",1934408,406,21,322,84,385,1.0856034507715,4.34241380308601,0.260869565217391
"United States","Nebraska","NE",2020-10-11,2020-10-17,7,2020,"42",1934408,401,29,320,81,372,1.49916667011303,4.18732759583294,0.253125
"United States","Nebraska","NE",2020-10-18,2020-10-24,7,2020,"43",1934408,425,48,324,101,377,2.48137931604915,5.22123564418675,0.311728395061728
"United States","Nebraska","NE",2020-10-25,2020-10-31,7,2020,"44",1934408,442,49,324,118,393,2.53307471846684,6.10005748528749,0.364197530864198
"United States","Nebraska","NE",2020-11-01,2020-11-07,7,2020,"45",1934408,498,56,321,177,442,2.89494253539067,9.15008622793123,0.551401869158878
"United States","Nebraska","NE",2020-11-08,2020-11-14,7,2020,"46",1934408,551,77,321,230,474,3.98054598616217,11.8899425560688,0.716510903426791
"United States","Nebraska","NE",2020-11-15,2020-11-21,7,2020,"47",1934408,574,122,326,248,452,6.30683909495825,12.8204597995873,0.760736196319018
"United States","Nebraska","NE",2020-11-22,2020-11-28,7,2020,"48",1934408,565,81,325,240,484,4.18732759583294,12.4068965802457,0.738461538461539
"United States","Nebraska","NE",2020-11-29,2020-12-05,7,2020,"49",1934408,514,211,327,187,303,10.9077299101327,9.66704025210814,0.571865443425077
"United States","Nebraska","NE",2020-12-06,2020-12-12,7,2020,"50",1934408,501,171,335,166,330,8.83991381342509,8.58143680133664,0.495522388059702
"United States","Nebraska","NE",2020-12-13,2020-12-19,7,2020,"51",1934408,460,110,342,118,350,5.68649426594596,6.10005748528749,0.345029239766082
"United States","Nebraska","NE",2020-12-20,2020-12-26,7,2020,"52",1934408,426,81,359,67,345,4.18732759583294,3.46359196198527,0.186629526462396
"United States","Nebraska","NE",2020-12-27,2021-01-02,7,2020,"53",1934408,434,111,367,67,323,5.73818966836365,3.46359196198527,0.182561307901907
"United States","Nebraska","NE",2021-01-03,2021-01-09,7,2021,"1",1934408,447,71,374,73,376,3.67037357165603,3.77376437649141,0.195187165775401
"United States","Nebraska","NE",2021-01-10,2021-01-16,7,2021,"2",1934408,390,87,376,14,303,4.49750001033908,0.723735633847668,0.0372340425531914
"United States","Nebraska","NE",2021-01-17,2021-01-23,7,2021,"3",1934408,407,50,372,35,357,2.58477012088453,1.80933908461917,0.0940860215053763
"United States","Nebraska","NE",2021-01-24,2021-01-30,7,2021,"4",1934408,378,40,364,14,338,2.06781609670762,0.723735633847668,0.0384615384615385
"United States","Nebraska","NE",2021-01-31,2021-02-06,7,2021,"5",1934408,364,46,362,2,318,2.37798851121377,0.103390804835381,0.00552486187845314
"United States","Nebraska","NE",2021-02-07,2021-02-13,7,2021,"6",1934408,341,43,358,-17,298,2.22290230396069,-0.87882184110074,-0.0474860335195531
"United States","Nebraska","NE",2021-02-14,2021-02-20,7,2021,"7",1934408,328,44,355,-27,284,2.27459770637839,-1.39577586527765,-0.076056338028169
"United States","Nebraska","NE",2021-02-21,2021-02-27,7,2021,"8",1934408,318,31,352,-34,287,1.60255747494841,-1.75764368220148,-0.0965909090909091
"United States","Nebraska","NE",2021-02-28,2021-03-06,7,2021,"9",1934408,354,31,357,-3,323,1.60255747494841,-0.155086207253072,-0.00840336134453779
"United States","Nebraska","NE",2021-03-07,2021-03-13,7,2021,"10",1934408,318,19,347,-29,299,0.982212645936121,-1.49916667011303,-0.0835734870317003
"United States","Nebraska","NE",2021-03-14,2021-03-20,7,2021,"11",1934408,332,9,346,-14,323,0.465258621759215,-0.723735633847668,-0.0404624277456648
"United States","Nebraska","NE",2021-03-21,2021-03-27,7,2021,"12",1934408,337,38,342,-5,299,1.96442529187224,-0.258477012088453,-0.0146198830409356
"United States","Nebraska","NE",2021-03-28,2021-04-03,7,2021,"13",1934408,333,12,341,-8,321,0.620344829012287,-0.413563219341525,-0.0234604105571847
"United States","Nebraska","NE",2021-04-04,2021-04-10,7,2021,"14",1934408,325,27,334,-9,298,1.39577586527765,-0.465258621759215,-0.0269461077844312
"United States","Nebraska","NE",2021-04-11,2021-04-17,7,2021,"15",1934408,368,-7,330,38,375,-0.361867816923834,1.96442529187224,0.115151515151515
"United States","Nebraska","NE",2021-04-18,2021-04-24,7,2021,"16",1934408,331,29,323,8,302,1.49916667011303,0.413563219341525,0.0247678018575852
"United States","Nebraska","NE",2021-04-25,2021-05-01,7,2021,"17",1934408,373,3,324,49,370,0.155086207253072,2.53307471846684,0.151234567901235
"United States","Nebraska","NE",2021-05-02,2021-05-08,7,2021,"18",1934408,344,7,314,30,337,0.361867816923834,1.55086207253072,0.0955414012738853
"United States","Nebraska","NE",2021-05-09,2021-05-15,7,2021,"19",1934408,374,33,311,63,341,1.70594827978379,3.25681035231451,0.202572347266881
"United States","Nebraska","NE",2021-05-16,2021-05-22,7,2021,"20",1934408,324,-36,310,14,360,-1.86103448703686,0.723735633847668,0.0451612903225806
"United States","Nebraska","NE",2021-05-23,2021-05-29,7,2021,"21",1934408,328,-12,310,18,340,-0.620344829012287,0.93051724351843,0.0580645161290323
"United States","Nebraska","NE",2021-05-30,2021-06-05,7,2021,"22",1934408,312,0,307,5,312,0,0.258477012088453,0.0162866449511401
"United States","Nebraska","NE",2021-06-06,2021-06-12,7,2021,"23",1934408,317,26,309,8,291,1.34408046285996,0.413563219341525,0.0258899676375404
"United States","Nebraska","NE",2021-06-13,2021-06-19,7,2021,"24",1934408,328,3,315,13,325,0.155086207253072,0.672040231429978,0.0412698412698413
"United States","Nebraska","NE",2021-06-20,2021-06-26,7,2021,"25",1934408,315,0,320,-5,315,0,-0.258477012088453,-0.015625
"United States","Nebraska","NE",2021-06-27,2021-07-03,7,2021,"26",1934408,310,2,319,-9,308,0.103390804835381,-0.465258621759215,-0.0282131661442007
"United States","Nebraska","NE",2021-07-04,2021-07-10,7,2021,"27",1934408,303,1,319,-16,302,0.0516954024176906,-0.827126438683049,-0.0501567398119123
"United States","Nebraska","NE",2021-07-11,2021-07-17,7,2021,"28",1934408,316,13,318,-2,303,0.672040231429978,-0.103390804835381,-0.00628930817610063
"United States","Nebraska","NE",2021-07-18,2021-07-24,7,2021,"29",1934408,327,9,313,14,318,0.465258621759215,0.723735633847668,0.0447284345047922
"United States","Nebraska","NE",2021-07-25,2021-07-31,7,2021,"30",1934408,351,-4,311,40,355,-0.206781609670762,2.06781609670762,0.128617363344051
"United States","Nebraska","NE",2021-08-01,2021-08-07,7,2021,"31",1934408,351,10,301,50,341,0.516954024176906,2.58477012088453,0.166112956810631
"United States","Nebraska","NE",2021-08-08,2021-08-14,7,2021,"32",1934408,327,-5,306,21,332,-0.258477012088453,1.0856034507715,0.0686274509803921
"United States","Nebraska","NE",2021-08-15,2021-08-21,7,2021,"33",1934408,305,0,307,-2,305,0,-0.103390804835381,-0.00651465798045603
"United States","Nevada","NV",2019-12-29,2020-01-04,7,2020,"1",3080156,521,0,598,-77,521,0,-2.49987338303644,-0.12876254180602
"United States","Nevada","NV",2020-01-05,2020-01-11,7,2020,"2",3080156,556,0,600,-44,556,0,-1.42849907602082,-0.0733333333333334
"United States","Nevada","NV",2020-01-12,2020-01-18,7,2020,"3",3080156,605,0,590,15,605,0,0.486988321370736,0.0254237288135593
"United States","Nevada","NV",2020-01-19,2020-01-25,7,2020,"4",3080156,577,0,567,10,577,0,0.324658880913824,0.0176366843033511
"United States","Nevada","NV",2020-01-26,2020-02-01,7,2020,"5",3080156,532,0,555,-23,532,0,-0.746715426101795,-0.0414414414414415
"United States","Nevada","NV",2020-02-02,2020-02-08,7,2020,"6",3080156,579,0,544,35,579,0,1.13630608319838,0.0643382352941178
"United States","Nevada","NV",2020-02-09,2020-02-15,7,2020,"7",3080156,530,0,541,-11,530,0,-0.357124769005206,-0.0203327171903882
"United States","Nevada","NV",2020-02-16,2020-02-22,7,2020,"8",3080156,546,0,539,7,546,0,0.227261216639677,0.0129870129870129
"United States","Nevada","NV",2020-02-23,2020-02-29,7,2020,"9",3080156,544,0,546,-2,544,0,-0.0649317761827648,-0.00366300366300365
"United States","Nevada","NV",2020-03-01,2020-03-07,7,2020,"10",3080156,535,0,546,-11,535,0,-0.357124769005206,-0.0201465201465202
"United States","Nevada","NV",2020-03-08,2020-03-14,7,2020,"11",3080156,515,0,548,-33,515,0,-1.07137430701562,-0.0602189781021898
"United States","Nevada","NV",2020-03-15,2020-03-21,7,2020,"12",3080156,508,2,543,-35,506,0.0649317761827648,-1.13630608319838,-0.0644567219152854
"United States","Nevada","NV",2020-03-22,2020-03-28,7,2020,"13",3080156,543,12,538,5,531,0.389590657096589,0.162329440456912,0.00929368029739774
"United States","Nevada","NV",2020-03-29,2020-04-04,7,2020,"14",3080156,593,32,532,61,561,1.03890841892424,1.98041917357433,0.114661654135338
"United States","Nevada","NV",2020-04-05,2020-04-11,7,2020,"15",3080156,588,56,529,59,532,1.81808973311741,1.91548739739156,0.111531190926276
"United States","Nevada","NV",2020-04-12,2020-04-18,7,2020,"16",3080156,546,66,529,17,480,2.14274861403124,0.551920097553501,0.0321361058601135
"United States","Nevada","NV",2020-04-19,2020-04-25,7,2020,"17",3080156,565,48,518,47,517,1.55836262838635,1.52589674029497,0.0907335907335907
"United States","Nevada","NV",2020-04-26,2020-05-02,7,2020,"18",3080156,547,53,516,31,494,1.72069206884327,1.00644253083285,0.0600775193798451
"United States","Nevada","NV",2020-05-03,2020-05-09,7,2020,"19",3080156,544,49,506,38,495,1.59082851647774,1.23370374747253,0.075098814229249
"United States","Nevada","NV",2020-05-10,2020-05-16,7,2020,"20",3080156,514,44,502,12,470,1.42849907602082,0.389590657096589,0.0239043824701195
"United States","Nevada","NV",2020-05-17,2020-05-23,7,2020,"21",3080156,536,44,502,34,492,1.42849907602082,1.103840195107,0.0677290836653386
"United States","Nevada","NV",2020-05-24,2020-05-30,7,2020,"22",3080156,543,22,501,42,521,0.714249538010412,1.36356729983806,0.0838323353293413
"United States","Nevada","NV",2020-05-31,2020-06-06,7,2020,"23",3080156,562,25,501,61,537,0.81164720228456,1.98041917357433,0.121756487025948
"United States","Nevada","NV",2020-06-07,2020-06-13,7,2020,"24",3080156,543,9,502,41,534,0.292192992822441,1.33110141174668,0.0816733067729083
"United States","Nevada","NV",2020-06-14,2020-06-20,7,2020,"25",3080156,519,23,504,15,496,0.746715426101795,0.486988321370736,0.0297619047619047
"United States","Nevada","NV",2020-06-21,2020-06-27,7,2020,"26",3080156,557,15,498,59,542,0.486988321370736,1.91548739739156,0.118473895582329
"United States","Nevada","NV",2020-06-28,2020-07-04,7,2020,"27",3080156,528,30,501,27,498,0.973976642741472,0.876578978467324,0.0538922155688624
"United States","Nevada","NV",2020-07-05,2020-07-11,7,2020,"28",3080156,633,59,489,144,574,1.91548739739156,4.67508788515906,0.294478527607362
"United States","Nevada","NV",2020-07-12,2020-07-18,7,2020,"29",3080156,640,57,480,160,583,1.8505556212088,5.19454209462118,0.333333333333333
"United States","Nevada","NV",2020-07-19,2020-07-25,7,2020,"30",3080156,657,86,476,181,571,2.79206637585889,5.87632574454021,0.380252100840336
"United States","Nevada","NV",2020-07-26,2020-08-01,7,2020,"31",3080156,620,100,475,145,520,3.24658880913824,4.70755377325045,0.305263157894737
"United States","Nevada","NV",2020-08-02,2020-08-08,7,2020,"32",3080156,694,117,462,232,577,3.79850890669174,7.53208603720071,0.502164502164502
"United States","Nevada","NV",2020-08-09,2020-08-15,7,2020,"33",3080156,662,120,465,197,542,3.89590657096589,6.39577995400233,0.423655913978495
"United States","Nevada","NV",2020-08-16,2020-08-22,7,2020,"34",3080156,648,128,462,186,520,4.15563367569695,6.03865518499712,0.402597402597403
"United States","Nevada","NV",2020-08-23,2020-08-29,7,2020,"35",3080156,633,105,467,166,528,3.40891824959515,5.38933742316948,0.355460385438972
"United States","Nevada","NV",2020-08-30,2020-09-05,7,2020,"36",3080156,640,86,464,176,554,2.79206637585889,5.7139963040833,0.379310344827586
"United States","Nevada","NV",2020-09-06,2020-09-12,7,2020,"37",3080156,559,61,463,96,498,1.98041917357433,3.11672525677271,0.207343412526998
"United States","Nevada","NV",2020-09-13,2020-09-19,7,2020,"38",3080156,537,79,466,71,458,2.56480515921921,2.30507805448815,0.152360515021459
"United States","Nevada","NV",2020-09-20,2020-09-26,7,2020,"39",3080156,528,54,466,62,474,1.75315795693465,2.01288506166571,0.133047210300429
"United States","Nevada","NV",2020-09-27,2020-10-03,7,2020,"40",3080156,564,38,469,95,526,1.23370374747253,3.08425936868133,0.202558635394456
"United States","Nevada","NV",2020-10-04,2020-10-10,7,2020,"41",3080156,558,39,464,94,519,1.26616963556391,3.05179348058994,0.202586206896552
"United States","Nevada","NV",2020-10-11,2020-10-17,7,2020,"42",3080156,526,48,469,57,478,1.55836262838635,1.8505556212088,0.121535181236674
"United States","Nevada","NV",2020-10-18,2020-10-24,7,2020,"43",3080156,541,36,472,69,505,1.16877197128977,2.24014627830538,0.146186440677966
"United States","Nevada","NV",2020-10-25,2020-10-31,7,2020,"44",3080156,604,34,463,141,570,1.103840195107,4.57769022088492,0.304535637149028
"United States","Nevada","NV",2020-11-01,2020-11-07,7,2020,"45",3080156,555,71,467,88,484,2.30507805448815,2.85699815204165,0.188436830835118
"United States","Nevada","NV",2020-11-08,2020-11-14,7,2020,"46",3080156,631,57,480,151,574,1.8505556212088,4.90234910179874,0.314583333333333
"United States","Nevada","NV",2020-11-15,2020-11-21,7,2020,"47",3080156,663,102,485,178,561,3.311520585321,5.77892808026606,0.367010309278351
"United States","Nevada","NV",2020-11-22,2020-11-28,7,2020,"48",3080156,744,105,484,260,639,3.40891824959515,8.44113090375942,0.537190082644628
"United States","Nevada","NV",2020-11-29,2020-12-05,7,2020,"49",3080156,773,170,495,278,603,5.51920097553501,9.0255168894043,0.561616161616162
"United States","Nevada","NV",2020-12-06,2020-12-12,7,2020,"50",3080156,908,214,501,407,694,6.94770005155583,13.2136164531926,0.812375249500998
"United States","Nevada","NV",2020-12-13,2020-12-19,7,2020,"51",3080156,845,222,513,332,623,7.20742715628689,10.778674846339,0.647173489278752
"United States","Nevada","NV",2020-12-20,2020-12-26,7,2020,"52",3080156,867,185,529,338,682,6.00618929690574,10.9734701748872,0.638941398865785
"United States","Nevada","NV",2020-12-27,2021-01-02,7,2020,"53",3080156,856,199,554,302,657,6.46071173018509,9.80469820359748,0.545126353790614
"United States","Nevada","NV",2021-01-03,2021-01-09,7,2021,"1",3080156,885,278,561,324,607,9.0255168894043,10.5189477416079,0.577540106951872
"United States","Nevada","NV",2021-01-10,2021-01-16,7,2021,"2",3080156,845,300,570,275,545,9.73976642741471,8.92811922513016,0.482456140350877
"United States","Nevada","NV",2021-01-17,2021-01-23,7,2021,"3",3080156,825,243,567,258,582,7.88921080620592,8.37619912757665,0.455026455026455
"United States","Nevada","NV",2021-01-24,2021-01-30,7,2021,"4",3080156,782,244,554,228,538,7.9216766942973,7.40222248483518,0.411552346570397
"United States","Nevada","NV",2021-01-31,2021-02-06,7,2021,"5",3080156,719,198,540,179,521,6.42824584209371,5.81139396835745,0.331481481481481
"United States","Nevada","NV",2021-02-07,2021-02-13,7,2021,"6",3080156,702,227,543,159,475,7.3697565967438,5.1620762065298,0.292817679558011
"United States","Nevada","NV",2021-02-14,2021-02-20,7,2021,"7",3080156,637,172,532,105,465,5.58413275171777,3.40891824959515,0.197368421052632
"United States","Nevada","NV",2021-02-21,2021-02-27,7,2021,"8",3080156,667,90,526,141,577,2.92192992822441,4.57769022088492,0.268060836501901
"United States","Nevada","NV",2021-02-28,2021-03-06,7,2021,"9",3080156,558,77,535,23,481,2.49987338303644,0.746715426101795,0.0429906542056075
"United States","Nevada","NV",2021-03-07,2021-03-13,7,2021,"10",3080156,606,60,531,75,546,1.94795328548294,2.43494160685368,0.141242937853107
"United States","Nevada","NV",2021-03-14,2021-03-20,7,2021,"11",3080156,600,71,531,69,529,2.30507805448815,2.24014627830538,0.129943502824859
"United States","Nevada","NV",2021-03-21,2021-03-27,7,2021,"12",3080156,558,61,522,36,497,1.98041917357433,1.16877197128977,0.0689655172413792
"United States","Nevada","NV",2021-03-28,2021-04-03,7,2021,"13",3080156,580,38,521,59,542,1.23370374747253,1.91548739739156,0.113243761996161
"United States","Nevada","NV",2021-04-04,2021-04-10,7,2021,"14",3080156,549,171,516,33,378,5.55166686362639,1.07137430701562,0.0639534883720929
"United States","Nevada","NV",2021-04-11,2021-04-17,7,2021,"15",3080156,540,33,519,21,507,1.07137430701562,0.68178364991903,0.0404624277456647
"United States","Nevada","NV",2021-04-18,2021-04-24,7,2021,"16",3080156,583,57,515,68,526,1.8505556212088,2.207680390214,0.132038834951456
"United States","Nevada","NV",2021-04-25,2021-05-01,7,2021,"17",3080156,557,42,506,51,515,1.36356729983806,1.6557602926605,0.100790513833992
"United States","Nevada","NV",2021-05-02,2021-05-08,7,2021,"18",3080156,595,34,499,96,561,1.103840195107,3.11672525677271,0.192384769539078
"United States","Nevada","NV",2021-05-09,2021-05-15,7,2021,"19",3080156,561,32,498,63,529,1.03890841892424,2.04535094975709,0.126506024096386
"United States","Nevada","NV",2021-05-16,2021-05-22,7,2021,"20",3080156,515,22,495,20,493,0.714249538010412,0.649317761827648,0.0404040404040404
"United States","Nevada","NV",2021-05-23,2021-05-29,7,2021,"21",3080156,503,34,501,2,469,1.103840195107,0.0649317761827648,0.00399201596806398
"United States","Nevada","NV",2021-05-30,2021-06-05,7,2021,"22",3080156,574,14,503,71,560,0.454522433279353,2.30507805448815,0.141153081510934
"United States","Nevada","NV",2021-06-06,2021-06-12,7,2021,"23",3080156,552,22,510,42,530,0.714249538010412,1.36356729983806,0.0823529411764705
"United States","Nevada","NV",2021-06-13,2021-06-19,7,2021,"24",3080156,571,27,525,46,544,0.876578978467324,1.49343085220359,0.0876190476190477
"United States","Nevada","NV",2021-06-20,2021-06-26,7,2021,"25",3080156,546,18,524,22,528,0.584385985644883,0.714249538010412,0.0419847328244274
"United States","Nevada","NV",2021-06-27,2021-07-03,7,2021,"26",3080156,563,30,515,48,533,0.973976642741472,1.55836262838635,0.0932038834951456
"United States","Nevada","NV",2021-07-04,2021-07-10,7,2021,"27",3080156,621,23,508,113,598,0.746715426101795,3.66864535432621,0.22244094488189
"United States","Nevada","NV",2021-07-11,2021-07-17,7,2021,"28",3080156,696,38,506,190,658,1.23370374747253,6.16851873736265,0.375494071146245
"United States","Nevada","NV",2021-07-18,2021-07-24,7,2021,"29",3080156,614,59,508,106,555,1.91548739739156,3.44138413768653,0.208661417322835
"United States","Nevada","NV",2021-07-25,2021-07-31,7,2021,"30",3080156,663,95,500,163,568,3.08425936868133,5.29193975889533,0.326
"United States","Nevada","NV",2021-08-01,2021-08-07,7,2021,"31",3080156,630,93,497,133,537,3.01932759249856,4.31796311615386,0.267605633802817
"United States","Nevada","NV",2021-08-08,2021-08-14,7,2021,"32",3080156,662,155,490,172,507,5.03221265416427,5.58413275171777,0.351020408163265
"United States","Nevada","NV",2021-08-15,2021-08-21,7,2021,"33",3080156,658,30,487,171,628,0.973976642741472,5.55166686362639,0.351129363449692
"United States","New Hampshire","NH",2019-12-29,2020-01-04,7,2020,"1",1359711,260,0,268,-8,260,0,-0.588360320685793,-0.0298507462686567
"United States","New Hampshire","NH",2020-01-05,2020-01-11,7,2020,"2",1359711,263,0,270,-7,263,0,-0.514815280600069,-0.0259259259259259
"United States","New Hampshire","NH",2020-01-12,2020-01-18,7,2020,"3",1359711,245,0,271,-26,245,0,-1.91217104222883,-0.0959409594095941
"United States","New Hampshire","NH",2020-01-19,2020-01-25,7,2020,"4",1359711,241,0,273,-32,241,0,-2.35344128274317,-0.117216117216117
"United States","New Hampshire","NH",2020-01-26,2020-02-01,7,2020,"5",1359711,240,0,273,-33,240,0,-2.4269863228289,-0.120879120879121
"United States","New Hampshire","NH",2020-02-02,2020-02-08,7,2020,"6",1359711,256,0,254,2,256,0,0.147090080171448,0.00787401574803148
"United States","New Hampshire","NH",2020-02-09,2020-02-15,7,2020,"7",1359711,236,0,275,-39,236,0,-2.86825656334324,-0.141818181818182
"United States","New Hampshire","NH",2020-02-16,2020-02-22,7,2020,"8",1359711,277,0,271,6,277,0,0.441270240514345,0.0221402214022139
"United States","New Hampshire","NH",2020-02-23,2020-02-29,7,2020,"9",1359711,228,0,266,-38,228,0,-2.79471152325752,-0.142857142857143
"United States","New Hampshire","NH",2020-03-01,2020-03-07,7,2020,"10",1359711,266,0,259,7,266,0,0.514815280600069,0.027027027027027
"United States","New Hampshire","NH",2020-03-08,2020-03-14,7,2020,"11",1359711,240,0,249,-9,240,0,-0.661905360771517,-0.036144578313253
"United States","New Hampshire","NH",2020-03-15,2020-03-21,7,2020,"12",1359711,252,0,249,3,252,0,0.220635120257172,0.0120481927710843
"United States","New Hampshire","NH",2020-03-22,2020-03-28,7,2020,"13",1359711,258,3,246,12,255,0.220635120257172,0.882540481028689,0.0487804878048781
"United States","New Hampshire","NH",2020-03-29,2020-04-04,7,2020,"14",1359711,248,6,247,1,242,0.441270240514345,0.0735450400857241,0.00404858299595134
"United States","New Hampshire","NH",2020-04-05,2020-04-11,7,2020,"15",1359711,270,14,254,16,256,1.02963056120014,1.17672064137159,0.0629921259842521
"United States","New Hampshire","NH",2020-04-12,2020-04-18,7,2020,"16",1359711,242,15,254,-12,227,1.10317560128586,-0.882540481028689,-0.047244094488189
"United States","New Hampshire","NH",2020-04-19,2020-04-25,7,2020,"17",1359711,274,22,249,25,252,1.61799088188593,1.8386260021431,0.100401606425703
"United States","New Hampshire","NH",2020-04-26,2020-05-02,7,2020,"18",1359711,266,24,250,16,242,1.76508096205738,1.17672064137159,0.0640000000000001
"United States","New Hampshire","NH",2020-05-03,2020-05-09,7,2020,"19",1359711,292,47,246,46,245,3.45661688402903,3.38307184394331,0.186991869918699
"United States","New Hampshire","NH",2020-05-10,2020-05-16,7,2020,"20",1359711,285,40,239,46,245,2.94180160342896,3.38307184394331,0.192468619246862
"United States","New Hampshire","NH",2020-05-17,2020-05-23,7,2020,"21",1359711,268,37,234,34,231,2.72116648317179,2.50053136291462,0.145299145299145
"United States","New Hampshire","NH",2020-05-24,2020-05-30,7,2020,"22",1359711,250,34,232,18,216,2.50053136291462,1.32381072154303,0.0775862068965518
"United States","New Hampshire","NH",2020-05-31,2020-06-06,7,2020,"23",1359711,259,41,231,28,218,3.01534664351469,2.05926112240028,0.121212121212121
"United States","New Hampshire","NH",2020-06-07,2020-06-13,7,2020,"24",1359711,302,35,227,75,267,2.57407640300034,5.51587800642931,0.330396475770925
"United States","New Hampshire","NH",2020-06-14,2020-06-20,7,2020,"25",1359711,238,21,232,6,217,1.54444584180021,0.441270240514345,0.0258620689655173
"United States","New Hampshire","NH",2020-06-21,2020-06-27,7,2020,"26",1359711,250,28,239,11,222,2.05926112240028,0.808995440942965,0.0460251046025104
"United States","New Hampshire","NH",2020-06-28,2020-07-04,7,2020,"27",1359711,247,9,238,9,238,0.661905360771517,0.661905360771517,0.0378151260504203
"United States","New Hampshire","NH",2020-07-05,2020-07-11,7,2020,"28",1359711,249,15,240,9,234,1.10317560128586,0.661905360771517,0.0375000000000001
"United States","New Hampshire","NH",2020-07-12,2020-07-18,7,2020,"29",1359711,231,5,242,-11,226,0.367725200428621,-0.808995440942965,-0.0454545454545454
"United States","New Hampshire","NH",2020-07-19,2020-07-25,7,2020,"30",1359711,266,13,240,26,253,0.956085521114413,1.91217104222883,0.108333333333333
"United States","New Hampshire","NH",2020-07-26,2020-08-01,7,2020,"31",1359711,248,7,240,8,241,0.514815280600069,0.588360320685793,0.0333333333333334
"United States","New Hampshire","NH",2020-08-02,2020-08-08,7,2020,"32",1359711,233,3,239,-6,230,0.220635120257172,-0.441270240514345,-0.0251046025104602
"United States","New Hampshire","NH",2020-08-09,2020-08-15,7,2020,"33",1359711,230,4,240,-10,226,0.294180160342896,-0.735450400857241,-0.0416666666666666
"United States","New Hampshire","NH",2020-08-16,2020-08-22,7,2020,"34",1359711,250,6,236,14,244,0.441270240514345,1.02963056120014,0.0593220338983051
"United States","New Hampshire","NH",2020-08-23,2020-08-29,7,2020,"35",1359711,231,3,240,-9,228,0.220635120257172,-0.661905360771517,-0.0375
"United States","New Hampshire","NH",2020-08-30,2020-09-05,7,2020,"36",1359711,234,0,242,-8,234,0,-0.588360320685793,-0.0330578512396694
"United States","New Hampshire","NH",2020-09-06,2020-09-12,7,2020,"37",1359711,228,3,242,-14,225,0.220635120257172,-1.02963056120014,-0.0578512396694215
"United States","New Hampshire","NH",2020-09-13,2020-09-19,7,2020,"38",1359711,226,3,241,-15,223,0.220635120257172,-1.10317560128586,-0.0622406639004149
"United States","New Hampshire","NH",2020-09-20,2020-09-26,7,2020,"39",1359711,273,1,245,28,272,0.0735450400857241,2.05926112240028,0.114285714285714
"United States","New Hampshire","NH",2020-09-27,2020-10-03,7,2020,"40",1359711,222,3,244,-22,219,0.220635120257172,-1.61799088188593,-0.0901639344262295
"United States","New Hampshire","NH",2020-10-04,2020-10-10,7,2020,"41",1359711,255,13,243,12,242,0.956085521114413,0.882540481028689,0.0493827160493827
"United States","New Hampshire","NH",2020-10-11,2020-10-17,7,2020,"42",1359711,253,11,249,4,242,0.808995440942965,0.294180160342896,0.0160642570281124
"United States","New Hampshire","NH",2020-10-18,2020-10-24,7,2020,"43",1359711,234,7,248,-14,227,0.514815280600069,-1.02963056120014,-0.0564516129032258
"United States","New Hampshire","NH",2020-10-25,2020-10-31,7,2020,"44",1359711,257,10,244,13,247,0.735450400857241,0.956085521114413,0.0532786885245902
"United States","New Hampshire","NH",2020-11-01,2020-11-07,7,2020,"45",1359711,263,6,240,23,257,0.441270240514345,1.69153592197165,0.0958333333333334
"United States","New Hampshire","NH",2020-11-08,2020-11-14,7,2020,"46",1359711,285,10,241,44,275,0.735450400857241,3.23598176377186,0.182572614107884
"United States","New Hampshire","NH",2020-11-15,2020-11-21,7,2020,"47",1359711,259,9,241,18,250,0.661905360771517,1.32381072154303,0.0746887966804979
"United States","New Hampshire","NH",2020-11-22,2020-11-28,7,2020,"48",1359711,284,6,243,41,278,0.441270240514345,3.01534664351469,0.168724279835391
"United States","New Hampshire","NH",2020-11-29,2020-12-05,7,2020,"49",1359711,313,45,244,69,268,3.30952680385758,5.07460776591496,0.282786885245902
"United States","New Hampshire","NH",2020-12-06,2020-12-12,7,2020,"50",1359711,312,41,253,59,271,3.01534664351469,4.33915736505772,0.233201581027668
"United States","New Hampshire","NH",2020-12-13,2020-12-19,7,2020,"51",1359711,288,50,255,33,238,3.6772520042862,2.4269863228289,0.129411764705882
"United States","New Hampshire","NH",2020-12-20,2020-12-26,7,2020,"52",1359711,357,6,254,103,351,0.441270240514345,7.57513912882958,0.405511811023622
"United States","New Hampshire","NH",2020-12-27,2021-01-02,7,2020,"53",1359711,305,113,259,46,192,8.31058952968682,3.38307184394331,0.177606177606178
"United States","New Hampshire","NH",2021-01-03,2021-01-09,7,2021,"1",1359711,323,77,264,59,246,5.66296808660076,4.33915736505772,0.223484848484848
"United States","New Hampshire","NH",2021-01-10,2021-01-16,7,2021,"2",1359711,357,81,263,94,276,5.95714824694365,6.91323376805807,0.357414448669201
"United States","New Hampshire","NH",2021-01-17,2021-01-23,7,2021,"3",1359711,296,44,266,30,252,3.23598176377186,2.20635120257172,0.112781954887218
"United States","New Hampshire","NH",2021-01-24,2021-01-30,7,2021,"4",1359711,272,71,267,5,201,5.22169784608641,0.367725200428621,0.0187265917602997
"United States","New Hampshire","NH",2021-01-31,2021-02-06,7,2021,"5",1359711,289,56,267,22,233,4.11852224480055,1.61799088188593,0.0823970037453183
"United States","New Hampshire","NH",2021-02-07,2021-02-13,7,2021,"6",1359711,257,32,269,-12,225,2.35344128274317,-0.882540481028689,-0.0446096654275093
"United States","New Hampshire","NH",2021-02-14,2021-02-20,7,2021,"7",1359711,264,23,258,6,241,1.69153592197165,0.441270240514345,0.0232558139534884
"United States","New Hampshire","NH",2021-02-21,2021-02-27,7,2021,"8",1359711,244,17,256,-12,227,1.25026568145731,-0.882540481028689,-0.046875
"United States","New Hampshire","NH",2021-02-28,2021-03-06,7,2021,"9",1359711,246,11,253,-7,235,0.808995440942965,-0.514815280600069,-0.0276679841897233
"United States","New Hampshire","NH",2021-03-07,2021-03-13,7,2021,"10",1359711,238,14,244,-6,224,1.02963056120014,-0.441270240514345,-0.0245901639344263
"United States","New Hampshire","NH",2021-03-14,2021-03-20,7,2021,"11",1359711,234,22,239,-5,212,1.61799088188593,-0.367725200428621,-0.0209205020920502
"United States","New Hampshire","NH",2021-03-21,2021-03-27,7,2021,"12",1359711,249,14,241,8,235,1.02963056120014,0.588360320685793,0.0331950207468881
"United States","New Hampshire","NH",2021-03-28,2021-04-03,7,2021,"13",1359711,218,16,233,-15,202,1.17672064137159,-1.10317560128586,-0.0643776824034334
"United States","New Hampshire","NH",2021-04-04,2021-04-10,7,2021,"14",1359711,233,9,235,-2,224,0.661905360771517,-0.147090080171448,-0.00851063829787235
"United States","New Hampshire","NH",2021-04-11,2021-04-17,7,2021,"15",1359711,228,10,237,-9,218,0.735450400857241,-0.661905360771517,-0.0379746835443038
"United States","New Hampshire","NH",2021-04-18,2021-04-24,7,2021,"16",1359711,258,16,237,21,242,1.17672064137159,1.54444584180021,0.0886075949367089
"United States","New Hampshire","NH",2021-04-25,2021-05-01,7,2021,"17",1359711,250,22,236,14,228,1.61799088188593,1.02963056120014,0.0593220338983051
"United States","New Hampshire","NH",2021-05-02,2021-05-08,7,2021,"18",1359711,249,10,236,13,239,0.735450400857241,0.956085521114413,0.0550847457627119
"United States","New Hampshire","NH",2021-05-09,2021-05-15,7,2021,"19",1359711,235,20,230,5,215,1.47090080171448,0.367725200428621,0.0217391304347827
"United States","New Hampshire","NH",2021-05-16,2021-05-22,7,2021,"20",1359711,274,13,223,51,261,0.956085521114413,3.75079704437193,0.228699551569507
"United States","New Hampshire","NH",2021-05-23,2021-05-29,7,2021,"21",1359711,232,8,218,14,224,0.588360320685793,1.02963056120014,0.0642201834862386
"United States","New Hampshire","NH",2021-05-30,2021-06-05,7,2021,"22",1359711,250,3,218,32,247,0.220635120257172,2.35344128274317,0.146788990825688
"United States","New Hampshire","NH",2021-06-06,2021-06-12,7,2021,"23",1359711,255,5,217,38,250,0.367725200428621,2.79471152325752,0.175115207373272
"United States","New Hampshire","NH",2021-06-13,2021-06-19,7,2021,"24",1359711,244,7,215,29,237,0.514815280600069,2.132806162486,0.134883720930232
"United States","New Hampshire","NH",2021-06-20,2021-06-26,7,2021,"25",1359711,240,4,217,23,236,0.294180160342896,1.69153592197165,0.105990783410138
"United States","New Hampshire","NH",2021-06-27,2021-07-03,7,2021,"26",1359711,259,1,223,36,258,0.0735450400857241,2.64762144308607,0.161434977578475
"United States","New Hampshire","NH",2021-07-04,2021-07-10,7,2021,"27",1359711,247,3,222,25,244,0.220635120257172,1.8386260021431,0.112612612612613
"United States","New Hampshire","NH",2021-07-11,2021-07-17,7,2021,"28",1359711,241,6,221,20,235,0.441270240514345,1.47090080171448,0.090497737556561
"United States","New Hampshire","NH",2021-07-18,2021-07-24,7,2021,"29",1359711,252,4,228,24,248,0.294180160342896,1.76508096205738,0.105263157894737
"United States","New Hampshire","NH",2021-07-25,2021-07-31,7,2021,"30",1359711,234,2,228,6,232,0.147090080171448,0.441270240514345,0.0263157894736843
"United States","New Hampshire","NH",2021-08-01,2021-08-07,7,2021,"31",1359711,254,2,229,25,252,0.147090080171448,1.8386260021431,0.109170305676856
"United States","New Hampshire","NH",2021-08-08,2021-08-14,7,2021,"32",1359711,268,6,230,38,262,0.441270240514345,2.79471152325752,0.165217391304348
"United States","New Hampshire","NH",2021-08-15,2021-08-21,7,2021,"33",1359711,265,0,233,32,265,0,2.35344128274317,0.137339055793992
"United States","New Jersey","NJ",2019-12-29,2020-01-04,7,2020,"1",8882190,1628,0,1653,-25,1628,0,-0.28146211688784,-0.015124016938899
"United States","New Jersey","NJ",2020-01-05,2020-01-11,7,2020,"2",8882190,1588,0,1675,-87,1588,0,-0.979488166769682,-0.0519402985074627
"United States","New Jersey","NJ",2020-01-12,2020-01-18,7,2020,"3",8882190,1490,0,1684,-194,1490,0,-2.18414602704964,-0.11520190023753
"United States","New Jersey","NJ",2020-01-19,2020-01-25,7,2020,"4",8882190,1579,0,1673,-94,1579,0,-1.05829755949828,-0.0561864913329349
"United States","New Jersey","NJ",2020-01-26,2020-02-01,7,2020,"5",8882190,1517,0,1644,-127,1517,0,-1.42982755379023,-0.0772506082725061
"United States","New Jersey","NJ",2020-02-02,2020-02-08,7,2020,"6",8882190,1495,0,1625,-130,1495,0,-1.46360300781677,-0.08
"United States","New Jersey","NJ",2020-02-09,2020-02-15,7,2020,"7",8882190,1488,0,1591,-103,1488,0,-1.1596239215779,-0.0647391577624136
"United States","New Jersey","NJ",2020-02-16,2020-02-22,7,2020,"8",8882190,1494,0,1578,-84,1494,0,-0.945712712743141,-0.0532319391634981
"United States","New Jersey","NJ",2020-02-23,2020-02-29,7,2020,"9",8882190,1571,0,1545,26,1571,0,0.292720601563353,0.0168284789644013
"United States","New Jersey","NJ",2020-03-01,2020-03-07,7,2020,"10",8882190,1509,0,1541,-32,1509,0,-0.360271509616435,-0.0207657365347177
"United States","New Jersey","NJ",2020-03-08,2020-03-14,7,2020,"11",8882190,1477,1,1532,-55,1476,0.0112584846755136,-0.619216657153247,-0.0359007832898173
"United States","New Jersey","NJ",2020-03-15,2020-03-21,7,2020,"12",8882190,1600,15,1516,84,1585,0.168877270132704,0.945712712743141,0.0554089709762533
"United States","New Jersey","NJ",2020-03-22,2020-03-28,7,2020,"13",8882190,2124,124,1510,614,2000,1.39605209976368,6.91270959076534,0.406622516556291
"United States","New Jersey","NJ",2020-03-29,2020-04-04,7,2020,"14",8882190,3484,697,1496,1988,2787,7.84716381883297,22.381867534921,1.32887700534759
"United States","New Jersey","NJ",2020-04-05,2020-04-11,7,2020,"15",8882190,4774,1346,1477,3297,3428,15.1539203732413,37.1192239751683,2.23222748815166
"United States","New Jersey","NJ",2020-04-12,2020-04-18,7,2020,"16",8882190,4733,1888,1470,3263,2845,21.2560190673696,36.7364354962008,2.21972789115646
"United States","New Jersey","NJ",2020-04-19,2020-04-25,7,2020,"17",8882190,3979,1795,1446,2533,2184,20.2089799925469,28.5177416830759,1.75172890733057
"United States","New Jersey","NJ",2020-04-26,2020-05-02,7,2020,"18",8882190,3181,1876,1422,1759,1305,21.1209172512635,19.8036745442284,1.23699015471167
"United States","New Jersey","NJ",2020-05-03,2020-05-09,7,2020,"19",8882190,2603,1373,1406,1197,1230,15.4578994594802,13.4764061565898,0.851351351351351
"United States","New Jersey","NJ",2020-05-10,2020-05-16,7,2020,"20",8882190,2287,1134,1394,893,1153,12.7671216220324,10.0538268152336,0.640602582496413
"United States","New Jersey","NJ",2020-05-17,2020-05-23,7,2020,"21",8882190,1937,831,1377,560,1106,9.35580076535179,6.30475141828761,0.406681190994916
"United States","New Jersey","NJ",2020-05-24,2020-05-30,7,2020,"22",8882190,1746,553,1375,371,1193,6.22594202555901,4.17689781461554,0.269818181818182
"United States","New Jersey","NJ",2020-05-31,2020-06-06,7,2020,"23",8882190,1587,472,1384,203,1115,5.31400476684241,2.28547238912926,0.146676300578035
"United States","New Jersey","NJ",2020-06-07,2020-06-13,7,2020,"24",8882190,1486,482,1368,118,1004,5.42658961359755,1.3285011917106,0.0862573099415205
"United States","New Jersey","NJ",2020-06-14,2020-06-20,7,2020,"25",8882190,1412,269,1376,36,1143,3.02853237771315,0.405305448318489,0.0261627906976745
"United States","New Jersey","NJ",2020-06-21,2020-06-27,7,2020,"26",8882190,1445,2092,1373,72,-647,23.5527499411744,0.810610896636978,0.0524399126001456
"United States","New Jersey","NJ",2020-06-28,2020-07-04,7,2020,"27",8882190,1407,241,1369,38,1166,2.71329480679877,0.427822417669516,0.0277574872169466
"United States","New Jersey","NJ",2020-07-05,2020-07-11,7,2020,"28",8882190,1389,336,1373,16,1053,3.78285085097256,0.180135754808217,0.0116533139111434
"United States","New Jersey","NJ",2020-07-12,2020-07-18,7,2020,"29",8882190,1324,174,1372,-48,1150,1.95897633353936,-0.540407264424652,-0.0349854227405247
"United States","New Jersey","NJ",2020-07-19,2020-07-25,7,2020,"30",8882190,1370,77,1359,11,1293,0.866903320014546,0.123843331430649,0.00809418690213382
"United States","New Jersey","NJ",2020-07-26,2020-08-01,7,2020,"31",8882190,1392,54,1366,26,1338,0.607958172477734,0.292720601563353,0.0190336749633968
"United States","New Jersey","NJ",2020-08-02,2020-08-08,7,2020,"32",8882190,1344,39,1365,-21,1305,0.43908090234503,-0.236428178185785,-0.0153846153846153
"United States","New Jersey","NJ",2020-08-09,2020-08-15,7,2020,"33",8882190,1308,41,1372,-64,1267,0.461597871696057,-0.720543019232869,-0.0466472303206997
"United States","New Jersey","NJ",2020-08-16,2020-08-22,7,2020,"34",8882190,1341,33,1379,-38,1308,0.371529994291948,-0.427822417669516,-0.0275562001450327
"United States","New Jersey","NJ",2020-08-23,2020-08-29,7,2020,"35",8882190,1335,-10,1372,-37,1345,-0.112584846755136,-0.416563932994003,-0.0269679300291545
"United States","New Jersey","NJ",2020-08-30,2020-09-05,7,2020,"36",8882190,1397,52,1369,28,1345,0.585441203126706,0.31523757091438,0.0204528853177501
"United States","New Jersey","NJ",2020-09-06,2020-09-12,7,2020,"37",8882190,1389,42,1364,25,1347,0.472856356371571,0.28146211688784,0.0183284457478006
"United States","New Jersey","NJ",2020-09-13,2020-09-19,7,2020,"38",8882190,1378,37,1359,19,1341,0.416563932994003,0.213911208834758,0.013980868285504
"United States","New Jersey","NJ",2020-09-20,2020-09-26,7,2020,"39",8882190,1395,39,1352,43,1356,0.43908090234503,0.484114841047084,0.0318047337278107
"United States","New Jersey","NJ",2020-09-27,2020-10-03,7,2020,"40",8882190,1330,32,1350,-20,1298,0.360271509616435,-0.225169693510272,-0.0148148148148148
"United States","New Jersey","NJ",2020-10-04,2020-10-10,7,2020,"41",8882190,1401,36,1364,37,1365,0.405305448318489,0.416563932994003,0.0271260997067448
"United States","New Jersey","NJ",2020-10-11,2020-10-17,7,2020,"42",8882190,1341,33,1374,-33,1308,0.371529994291948,-0.371529994291948,-0.0240174672489083
"United States","New Jersey","NJ",2020-10-18,2020-10-24,7,2020,"43",8882190,1470,77,1377,93,1393,0.866903320014546,1.04703907482276,0.0675381263616557
"United States","New Jersey","NJ",2020-10-25,2020-10-31,7,2020,"44",8882190,1434,67,1387,47,1367,0.75431847325941,0.529148779749138,0.033886085075703
"United States","New Jersey","NJ",2020-11-01,2020-11-07,7,2020,"45",8882190,1567,77,1406,161,1490,0.866903320014546,1.81261603275769,0.114509246088193
"United States","New Jersey","NJ",2020-11-08,2020-11-14,7,2020,"46",8882190,1632,123,1426,206,1509,1.38479361508817,2.3192478431558,0.144460028050491
"United States","New Jersey","NJ",2020-11-15,2020-11-21,7,2020,"47",8882190,1677,198,1440,237,1479,2.22917996575169,2.66826086809672,0.164583333333333
"United States","New Jersey","NJ",2020-11-22,2020-11-28,7,2020,"48",8882190,1697,219,1453,244,1478,2.46560814393747,2.74707026082531,0.167928423950447
"United States","New Jersey","NJ",2020-11-29,2020-12-05,7,2020,"49",8882190,1904,339,1470,434,1565,3.8166263049991,4.8861823491729,0.295238095238095
"United States","New Jersey","NJ",2020-12-06,2020-12-12,7,2020,"50",8882190,2026,427,1478,548,1599,4.8073729564443,6.16964960218144,0.370771312584574
"United States","New Jersey","NJ",2020-12-13,2020-12-19,7,2020,"51",8882190,2094,442,1490,604,1652,4.976250226577,6.8001247440102,0.405369127516779
"United States","New Jersey","NJ",2020-12-20,2020-12-26,7,2020,"52",8882190,2065,438,1502,563,1627,4.93121628787495,6.33852687231415,0.374833555259654
"United States","New Jersey","NJ",2020-12-27,2021-01-02,7,2020,"53",8882190,2215,576,1526,689,1639,6.48488717309582,7.75709594142886,0.451507208387942
"United States","New Jersey","NJ",2021-01-03,2021-01-09,7,2021,"1",8882190,2056,667,1540,516,1389,7.50940927856756,5.80937809256501,0.335064935064935
"United States","New Jersey","NJ",2021-01-10,2021-01-16,7,2021,"2",8882190,2160,560,1560,600,1600,6.30475141828761,6.75509080530815,0.384615384615385
"United States","New Jersey","NJ",2021-01-17,2021-01-23,7,2021,"3",8882190,1989,520,1573,416,1469,5.85441203126706,4.68352962501365,0.264462809917355
"United States","New Jersey","NJ",2021-01-24,2021-01-30,7,2021,"4",8882190,2006,521,1578,428,1485,5.86567051594258,4.81863144111981,0.271229404309252
"United States","New Jersey","NJ",2021-01-31,2021-02-06,7,2021,"5",8882190,2029,509,1580,449,1520,5.73056869983641,5.0550596193056,0.284177215189873
"United States","New Jersey","NJ",2021-02-07,2021-02-13,7,2021,"6",8882190,1862,476,1581,281,1386,5.35903870554447,3.16363419381932,0.177735610373182
"United States","New Jersey","NJ",2021-02-14,2021-02-20,7,2021,"7",8882190,1822,395,1563,259,1427,4.44710144682787,2.91594753095802,0.165706973768394
"United States","New Jersey","NJ",2021-02-21,2021-02-27,7,2021,"8",8882190,1796,404,1541,255,1392,4.54842780890749,2.87091359225596,0.165476963011032
"United States","New Jersey","NJ",2021-02-28,2021-03-06,7,2021,"9",8882190,1711,318,1516,195,1393,3.58019812681332,2.19540451172515,0.128627968337731
"United States","New Jersey","NJ",2021-03-07,2021-03-13,7,2021,"10",8882190,1583,331,1495,88,1252,3.726558427595,0.990746651445195,0.0588628762541805
"United States","New Jersey","NJ",2021-03-14,2021-03-20,7,2021,"11",8882190,1682,246,1480,202,1436,2.76958723017634,2.27421390445374,0.136486486486487
"United States","New Jersey","NJ",2021-03-21,2021-03-27,7,2021,"12",8882190,1632,248,1473,159,1384,2.79210419952737,1.79009906340666,0.107942973523422
"United States","New Jersey","NJ",2021-03-28,2021-04-03,7,2021,"13",8882190,1596,255,1463,133,1341,2.87091359225596,1.49737846184331,0.0909090909090908
"United States","New Jersey","NJ",2021-04-04,2021-04-10,7,2021,"14",8882190,1684,222,1454,230,1462,2.49938359796402,2.58945147536812,0.15818431911967
"United States","New Jersey","NJ",2021-04-11,2021-04-17,7,2021,"15",8882190,1593,275,1428,165,1318,3.09608328576624,1.85764997145974,0.115546218487395
"United States","New Jersey","NJ",2021-04-18,2021-04-24,7,2021,"16",8882190,1668,233,1412,256,1435,2.62322692939467,2.88217207693148,0.181303116147309
"United States","New Jersey","NJ",2021-04-25,2021-05-01,7,2021,"17",8882190,1654,221,1393,261,1433,2.4881251132885,2.93846450030905,0.187365398420675
"United States","New Jersey","NJ",2021-05-02,2021-05-08,7,2021,"18",8882190,1478,203,1383,95,1275,2.28547238912926,1.06955604417379,0.0686912509038322
"United States","New Jersey","NJ",2021-05-09,2021-05-15,7,2021,"19",8882190,1488,161,1381,107,1327,1.81261603275769,1.20465786027995,0.0774800868935555
"United States","New Jersey","NJ",2021-05-16,2021-05-22,7,2021,"20",8882190,1471,132,1372,99,1339,1.48611997716779,1.11458998287584,0.0721574344023324
"United States","New Jersey","NJ",2021-05-23,2021-05-29,7,2021,"21",8882190,1333,75,1356,-23,1258,0.844386350663519,-0.258945147536812,-0.0169616519174042
"United States","New Jersey","NJ",2021-05-30,2021-06-05,7,2021,"22",8882190,1432,0,1352,80,1432,0,0.900678774041087,0.0591715976331362
"United States","New Jersey","NJ",2021-06-06,2021-06-12,7,2021,"23",8882190,1334,0,1354,-20,1334,0,-0.225169693510272,-0.0147710487444609
"United States","New Jersey","NJ",2021-06-13,2021-06-19,7,2021,"24",8882190,1352,198,1354,-2,1154,2.22917996575169,-0.0225169693510272,-0.00147710487444608
"United States","New Jersey","NJ",2021-06-20,2021-06-26,7,2021,"25",8882190,1378,53,1364,14,1325,0.59669968780222,0.15761878545719,0.0102639296187683
"United States","New Jersey","NJ",2021-06-27,2021-07-03,7,2021,"26",8882190,1381,0,1360,21,1381,0,0.236428178185785,0.0154411764705882
"United States","New Jersey","NJ",2021-07-04,2021-07-10,7,2021,"27",8882190,1389,80,1372,17,1309,0.900678774041087,0.191394239483731,0.0123906705539358
"United States","New Jersey","NJ",2021-07-11,2021-07-17,7,2021,"28",8882190,1310,0,1354,-44,1310,0,-0.495373325722598,-0.0324963072378139
"United States","New Jersey","NJ",2021-07-18,2021-07-24,7,2021,"29",8882190,1399,55,1360,39,1344,0.619216657153247,0.43908090234503,0.0286764705882352
"United States","New Jersey","NJ",2021-07-25,2021-07-31,7,2021,"30",8882190,1405,34,1349,56,1371,0.382788478967462,0.630475141828761,0.0415122312824314
"United States","New Jersey","NJ",2021-08-01,2021-08-07,7,2021,"31",8882190,1430,27,1352,78,1403,0.303979086238867,0.87816180469006,0.0576923076923077
"United States","New Jersey","NJ",2021-08-08,2021-08-14,7,2021,"32",8882190,1480,0,1338,142,1480,0,1.59870482392293,0.106128550074738
"United States","New Jersey","NJ",2021-08-15,2021-08-21,7,2021,"33",8882190,1512,0,1355,157,1512,0,1.76758209405563,0.115867158671587
"United States","New Mexico","NM",2019-12-29,2020-01-04,7,2020,"1",2096829,408,0,397,11,408,0,0.524601672334749,0.0277078085642317
"United States","New Mexico","NM",2020-01-05,2020-01-11,7,2020,"2",2096829,410,0,395,15,410,0,0.715365916820113,0.0379746835443038
"United States","New Mexico","NM",2020-01-12,2020-01-18,7,2020,"3",2096829,388,0,395,-7,388,0,-0.333837427849386,-0.0177215189873418
"United States","New Mexico","NM",2020-01-19,2020-01-25,7,2020,"4",2096829,404,0,395,9,404,0,0.429219550092068,0.0227848101265822
"United States","New Mexico","NM",2020-01-26,2020-02-01,7,2020,"5",2096829,370,0,389,-19,370,0,-0.906130161305476,-0.0488431876606684
"United States","New Mexico","NM",2020-02-02,2020-02-08,7,2020,"6",2096829,377,0,390,-13,377,0,-0.619983794577431,-0.0333333333333333
"United States","New Mexico","NM",2020-02-09,2020-02-15,7,2020,"7",2096829,382,0,390,-8,382,0,-0.381528488970727,-0.0205128205128206
"United States","New Mexico","NM",2020-02-16,2020-02-22,7,2020,"8",2096829,391,0,395,-4,391,0,-0.190764244485363,-0.0101265822784811
"United States","New Mexico","NM",2020-02-23,2020-02-29,7,2020,"9",2096829,396,0,392,4,396,0,0.190764244485363,0.010204081632653
"United States","New Mexico","NM",2020-03-01,2020-03-07,7,2020,"10",2096829,400,0,396,4,400,0,0.190764244485363,0.0101010101010102
"United States","New Mexico","NM",2020-03-08,2020-03-14,7,2020,"11",2096829,342,0,392,-50,342,0,-2.38455305606704,-0.127551020408163
"United States","New Mexico","NM",2020-03-15,2020-03-21,7,2020,"12",2096829,390,0,386,4,390,0,0.190764244485363,0.0103626943005182
"United States","New Mexico","NM",2020-03-22,2020-03-28,7,2020,"13",2096829,365,2,387,-22,363,0.0953821222426817,-1.0492033446695,-0.0568475452196382
"United States","New Mexico","NM",2020-03-29,2020-04-04,7,2020,"14",2096829,399,9,381,18,390,0.429219550092068,0.858439100184135,0.0472440944881889
"United States","New Mexico","NM",2020-04-05,2020-04-11,7,2020,"15",2096829,411,9,377,34,402,0.429219550092068,1.62149607812559,0.090185676392573
"United States","New Mexico","NM",2020-04-12,2020-04-18,7,2020,"16",2096829,422,33,371,51,389,1.57380501700425,2.43224411718838,0.137466307277628
"United States","New Mexico","NM",2020-04-19,2020-04-25,7,2020,"17",2096829,407,40,377,30,367,1.90764244485363,1.43073183364023,0.0795755968169762
"United States","New Mexico","NM",2020-04-26,2020-05-02,7,2020,"18",2096829,420,45,368,52,375,2.14609775046034,2.47993517830972,0.141304347826087
"United States","New Mexico","NM",2020-05-03,2020-05-09,7,2020,"19",2096829,442,53,364,78,389,2.52762623943106,3.71990276746459,0.214285714285714
"United States","New Mexico","NM",2020-05-10,2020-05-16,7,2020,"20",2096829,474,62,357,117,412,2.95684578952313,5.57985415119688,0.327731092436975
"United States","New Mexico","NM",2020-05-17,2020-05-23,7,2020,"21",2096829,396,55,364,32,341,2.62300836167375,1.52611395588291,0.0879120879120878
"United States","New Mexico","NM",2020-05-24,2020-05-30,7,2020,"22",2096829,433,43,358,75,390,2.05071562821766,3.57682958410056,0.209497206703911
"United States","New Mexico","NM",2020-05-31,2020-06-06,7,2020,"23",2096829,448,41,356,92,407,1.95533350597497,4.38757762316336,0.258426966292135
"United States","New Mexico","NM",2020-06-07,2020-06-13,7,2020,"24",2096829,445,39,350,95,406,1.85995138373229,4.53065080652738,0.271428571428571
"United States","New Mexico","NM",2020-06-14,2020-06-20,7,2020,"25",2096829,417,35,352,65,382,1.66918713924693,3.09991897288716,0.184659090909091
"United States","New Mexico","NM",2020-06-21,2020-06-27,7,2020,"26",2096829,399,25,348,51,374,1.19227652803352,2.43224411718838,0.146551724137931
"United States","New Mexico","NM",2020-06-28,2020-07-04,7,2020,"27",2096829,448,22,347,101,426,1.0492033446695,4.81679717325543,0.291066282420749
"United States","New Mexico","NM",2020-07-05,2020-07-11,7,2020,"28",2096829,408,30,347,61,378,1.43073183364023,2.90915472840179,0.175792507204611
"United States","New Mexico","NM",2020-07-12,2020-07-18,7,2020,"29",2096829,402,26,343,59,376,1.23996758915486,2.81377260615911,0.17201166180758
"United States","New Mexico","NM",2020-07-19,2020-07-25,7,2020,"30",2096829,435,38,343,92,397,1.81226032261095,4.38757762316336,0.268221574344023
"United States","New Mexico","NM",2020-07-26,2020-08-01,7,2020,"31",2096829,407,44,345,62,363,2.098406689339,2.95684578952313,0.179710144927536
"United States","New Mexico","NM",2020-08-02,2020-08-08,7,2020,"32",2096829,433,30,344,89,403,1.43073183364023,4.24450443979933,0.258720930232558
"United States","New Mexico","NM",2020-08-09,2020-08-15,7,2020,"33",2096829,394,30,341,53,364,1.43073183364023,2.52762623943106,0.155425219941349
"United States","New Mexico","NM",2020-08-16,2020-08-22,7,2020,"34",2096829,411,32,351,60,379,1.52611395588291,2.86146366728045,0.170940170940171
"United States","New Mexico","NM",2020-08-23,2020-08-29,7,2020,"35",2096829,397,26,350,47,371,1.23996758915486,2.24147987270302,0.134285714285714
"United States","New Mexico","NM",2020-08-30,2020-09-05,7,2020,"36",2096829,376,31,349,27,345,1.47842289476157,1.2876586502762,0.0773638968481376
"United States","New Mexico","NM",2020-09-06,2020-09-12,7,2020,"37",2096829,400,21,347,53,379,1.00151228354816,2.52762623943106,0.152737752161383
"United States","New Mexico","NM",2020-09-13,2020-09-19,7,2020,"38",2096829,398,26,352,46,372,1.23996758915486,2.19378881158168,0.130681818181818
"United States","New Mexico","NM",2020-09-20,2020-09-26,7,2020,"39",2096829,399,23,357,42,376,1.09689440579084,2.00302456709632,0.117647058823529
"United States","New Mexico","NM",2020-09-27,2020-10-03,7,2020,"40",2096829,388,20,354,34,368,0.953821222426817,1.62149607812559,0.0960451977401129
"United States","New Mexico","NM",2020-10-04,2020-10-10,7,2020,"41",2096829,389,17,359,30,372,0.810748039062794,1.43073183364023,0.0835654596100279
"United States","New Mexico","NM",2020-10-11,2020-10-17,7,2020,"42",2096829,406,22,367,39,384,1.0492033446695,1.85995138373229,0.106267029972752
"United States","New Mexico","NM",2020-10-18,2020-10-24,7,2020,"43",2096829,434,36,364,70,398,1.71687820036827,3.33837427849386,0.192307692307692
"United States","New Mexico","NM",2020-10-25,2020-10-31,7,2020,"44",2096829,460,53,366,94,407,2.52762623943106,4.48295974540604,0.256830601092896
"United States","New Mexico","NM",2020-11-01,2020-11-07,7,2020,"45",2096829,519,86,363,156,433,4.10143125643531,7.43980553492917,0.429752066115702
"United States","New Mexico","NM",2020-11-08,2020-11-14,7,2020,"46",2096829,577,104,355,222,473,4.95987035661945,10.5874155689377,0.625352112676056
"United States","New Mexico","NM",2020-11-15,2020-11-21,7,2020,"47",2096829,587,142,357,230,445,6.7721306792304,10.9689440579084,0.644257703081232
"United States","New Mexico","NM",2020-11-22,2020-11-28,7,2020,"48",2096829,601,177,367,234,424,8.44131781847733,11.1597083023938,0.637602179836512
"United States","New Mexico","NM",2020-11-29,2020-12-05,7,2020,"49",2096829,662,211,362,300,451,10.0628138966029,14.3073183364023,0.828729281767956
"United States","New Mexico","NM",2020-12-06,2020-12-12,7,2020,"50",2096829,687,175,372,315,512,8.34593569623465,15.0226842532224,0.846774193548387
"United States","New Mexico","NM",2020-12-13,2020-12-19,7,2020,"51",2096829,662,242,379,283,420,11.5412367913645,13.4965702973395,0.746701846965699
"United States","New Mexico","NM",2020-12-20,2020-12-26,7,2020,"52",2096829,626,161,381,245,465,7.67826084053588,11.6843099747285,0.643044619422572
"United States","New Mexico","NM",2020-12-27,2021-01-02,7,2020,"53",2096829,607,218,387,220,389,10.3966513244523,10.492033446695,0.568475452196382
"United States","New Mexico","NM",2021-01-03,2021-01-09,7,2021,"1",2096829,587,198,410,177,389,9.44283010202549,8.44131781847733,0.431707317073171
"United States","New Mexico","NM",2021-01-10,2021-01-16,7,2021,"2",2096829,537,177,408,129,360,8.44131781847733,6.15214688465297,0.316176470588235
"United States","New Mexico","NM",2021-01-17,2021-01-23,7,2021,"3",2096829,530,206,403,127,324,9.82435859099621,6.05676476241029,0.315136476426799
"United States","New Mexico","NM",2021-01-24,2021-01-30,7,2021,"4",2096829,481,150,397,84,331,7.15365916820113,4.00604913419263,0.211586901763224
"United States","New Mexico","NM",2021-01-31,2021-02-06,7,2021,"5",2096829,467,121,392,75,346,5.77061839568224,3.57682958410056,0.191326530612245
"United States","New Mexico","NM",2021-02-07,2021-02-13,7,2021,"6",2096829,469,130,395,74,339,6.19983794577431,3.52913852297922,0.187341772151899
"United States","New Mexico","NM",2021-02-14,2021-02-20,7,2021,"7",2096829,437,94,394,43,343,4.48295974540604,2.05071562821766,0.109137055837564
"United States","New Mexico","NM",2021-02-21,2021-02-27,7,2021,"8",2096829,460,90,401,59,370,4.29219550092068,2.81377260615911,0.14713216957606
"United States","New Mexico","NM",2021-02-28,2021-03-06,7,2021,"9",2096829,445,97,398,47,348,4.62603292877006,2.24147987270302,0.118090452261306
"United States","New Mexico","NM",2021-03-07,2021-03-13,7,2021,"10",2096829,404,54,396,8,350,2.57531730055241,0.381528488970727,0.0202020202020201
"United States","New Mexico","NM",2021-03-14,2021-03-20,7,2021,"11",2096829,451,38,391,60,413,1.81226032261095,2.86146366728045,0.153452685421995
"United States","New Mexico","NM",2021-03-21,2021-03-27,7,2021,"12",2096829,448,36,393,55,412,1.71687820036827,2.62300836167375,0.139949109414758
"United States","New Mexico","NM",2021-03-28,2021-04-03,7,2021,"13",2096829,444,24,387,57,420,1.14458546691218,2.71839048391643,0.147286821705426
"United States","New Mexico","NM",2021-04-04,2021-04-10,7,2021,"14",2096829,427,27,379,48,400,1.2876586502762,2.28917093382436,0.12664907651715
"United States","New Mexico","NM",2021-04-11,2021-04-17,7,2021,"15",2096829,439,25,378,61,414,1.19227652803352,2.90915472840179,0.161375661375661
"United States","New Mexico","NM",2021-04-18,2021-04-24,7,2021,"16",2096829,414,23,379,35,391,1.09689440579084,1.66918713924693,0.0923482849604222
"United States","New Mexico","NM",2021-04-25,2021-05-01,7,2021,"17",2096829,394,43,378,16,351,2.05071562821766,0.763056977941454,0.0423280423280423
"United States","New Mexico","NM",2021-05-02,2021-05-08,7,2021,"18",2096829,418,31,372,46,387,1.47842289476157,2.19378881158168,0.123655913978495
"United States","New Mexico","NM",2021-05-09,2021-05-15,7,2021,"19",2096829,443,15,365,78,428,0.715365916820113,3.71990276746459,0.213698630136986
"United States","New Mexico","NM",2021-05-16,2021-05-22,7,2021,"20",2096829,413,18,369,44,395,0.858439100184135,2.098406689339,0.119241192411924
"United States","New Mexico","NM",2021-05-23,2021-05-29,7,2021,"21",2096829,403,132,369,34,271,6.29522006801699,1.62149607812559,0.0921409214092141
"United States","New Mexico","NM",2021-05-30,2021-06-05,7,2021,"22",2096829,409,17,370,39,392,0.810748039062794,1.85995138373229,0.105405405405405
"United States","New Mexico","NM",2021-06-06,2021-06-12,7,2021,"23",2096829,355,17,368,-13,338,0.810748039062794,-0.619983794577431,-0.0353260869565217
"United States","New Mexico","NM",2021-06-13,2021-06-19,7,2021,"24",2096829,414,19,374,40,395,0.906130161305476,1.90764244485363,0.106951871657754
"United States","New Mexico","NM",2021-06-20,2021-06-26,7,2021,"25",2096829,402,19,378,24,383,0.906130161305476,1.14458546691218,0.0634920634920635
"United States","New Mexico","NM",2021-06-27,2021-07-03,7,2021,"26",2096829,413,9,370,43,404,0.429219550092068,2.05071562821766,0.116216216216216
"United States","New Mexico","NM",2021-07-04,2021-07-10,7,2021,"27",2096829,371,10,366,5,361,0.476910611213408,0.238455305606704,0.0136612021857923
"United States","New Mexico","NM",2021-07-11,2021-07-17,7,2021,"28",2096829,390,25,362,28,365,1.19227652803352,1.33534971139754,0.0773480662983426
"United States","New Mexico","NM",2021-07-18,2021-07-24,7,2021,"29",2096829,383,18,349,34,365,0.858439100184135,1.62149607812559,0.0974212034383954
"United States","New Mexico","NM",2021-07-25,2021-07-31,7,2021,"30",2096829,380,13,347,33,367,0.619983794577431,1.57380501700425,0.095100864553314
"United States","New Mexico","NM",2021-08-01,2021-08-07,7,2021,"31",2096829,399,15,351,48,384,0.715365916820113,2.28917093382436,0.136752136752137
"United States","New Mexico","NM",2021-08-08,2021-08-14,7,2021,"32",2096829,423,21,354,69,402,1.00151228354816,3.29068321737252,0.194915254237288
"United States","New Mexico","NM",2021-08-15,2021-08-21,7,2021,"33",2096829,431,5,356,75,426,0.238455305606704,3.57682958410056,0.210674157303371
"United States","New York","NY",2019-12-29,2020-01-04,7,2020,"1",19453561,3319,0,3460,-141,3319,0,-0.724803032205775,-0.0407514450867053
"United States","New York","NY",2020-01-05,2020-01-11,7,2020,"2",19453561,3229,0,3470,-241,3229,0,-1.23884773589781,-0.0694524495677233
"United States","New York","NY",2020-01-12,2020-01-18,7,2020,"3",19453561,3298,0,3472,-174,3298,0,-0.894437784424147,-0.0501152073732719
"United States","New York","NY",2020-01-19,2020-01-25,7,2020,"4",19453561,3205,0,3426,-221,3205,0,-1.13603879515941,-0.0645067133683596
"United States","New York","NY",2020-01-26,2020-02-01,7,2020,"5",19453561,3202,0,3369,-167,3202,0,-0.858454655165705,-0.0495696052241021
"United States","New York","NY",2020-02-02,2020-02-08,7,2020,"6",19453561,3231,0,3314,-83,3231,0,-0.426657104064392,-0.0250452625226313
"United States","New York","NY",2020-02-09,2020-02-15,7,2020,"7",19453561,3120,0,3260,-140,3120,0,-0.719662585168854,-0.0429447852760736
"United States","New York","NY",2020-02-16,2020-02-22,7,2020,"8",19453561,3129,0,3236,-107,3129,0,-0.550027832950481,-0.0330655129789864
"United States","New York","NY",2020-02-23,2020-02-29,7,2020,"9",19453561,3271,0,3184,87,3271,0,0.447218892212074,0.027324120603015
"United States","New York","NY",2020-03-01,2020-03-07,7,2020,"10",19453561,3185,0,3168,17,3185,0,0.0873875996276466,0.00536616161616155
"United States","New York","NY",2020-03-08,2020-03-14,7,2020,"11",19453561,3117,3,3132,-15,3114,0.0154213411107612,-0.0771067055538058,-0.00478927203065138
"United States","New York","NY",2020-03-15,2020-03-21,7,2020,"12",19453561,3535,75,3100,435,3460,0.385533527769029,2.23609446106037,0.140322580645161
"United States","New York","NY",2020-03-22,2020-03-28,7,2020,"13",19453561,5350,914,3089,2261,4436,4.69836859174523,11.622550750477,0.731952088054387
"United States","New York","NY",2020-03-29,2020-04-04,7,2020,"14",19453561,10070,3532,3075,6995,6538,18.1560589344028,35.9574270232581,2.27479674796748
"United States","New York","NY",2020-04-05,2020-04-11,7,2020,"15",19453561,12529,6588,3046,9483,5941,33.8652650792315,48.746859251116,3.11326329612607
"United States","New York","NY",2020-04-12,2020-04-18,7,2020,"16",19453561,10365,5117,3021,7344,5248,26.3036674879216,37.7514430391433,2.43098311817279
"United States","New York","NY",2020-04-19,2020-04-25,7,2020,"17",19453561,7794,5242,2990,4804,2552,26.9462233675367,24.6947075653655,1.6066889632107
"United States","New York","NY",2020-04-26,2020-05-02,7,2020,"18",19453561,5976,2513,2953,3023,3463,12.9179434037809,15.5395713926103,1.02370470707755
"United States","New York","NY",2020-05-03,2020-05-09,7,2020,"19",19453561,4851,2737,2909,1942,2114,14.0694035400511,9.98274814569939,0.667583361980062
"United States","New York","NY",2020-05-10,2020-05-16,7,2020,"20",19453561,4111,1246,2892,1219,2865,6.4049970080028,6.26620493800595,0.421507607192255
"United States","New York","NY",2020-05-17,2020-05-23,7,2020,"21",19453561,3556,920,2842,714,2636,4.72921127396676,3.67027918436116,0.251231527093596
"United States","New York","NY",2020-05-24,2020-05-30,7,2020,"22",19453561,3281,671,2824,457,2610,3.44923996177358,2.34918429587262,0.161827195467422
"United States","New York","NY",2020-05-31,2020-06-06,7,2020,"23",19453561,3088,550,2859,229,2538,2.82724587030621,1.17716237145477,0.0800979363413781
"United States","New York","NY",2020-06-07,2020-06-13,7,2020,"24",19453561,2996,428,2828,168,2568,2.20011133180193,0.863595102202625,0.0594059405940595
"United States","New York","NY",2020-06-14,2020-06-20,7,2020,"25",19453561,2891,303,2839,52,2588,1.55755545218688,0.26730324591986,0.0183163085593518
"United States","New York","NY",2020-06-21,2020-06-27,7,2020,"26",19453561,3004,266,2860,144,2738,1.36735891182082,0.740224373316536,0.0503496503496503
"United States","New York","NY",2020-06-28,2020-07-04,7,2020,"27",19453561,2883,751,2847,36,2132,3.86047572472721,0.185056093329134,0.0126448893572182
"United States","New York","NY",2020-07-05,2020-07-11,7,2020,"28",19453561,2920,153,2833,87,2767,0.786488396648819,0.447218892212074,0.0307094952347335
"United States","New York","NY",2020-07-12,2020-07-18,7,2020,"29",19453561,2818,157,2818,0,2661,0.807050184796501,0,0
"United States","New York","NY",2020-07-19,2020-07-25,7,2020,"30",19453561,2834,129,2808,26,2705,0.66311766776273,0.13365162295993,0.0092592592592593
"United States","New York","NY",2020-07-26,2020-08-01,7,2020,"31",19453561,2871,95,2788,83,2776,0.488342468507437,0.426657104064392,0.0297704447632712
"United States","New York","NY",2020-08-02,2020-08-08,7,2020,"32",19453561,2841,60,2802,39,2781,0.308426822215223,0.200477434439895,0.0139186295503213
"United States","New York","NY",2020-08-09,2020-08-15,7,2020,"33",19453561,2811,67,2800,11,2744,0.344409951473666,0.0565449174061243,0.0039285714285715
"United States","New York","NY",2020-08-16,2020-08-22,7,2020,"34",19453561,2841,53,2801,40,2788,0.272443692956781,0.205617881476815,0.0142806140664049
"United States","New York","NY",2020-08-23,2020-08-29,7,2020,"35",19453561,2810,58,2794,16,2752,0.298145928141382,0.0822471525907262,0.00572655690765922
"United States","New York","NY",2020-08-30,2020-09-05,7,2020,"36",19453561,2768,57,2806,-38,2711,0.293005481104462,-0.195336987402975,-0.0135424091233072
"United States","New York","NY",2020-09-06,2020-09-12,7,2020,"37",19453561,2757,46,2807,-50,2711,0.236460563698338,-0.257022351846019,-0.0178126113288208
"United States","New York","NY",2020-09-13,2020-09-19,7,2020,"38",19453561,2886,54,2828,58,2832,0.277584139993701,0.298145928141382,0.0205091937765205
"United States","New York","NY",2020-09-20,2020-09-26,7,2020,"39",19453561,3080,34,2852,228,3046,0.174775199255293,1.17202192441785,0.0799438990182328
"United States","New York","NY",2020-09-27,2020-10-03,7,2020,"40",19453561,2951,80,2878,73,2871,0.411235762953631,0.375252633695188,0.0253648366921473
"United States","New York","NY",2020-10-04,2020-10-10,7,2020,"41",19453561,3108,83,2923,185,3025,0.426657104064392,0.950982701830272,0.0632911392405062
"United States","New York","NY",2020-10-11,2020-10-17,7,2020,"42",19453561,2985,85,2939,46,2900,0.436937998138233,0.236460563698338,0.0156515821708063
"United States","New York","NY",2020-10-18,2020-10-24,7,2020,"43",19453561,2939,81,2956,-17,2858,0.416376209990551,-0.0873875996276466,-0.00575101488497975
"United States","New York","NY",2020-10-25,2020-10-31,7,2020,"44",19453561,3076,116,2967,109,2960,0.596291856282765,0.560308727024322,0.0367374452308729
"United States","New York","NY",2020-11-01,2020-11-07,7,2020,"45",19453561,3317,134,2981,336,3183,0.688819902947332,1.72719020440525,0.112713854411271
"United States","New York","NY",2020-11-08,2020-11-14,7,2020,"46",19453561,3158,192,2985,173,2966,0.986965831088714,0.889297337387227,0.0579564489112228
"United States","New York","NY",2020-11-15,2020-11-21,7,2020,"47",19453561,3288,230,3018,270,3058,1.18230281849169,1.3879206999685,0.0894632206759443
"United States","New York","NY",2020-11-22,2020-11-28,7,2020,"48",19453561,3375,338,3028,347,3037,1.73747109847909,1.78373512181137,0.114597093791281
"United States","New York","NY",2020-11-29,2020-12-05,7,2020,"49",19453561,3569,461,3062,507,3108,2.3697460840203,2.60620664771864,0.165578053559765
"United States","New York","NY",2020-12-06,2020-12-12,7,2020,"50",19453561,3872,591,3097,775,3281,3.03800419881995,3.9838464536133,0.250242169841782
"United States","New York","NY",2020-12-13,2020-12-19,7,2020,"51",19453561,4118,827,3145,973,3291,4.25114969953316,5.00165496692354,0.309379968203498
"United States","New York","NY",2020-12-20,2020-12-26,7,2020,"52",19453561,4358,657,3179,1179,3701,3.37727370325669,6.06058705652914,0.370871343189682
"United States","New York","NY",2020-12-27,2021-01-02,7,2020,"53",19453561,4339,1315,3244,1095,3024,6.75968785355031,5.62878950542782,0.337546239210851
"United States","New York","NY",2021-01-03,2021-01-09,7,2021,"1",19453561,4549,1190,3269,1280,3359,6.11713197393526,6.57977220725809,0.391557051085959
"United States","New York","NY",2021-01-10,2021-01-16,7,2021,"2",19453561,4668,1341,3295,1373,3327,6.89333947651024,7.05783378169169,0.416691957511381
"United States","New York","NY",2021-01-17,2021-01-23,7,2021,"3",19453561,4540,1322,3290,1250,3218,6.79567098280875,6.42555879615048,0.379939209726444
"United States","New York","NY",2021-01-24,2021-01-30,7,2021,"4",19453561,4443,1311,3297,1146,3132,6.73912606540263,5.89095230431076,0.347588717015469
"United States","New York","NY",2021-01-31,2021-02-06,7,2021,"5",19453561,4394,1217,3287,1107,3177,6.25592404393211,5.69047486987087,0.336781259507149
"United States","New York","NY",2021-02-07,2021-02-13,7,2021,"6",19453561,4128,1090,3207,921,3038,5.60308727024322,4.73435172100368,0.287184284377923
"United States","New York","NY",2021-02-14,2021-02-20,7,2021,"7",19453561,4014,942,3205,809,3072,4.842301108779,4.15862165286859,0.252418096723869
"United States","New York","NY",2021-02-21,2021-02-27,7,2021,"8",19453561,3906,832,3177,729,3074,4.27685193471776,3.74738588991496,0.229461756373938
"United States","New York","NY",2021-02-28,2021-03-06,7,2021,"9",19453561,3643,646,3147,496,2997,3.32072878585057,2.54966173031251,0.157610422624722
"United States","New York","NY",2021-03-07,2021-03-13,7,2021,"10",19453561,3598,679,3120,478,2919,3.49036353806894,2.45713368364795,0.153205128205128
"United States","New York","NY",2021-03-14,2021-03-20,7,2021,"11",19453561,3500,469,3065,435,3031,2.41086966031566,2.23609446106037,0.141924959216966
"United States","New York","NY",2021-03-21,2021-03-27,7,2021,"12",19453561,3578,675,3022,556,2903,3.46980174992126,2.85808855252774,0.183984116479153
"United States","New York","NY",2021-03-28,2021-04-03,7,2021,"13",19453561,3398,468,3006,392,2930,2.40572921327874,2.01505523847279,0.130405854956753
"United States","New York","NY",2021-04-04,2021-04-10,7,2021,"14",19453561,3460,479,2988,472,2981,2.46227413068487,2.42629100142642,0.157965194109772
"United States","New York","NY",2021-04-11,2021-04-17,7,2021,"15",19453561,3216,535,2965,251,2681,2.75013916475241,1.29025220626702,0.084654300168634
"United States","New York","NY",2021-04-18,2021-04-24,7,2021,"16",19453561,3319,346,2945,374,2973,1.77859467477445,1.92252719180822,0.126994906621392
"United States","New York","NY",2021-04-25,2021-05-01,7,2021,"17",19453561,3214,314,2909,305,2900,1.614100369593,1.56783634626072,0.104847026469577
"United States","New York","NY",2021-05-02,2021-05-08,7,2021,"18",19453561,3111,131,2884,227,2980,0.673398561836571,1.16688147738093,0.0787101248266298
"United States","New York","NY",2021-05-09,2021-05-15,7,2021,"19",19453561,3110,503,2854,256,2607,2.58564485957095,1.31595444145162,0.0896986685353889
"United States","New York","NY",2021-05-16,2021-05-22,7,2021,"20",19453561,3199,200,2817,382,2999,1.02808940738408,1.96365076810359,0.135605253816117
"United States","New York","NY",2021-05-23,2021-05-29,7,2021,"21",19453561,2944,178,2797,147,2766,0.914999572571829,0.755645714427297,0.0525563103324991
"United States","New York","NY",2021-05-30,2021-06-05,7,2021,"22",19453561,3034,137,2797,237,2897,0.704241244058093,1.21828594775013,0.0847336431891312
"United States","New York","NY",2021-06-06,2021-06-12,7,2021,"23",19453561,2836,107,2811,25,2729,0.550027832950481,0.12851117592301,0.008893632159374
"United States","New York","NY",2021-06-13,2021-06-19,7,2021,"24",19453561,2873,78,2835,38,2795,0.40095486887979,0.195336987402975,0.0134038800705467
"United States","New York","NY",2021-06-20,2021-06-26,7,2021,"25",19453561,2859,39,2844,15,2820,0.200477434439895,0.0771067055538058,0.00527426160337563
"United States","New York","NY",2021-06-27,2021-07-03,7,2021,"26",19453561,2956,52,2851,105,2904,0.26730324591986,0.539746938876641,0.0368291827428973
"United States","New York","NY",2021-07-04,2021-07-10,7,2021,"27",19453561,2925,34,2838,87,2891,0.174775199255293,0.447218892212074,0.0306553911205074
"United States","New York","NY",2021-07-11,2021-07-17,7,2021,"28",19453561,2885,35,2807,78,2850,0.179915646292214,0.40095486887979,0.0277876736729605
"United States","New York","NY",2021-07-18,2021-07-24,7,2021,"29",19453561,2953,42,2812,141,2911,0.215898775550656,0.724803032205775,0.0501422475106685
"United States","New York","NY",2021-07-25,2021-07-31,7,2021,"30",19453561,2952,41,2797,155,2911,0.210758328513736,0.79676929072266,0.055416517697533
"United States","New York","NY",2021-08-01,2021-08-07,7,2021,"31",19453561,3210,60,2770,440,3150,0.308426822215223,2.26179669624497,0.15884476534296
"United States","New York","NY",2021-08-08,2021-08-14,7,2021,"32",19453561,3221,120,2767,454,3101,0.616853644430446,2.33376295476186,0.164076617275027
"United States","New York","NY",2021-08-15,2021-08-21,7,2021,"33",19453561,3129,42,2770,359,3087,0.215898775550656,1.84542048625442,0.129602888086643
"United States","North Carolina","NC",2019-12-29,2020-01-04,7,2020,"1",10488084,2003,0,2088,-85,2003,0,-0.8104435471722,-0.0407088122605364
"United States","North Carolina","NC",2020-01-05,2020-01-11,7,2020,"2",10488084,1984,0,2106,-122,1984,0,-1.16322485594128,-0.0579297245963912
"United States","North Carolina","NC",2020-01-12,2020-01-18,7,2020,"3",10488084,1902,0,2112,-210,1902,0,-2.00227229301367,-0.0994318181818182
"United States","North Carolina","NC",2020-01-19,2020-01-25,7,2020,"4",10488084,1994,0,2093,-99,1994,0,-0.943928366706445,-0.0473005255613951
"United States","North Carolina","NC",2020-01-26,2020-02-01,7,2020,"5",10488084,1983,0,2075,-92,1983,0,-0.877185956939323,-0.0443373493975904
"United States","North Carolina","NC",2020-02-02,2020-02-08,7,2020,"6",10488084,2053,0,2061,-8,2053,0,-0.0762770397338541,-0.00388161086851047
"United States","North Carolina","NC",2020-02-09,2020-02-15,7,2020,"7",10488084,2060,0,2037,23,2060,0,0.219296489234831,0.0112911143838978
"United States","North Carolina","NC",2020-02-16,2020-02-22,7,2020,"8",10488084,1925,0,2038,-113,1925,0,-1.07741318624069,-0.0554465161923454
"United States","North Carolina","NC",2020-02-23,2020-02-29,7,2020,"9",10488084,1972,0,2011,-39,1972,0,-0.371850568702539,-0.0193933366484336
"United States","North Carolina","NC",2020-03-01,2020-03-07,7,2020,"10",10488084,2032,0,1989,43,2032,0,0.409989088569466,0.0216189039718451
"United States","North Carolina","NC",2020-03-08,2020-03-14,7,2020,"11",10488084,2025,0,2004,21,2025,0,0.200227229301367,0.0104790419161678
"United States","North Carolina","NC",2020-03-15,2020-03-21,7,2020,"12",10488084,2052,0,2000,52,2052,0,0.495800758270052,0.026
"United States","North Carolina","NC",2020-03-22,2020-03-28,7,2020,"13",10488084,1877,4,1975,-98,1873,0.0381385198669271,-0.934393736739713,-0.049620253164557
"United States","North Carolina","NC",2020-03-29,2020-04-04,7,2020,"14",10488084,2024,20,1931,93,2004,0.190692599334635,0.886720586906054,0.0481615743138271
"United States","North Carolina","NC",2020-04-05,2020-04-11,7,2020,"15",10488084,2016,55,1895,121,1961,0.524404648170247,1.15369022597454,0.0638522427440633
"United States","North Carolina","NC",2020-04-12,2020-04-18,7,2020,"16",10488084,2029,84,1876,153,1945,0.800908917205469,1.45879838490996,0.0815565031982943
"United States","North Carolina","NC",2020-04-19,2020-04-25,7,2020,"17",10488084,2104,125,1857,247,1979,1.19182874584147,2.35505360178275,0.133010231556274
"United States","North Carolina","NC",2020-04-26,2020-05-02,7,2020,"18",10488084,1948,131,1830,118,1817,1.24903652564186,1.12508633607435,0.0644808743169398
"United States","North Carolina","NC",2020-05-03,2020-05-09,7,2020,"19",10488084,2059,123,1810,249,1936,1.17275948590801,2.37412286171621,0.137569060773481
"United States","North Carolina","NC",2020-05-10,2020-05-16,7,2020,"20",10488084,2039,105,1815,224,1934,1.00113614650684,2.13575711254792,0.123415977961433
"United States","North Carolina","NC",2020-05-17,2020-05-23,7,2020,"21",10488084,2061,84,1804,257,1977,0.800908917205469,2.45039990145006,0.142461197339246
"United States","North Carolina","NC",2020-05-24,2020-05-30,7,2020,"22",10488084,1991,144,1793,198,1847,1.37298671520937,1.88785673341289,0.110429447852761
"United States","North Carolina","NC",2020-05-31,2020-06-06,7,2020,"23",10488084,1967,115,1799,168,1852,1.09648244617415,1.60181783441094,0.093385214007782
"United States","North Carolina","NC",2020-06-07,2020-06-13,7,2020,"24",10488084,1878,114,1776,102,1764,1.08694781620742,0.97253225660664,0.0574324324324325
"United States","North Carolina","NC",2020-06-14,2020-06-20,7,2020,"25",10488084,1938,108,1783,155,1830,1.02974003640703,1.47786764484342,0.0869321368480089
"United States","North Carolina","NC",2020-06-21,2020-06-27,7,2020,"26",10488084,1946,106,1781,165,1840,1.01067077647357,1.57321394451074,0.0926445816956767
"United States","North Carolina","NC",2020-06-28,2020-07-04,7,2020,"27",10488084,2001,77,1766,235,1924,0.734166507438346,2.24063804218197,0.133069082672707
"United States","North Carolina","NC",2020-07-05,2020-07-11,7,2020,"28",10488084,1979,98,1759,220,1881,0.934393736739713,2.09761859268099,0.125071063104036
"United States","North Carolina","NC",2020-07-12,2020-07-18,7,2020,"29",10488084,2027,136,1753,274,1891,1.29670967547552,2.6124886108845,0.156303479749002
"United States","North Carolina","NC",2020-07-19,2020-07-25,7,2020,"30",10488084,2147,149,1744,403,1998,1.42065986504303,3.8424558765929,0.231077981651376
"United States","North Carolina","NC",2020-07-26,2020-08-01,7,2020,"31",10488084,2085,186,1730,355,1899,1.77344117381211,3.38479363818978,0.205202312138728
"United States","North Carolina","NC",2020-08-02,2020-08-08,7,2020,"32",10488084,2061,196,1728,333,1865,1.86878747347943,3.17503177892168,0.192708333333333
"United States","North Carolina","NC",2020-08-09,2020-08-15,7,2020,"33",10488084,2160,183,1733,427,1977,1.74483728391191,4.07128699579447,0.246393537218696
"United States","North Carolina","NC",2020-08-16,2020-08-22,7,2020,"34",10488084,2123,178,1746,377,1945,1.69716413407825,3.59455549745788,0.215922107674685
"United States","North Carolina","NC",2020-08-23,2020-08-29,7,2020,"35",10488084,2070,162,1748,322,1908,1.54461005461055,3.07015084928763,0.184210526315789
"United States","North Carolina","NC",2020-08-30,2020-09-05,7,2020,"36",10488084,2167,206,1741,426,1961,1.96413377314674,4.06175236582773,0.24468696151637
"United States","North Carolina","NC",2020-09-06,2020-09-12,7,2020,"37",10488084,2124,158,1738,386,1966,1.50647153474362,3.68036716715846,0.222094361334868
"United States","North Carolina","NC",2020-09-13,2020-09-19,7,2020,"38",10488084,2261,188,1747,514,2073,1.79251043374557,4.90079980290013,0.294218660560962
"United States","North Carolina","NC",2020-09-20,2020-09-26,7,2020,"39",10488084,2072,205,1746,326,1867,1.95459914318001,3.10828936915456,0.186712485681558
"United States","North Carolina","NC",2020-09-27,2020-10-03,7,2020,"40",10488084,2038,189,1764,274,1849,1.8020450637123,2.6124886108845,0.155328798185941
"United States","North Carolina","NC",2020-10-04,2020-10-10,7,2020,"41",10488084,2117,136,1758,359,1981,1.29670967547552,3.42293215805671,0.204209328782708
"United States","North Carolina","NC",2020-10-11,2020-10-17,7,2020,"42",10488084,2130,164,1771,359,1966,1.56367931454401,3.42293215805671,0.202710333145116
"United States","North Carolina","NC",2020-10-18,2020-10-24,7,2020,"43",10488084,2130,63,1794,336,2067,0.600681687904101,3.20363566882187,0.187290969899666
"United States","North Carolina","NC",2020-10-25,2020-10-31,7,2020,"44",10488084,2159,175,1807,352,1984,1.66856024417806,3.35618974828958,0.194798007747648
"United States","North Carolina","NC",2020-11-01,2020-11-07,7,2020,"45",10488084,2382,381,1824,558,2001,3.6326940173248,5.32032352143633,0.305921052631579
"United States","North Carolina","NC",2020-11-08,2020-11-14,7,2020,"46",10488084,2230,171,1836,394,2059,1.63042172431113,3.75664420689232,0.214596949891068
"United States","North Carolina","NC",2020-11-15,2020-11-21,7,2020,"47",10488084,2176,286,1849,327,1890,2.72690417048529,3.11782399912129,0.176852352623039
"United States","North Carolina","NC",2020-11-22,2020-11-28,7,2020,"48",10488084,2320,133,1858,462,2187,1.26810578557533,4.40499904463008,0.248654467168999
"United States","North Carolina","NC",2020-11-29,2020-12-05,7,2020,"49",10488084,2378,377,1886,492,2001,3.59455549745788,4.69103794363203,0.260869565217391
"United States","North Carolina","NC",2020-12-06,2020-12-12,7,2020,"50",10488084,2459,278,1907,552,2181,2.65062713075143,5.26311574163594,0.289459884635553
"United States","North Carolina","NC",2020-12-13,2020-12-19,7,2020,"51",10488084,2588,389,1934,654,2199,3.70897105705866,6.23564799824258,0.338159255429162
"United States","North Carolina","NC",2020-12-20,2020-12-26,7,2020,"52",10488084,2670,42,1967,703,2628,0.400454458602734,6.70284486661243,0.357397051347229
"United States","North Carolina","NC",2020-12-27,2021-01-02,7,2020,"53",10488084,2839,667,1991,848,2172,6.35959818781009,8.08536621178854,0.425916624811652
"United States","North Carolina","NC",2021-01-03,2021-01-09,7,2021,"1",10488084,2930,534,1992,938,2396,5.09149240223476,8.9434829087944,0.470883534136546
"United States","North Carolina","NC",2021-01-10,2021-01-16,7,2021,"2",10488084,2997,590,2020,977,2407,5.62543168037174,9.31533347749694,0.483663366336634
"United States","North Carolina","NC",2021-01-17,2021-01-23,7,2021,"3",10488084,2870,570,2042,828,2300,5.43473908103711,7.89467361245391,0.405484818805093
"United States","North Carolina","NC",2021-01-24,2021-01-30,7,2021,"4",10488084,2855,702,2034,821,2153,6.6933102366457,7.82793120268678,0.403638151425762
"United States","North Carolina","NC",2021-01-31,2021-02-06,7,2021,"5",10488084,2621,639,2052,569,1982,6.0926285487416,5.42520445107038,0.27729044834308
"United States","North Carolina","NC",2021-02-07,2021-02-13,7,2021,"6",10488084,2516,527,2052,464,1989,5.02474999246764,4.42406830456354,0.226120857699805
"United States","North Carolina","NC",2021-02-14,2021-02-20,7,2021,"7",10488084,2412,444,2036,376,1968,4.23337570522891,3.58502086749115,0.18467583497053
"United States","North Carolina","NC",2021-02-21,2021-02-27,7,2021,"8",10488084,2209,316,2008,201,1893,3.01294306948724,1.91646062331309,0.100099601593626
"United States","North Carolina","NC",2021-02-28,2021-03-06,7,2021,"9",10488084,2028,290,1997,31,1738,2.76504269035221,0.295573528968685,0.0155232849273912
"United States","North Carolina","NC",2021-03-07,2021-03-13,7,2021,"10",10488084,1946,164,1961,-15,1782,1.56367931454401,-0.143019449500977,-0.00764915859255477
"United States","North Carolina","NC",2021-03-14,2021-03-20,7,2021,"11",10488084,1920,159,1955,-35,1761,1.51600616471035,-0.333712048835612,-0.0179028132992327
"United States","North Carolina","NC",2021-03-21,2021-03-27,7,2021,"12",10488084,1895,207,1946,-51,1688,1.97366840311348,-0.48626612830332,-0.026207605344296
"United States","North Carolina","NC",2021-03-28,2021-04-03,7,2021,"13",10488084,1429,106,1928,-499,1323,1.01067077647357,-4.75778035339915,-0.258817427385892
"United States","North Carolina","NC",2021-07-18,2021-07-24,7,2021,"29",10488084,992,47,1789,-797,945,0.448127608436393,-7.59910008348522,-0.445500279485746
"United States","North Carolina","NC",2021-07-25,2021-07-31,7,2021,"30",10488084,1036,65,1788,-752,971,0.619750947837565,-7.17004173498229,-0.420581655480984
"United States","North Carolina","NC",2021-08-01,2021-08-07,7,2021,"31",10488084,1086,101,1791,-705,985,0.962997626639909,-6.7219141265459,-0.393634840871022
"United States","North Carolina","NC",2021-08-08,2021-08-14,7,2021,"32",10488084,924,90,1778,-854,834,0.858116697005859,-8.14257399158893,-0.480314960629921
"United States","North Dakota","ND",2019-12-29,2020-01-04,7,2020,"1",762062,149,0,150,-1,149,0,-0.131222918870118,-0.00666666666666671
"United States","North Dakota","ND",2020-01-05,2020-01-11,7,2020,"2",762062,151,0,153,-2,151,0,-0.262445837740236,-0.0130718954248366
"United States","North Dakota","ND",2020-01-12,2020-01-18,7,2020,"3",762062,171,0,153,18,171,0,2.36201253966213,0.117647058823529
"United States","North Dakota","ND",2020-01-19,2020-01-25,7,2020,"4",762062,147,0,151,-4,147,0,-0.524891675480473,-0.0264900662251656
"United States","North Dakota","ND",2020-01-26,2020-02-01,7,2020,"5",762062,130,0,148,-18,130,0,-2.36201253966213,-0.121621621621622
"United States","North Dakota","ND",2020-02-02,2020-02-08,7,2020,"6",762062,138,0,149,-11,138,0,-1.4434521075713,-0.0738255033557047
"United States","North Dakota","ND",2020-02-09,2020-02-15,7,2020,"7",762062,148,0,145,3,148,0,0.393668756610355,0.0206896551724138
"United States","North Dakota","ND",2020-02-16,2020-02-22,7,2020,"8",762062,176,0,146,30,176,0,3.93668756610354,0.205479452054794
"United States","North Dakota","ND",2020-02-23,2020-02-29,7,2020,"9",762062,152,0,146,6,152,0,0.787337513220709,0.0410958904109588
"United States","North Dakota","ND",2020-03-01,2020-03-07,7,2020,"10",762062,171,0,147,24,171,0,3.14935005288284,0.163265306122449
"United States","North Dakota","ND",2020-03-08,2020-03-14,7,2020,"11",762062,148,0,143,5,148,0,0.656114594350591,0.034965034965035
"United States","North Dakota","ND",2020-03-15,2020-03-21,7,2020,"12",762062,150,0,143,7,150,0,0.918560432090827,0.048951048951049
"United States","North Dakota","ND",2020-03-22,2020-03-28,7,2020,"13",762062,119,1,143,-24,118,0.131222918870118,-3.14935005288284,-0.167832167832168
"United States","North Dakota","ND",2020-03-29,2020-04-04,7,2020,"14",762062,140,2,141,-1,138,0.262445837740236,-0.131222918870118,-0.00709219858156029
"United States","North Dakota","ND",2020-04-05,2020-04-11,7,2020,"15",762062,158,4,142,16,154,0.524891675480473,2.09956670192189,0.112676056338028
"United States","North Dakota","ND",2020-04-12,2020-04-18,7,2020,"16",762062,157,2,139,18,155,0.262445837740236,2.36201253966213,0.129496402877698
"United States","North Dakota","ND",2020-04-19,2020-04-25,7,2020,"17",762062,158,7,136,22,151,0.918560432090827,2.8869042151426,0.161764705882353
"United States","North Dakota","ND",2020-04-26,2020-05-02,7,2020,"18",762062,148,8,136,12,140,1.04978335096095,1.57467502644142,0.088235294117647
"United States","North Dakota","ND",2020-05-03,2020-05-09,7,2020,"19",762062,141,10,134,7,131,1.31222918870118,0.918560432090827,0.0522388059701493
"United States","North Dakota","ND",2020-05-10,2020-05-16,7,2020,"20",762062,153,8,130,23,145,1.04978335096095,3.01812713401272,0.176923076923077
"United States","North Dakota","ND",2020-05-17,2020-05-23,7,2020,"21",762062,140,10,129,11,130,1.31222918870118,1.4434521075713,0.0852713178294573
"United States","North Dakota","ND",2020-05-24,2020-05-30,7,2020,"22",762062,143,7,133,10,136,0.918560432090827,1.31222918870118,0.0751879699248121
"United States","North Dakota","ND",2020-05-31,2020-06-06,7,2020,"23",762062,161,13,130,31,148,1.70589794531154,4.06791048497366,0.238461538461539
"United States","North Dakota","ND",2020-06-07,2020-06-13,7,2020,"24",762062,143,2,130,13,141,0.262445837740236,1.70589794531154,0.1
"United States","North Dakota","ND",2020-06-14,2020-06-20,7,2020,"25",762062,142,2,129,13,140,0.262445837740236,1.70589794531154,0.10077519379845
"United States","North Dakota","ND",2020-06-21,2020-06-27,7,2020,"26",762062,131,2,129,2,129,0.262445837740236,0.262445837740236,0.0155038759689923
"United States","North Dakota","ND",2020-06-28,2020-07-04,7,2020,"27",762062,117,2,128,-11,115,0.262445837740236,-1.4434521075713,-0.0859375
"United States","North Dakota","ND",2020-07-05,2020-07-11,7,2020,"28",762062,135,7,128,7,128,0.918560432090827,0.918560432090827,0.0546875
"United States","North Dakota","ND",2020-07-12,2020-07-18,7,2020,"29",762062,134,3,130,4,131,0.393668756610355,0.524891675480473,0.0307692307692307
"United States","North Dakota","ND",2020-07-19,2020-07-25,7,2020,"30",762062,132,9,126,6,123,1.18100626983106,0.787337513220709,0.0476190476190477
"United States","North Dakota","ND",2020-07-26,2020-08-01,7,2020,"31",762062,139,4,124,15,135,0.524891675480473,1.96834378305177,0.120967741935484
"United States","North Dakota","ND",2020-08-02,2020-08-08,7,2020,"32",762062,154,9,128,26,145,1.18100626983106,3.41179589062307,0.203125
"United States","North Dakota","ND",2020-08-09,2020-08-15,7,2020,"33",762062,136,9,123,13,127,1.18100626983106,1.70589794531154,0.105691056910569
"United States","North Dakota","ND",2020-08-16,2020-08-22,7,2020,"34",762062,132,14,120,12,118,1.83712086418165,1.57467502644142,0.1
"United States","North Dakota","ND",2020-08-23,2020-08-29,7,2020,"35",762062,141,6,122,19,135,0.787337513220709,2.49323545853225,0.155737704918033
"United States","North Dakota","ND",2020-08-30,2020-09-05,7,2020,"36",762062,163,14,126,37,149,1.83712086418165,4.85524799819437,0.293650793650794
"United States","North Dakota","ND",2020-09-06,2020-09-12,7,2020,"37",762062,143,12,126,17,131,1.57467502644142,2.23078962079201,0.134920634920635
"United States","North Dakota","ND",2020-09-13,2020-09-19,7,2020,"38",762062,165,25,129,36,140,3.28057297175295,4.72402507932425,0.279069767441861
"United States","North Dakota","ND",2020-09-20,2020-09-26,7,2020,"39",762062,178,19,136,42,159,2.49323545853225,5.51136259254496,0.308823529411765
"United States","North Dakota","ND",2020-09-27,2020-10-03,7,2020,"40",762062,197,60,138,59,137,7.87337513220709,7.74215221333697,0.427536231884058
"United States","North Dakota","ND",2020-10-04,2020-10-10,7,2020,"41",762062,239,65,138,101,174,8.52948972655768,13.2535148058819,0.731884057971014
"United States","North Dakota","ND",2020-10-11,2020-10-17,7,2020,"42",762062,223,63,140,83,160,8.26704388881745,10.8915022662198,0.592857142857143
"United States","North Dakota","ND",2020-10-18,2020-10-24,7,2020,"43",762062,195,49,143,52,146,6.42992302463579,6.82359178124614,0.363636363636364
"United States","North Dakota","ND",2020-10-25,2020-10-31,7,2020,"44",762062,246,76,142,104,170,9.97294183412898,13.6471835624923,0.732394366197183
"United States","North Dakota","ND",2020-11-01,2020-11-07,7,2020,"45",762062,269,104,144,125,165,13.6471835624923,16.4028648587648,0.868055555555556
"United States","North Dakota","ND",2020-11-08,2020-11-14,7,2020,"46",762062,255,98,144,111,157,12.8598460492716,14.5657439945831,0.770833333333333
"United States","North Dakota","ND",2020-11-15,2020-11-21,7,2020,"47",762062,273,108,138,135,165,14.1720752379728,17.715094047466,0.978260869565217
"United States","North Dakota","ND",2020-11-22,2020-11-28,7,2020,"48",762062,248,81,135,113,167,10.6290564284796,14.8281898323234,0.837037037037037
"United States","North Dakota","ND",2020-11-29,2020-12-05,7,2020,"49",762062,283,92,137,146,191,12.0725085360509,19.1585461550373,1.06569343065693
"United States","North Dakota","ND",2020-12-06,2020-12-12,7,2020,"50",762062,231,57,135,96,174,7.47970637559674,12.5974002115313,0.711111111111111
"United States","North Dakota","ND",2020-12-13,2020-12-19,7,2020,"51",762062,200,140,137,63,60,18.3712086418165,8.26704388881745,0.45985401459854
"United States","North Dakota","ND",2020-12-20,2020-12-26,7,2020,"52",762062,200,60,139,61,140,7.87337513220709,8.00459805107721,0.438848920863309
"United States","North Dakota","ND",2020-12-27,2021-01-02,7,2020,"53",762062,163,46,141,22,117,6.03625426802544,2.8869042151426,0.156028368794326
"United States","North Dakota","ND",2021-01-03,2021-01-09,7,2021,"1",762062,156,42,142,14,114,5.51136259254496,1.83712086418165,0.0985915492957747
"United States","North Dakota","ND",2021-01-10,2021-01-16,7,2021,"2",762062,153,29,141,12,124,3.80546464723343,1.57467502644142,0.0851063829787233
"United States","North Dakota","ND",2021-01-17,2021-01-23,7,2021,"3",762062,140,30,143,-3,110,3.93668756610354,-0.393668756610355,-0.0209790209790209
"United States","North Dakota","ND",2021-01-24,2021-01-30,7,2021,"4",762062,147,11,144,3,136,1.4434521075713,0.393668756610355,0.0208333333333333
"United States","North Dakota","ND",2021-01-31,2021-02-06,7,2021,"5",762062,157,6,141,16,151,0.787337513220709,2.09956670192189,0.113475177304964
"United States","North Dakota","ND",2021-02-07,2021-02-13,7,2021,"6",762062,119,4,143,-24,115,0.524891675480473,-3.14935005288284,-0.167832167832168
"United States","North Dakota","ND",2021-02-14,2021-02-20,7,2021,"7",762062,131,6,142,-11,125,0.787337513220709,-1.4434521075713,-0.0774647887323944
"United States","North Dakota","ND",2021-02-21,2021-02-27,7,2021,"8",762062,162,8,143,19,154,1.04978335096095,2.49323545853225,0.132867132867133
"United States","North Dakota","ND",2021-02-28,2021-03-06,7,2021,"9",762062,155,4,142,13,151,0.524891675480473,1.70589794531154,0.091549295774648
"United States","North Dakota","ND",2021-03-07,2021-03-13,7,2021,"10",762062,135,9,144,-9,126,1.18100626983106,-1.18100626983106,-0.0625
"United States","North Dakota","ND",2021-03-14,2021-03-20,7,2021,"11",762062,144,3,145,-1,141,0.393668756610355,-0.131222918870118,-0.00689655172413794
"United States","North Dakota","ND",2021-03-21,2021-03-27,7,2021,"12",762062,146,6,152,-6,140,0.787337513220709,-0.787337513220709,-0.0394736842105263
"United States","North Dakota","ND",2021-03-28,2021-04-03,7,2021,"13",762062,140,0,149,-9,140,0,-1.18100626983106,-0.0604026845637584
"United States","North Dakota","ND",2021-04-04,2021-04-10,7,2021,"14",762062,137,3,151,-14,134,0.393668756610355,-1.83712086418165,-0.0927152317880795
"United States","North Dakota","ND",2021-04-11,2021-04-17,7,2021,"15",762062,147,8,153,-6,139,1.04978335096095,-0.787337513220709,-0.0392156862745098
"United States","North Dakota","ND",2021-04-18,2021-04-24,7,2021,"16",762062,128,7,148,-20,121,0.918560432090827,-2.62445837740236,-0.135135135135135
"United States","North Dakota","ND",2021-04-25,2021-05-01,7,2021,"17",762062,146,8,149,-3,138,1.04978335096095,-0.393668756610355,-0.0201342281879194
"United States","North Dakota","ND",2021-05-02,2021-05-08,7,2021,"18",762062,147,5,149,-2,142,0.656114594350591,-0.262445837740236,-0.0134228187919463
"United States","North Dakota","ND",2021-05-09,2021-05-15,7,2021,"19",762062,139,5,148,-9,134,0.656114594350591,-1.18100626983106,-0.0608108108108109
"United States","North Dakota","ND",2021-05-16,2021-05-22,7,2021,"20",762062,158,3,144,14,155,0.393668756610355,1.83712086418165,0.0972222222222223
"United States","North Dakota","ND",2021-05-23,2021-05-29,7,2021,"21",762062,124,5,148,-24,119,0.656114594350591,-3.14935005288284,-0.162162162162162
"United States","North Dakota","ND",2021-05-30,2021-06-05,7,2021,"22",762062,150,4,144,6,146,0.524891675480473,0.787337513220709,0.0416666666666667
"United States","North Dakota","ND",2021-06-06,2021-06-12,7,2021,"23",762062,142,4,145,-3,138,0.524891675480473,-0.393668756610355,-0.0206896551724138
"United States","North Dakota","ND",2021-06-13,2021-06-19,7,2021,"24",762062,129,3,142,-13,126,0.393668756610355,-1.70589794531154,-0.0915492957746479
"United States","North Dakota","ND",2021-06-20,2021-06-26,7,2021,"25",762062,153,5,140,13,148,0.656114594350591,1.70589794531154,0.0928571428571427
"United States","North Dakota","ND",2021-06-27,2021-07-03,7,2021,"26",762062,151,0,138,13,151,0,1.70589794531154,0.0942028985507246
"United States","North Dakota","ND",2021-07-04,2021-07-10,7,2021,"27",762062,144,4,139,5,140,0.524891675480473,0.656114594350591,0.0359712230215827
"United States","North Dakota","ND",2021-07-11,2021-07-17,7,2021,"28",762062,126,5,135,-9,121,0.656114594350591,-1.18100626983106,-0.0666666666666667
"United States","North Dakota","ND",2021-07-18,2021-07-24,7,2021,"29",762062,138,1,137,1,137,0.131222918870118,0.131222918870118,0.0072992700729928
"United States","North Dakota","ND",2021-07-25,2021-07-31,7,2021,"30",762062,127,1,136,-9,126,0.131222918870118,-1.18100626983106,-0.0661764705882353
"United States","North Dakota","ND",2021-08-01,2021-08-07,7,2021,"31",762062,124,3,142,-18,121,0.393668756610355,-2.36201253966213,-0.126760563380282
"United States","North Dakota","ND",2021-08-08,2021-08-14,7,2021,"32",762062,139,3,141,-2,136,0.393668756610355,-0.262445837740236,-0.0141843971631206
"United States","North Dakota","ND",2021-08-15,2021-08-21,7,2021,"33",762062,134,0,140,-6,134,0,-0.787337513220709,-0.0428571428571428
"United States","Ohio","OH",2019-12-29,2020-01-04,7,2020,"1",11689100,2541,0,2799,-258,2541,0,-2.2071844710029,-0.0921757770632369
"United States","Ohio","OH",2020-01-05,2020-01-11,7,2020,"2",11689100,2615,0,2857,-242,2615,0,-2.07030481388644,-0.0847042352117606
"United States","Ohio","OH",2020-01-12,2020-01-18,7,2020,"3",11689100,2478,0,2850,-372,2478,0,-3.18245202795767,-0.130526315789474
"United States","Ohio","OH",2020-01-19,2020-01-25,7,2020,"4",11689100,2565,0,2790,-225,2565,0,-1.9248701782002,-0.0806451612903226
"United States","Ohio","OH",2020-01-26,2020-02-01,7,2020,"5",11689100,2493,0,2718,-225,2493,0,-1.9248701782002,-0.0827814569536424
"United States","Ohio","OH",2020-02-02,2020-02-08,7,2020,"6",11689100,2533,0,2680,-147,2533,0,-1.25758184975747,-0.0548507462686567
"United States","Ohio","OH",2020-02-09,2020-02-15,7,2020,"7",11689100,2495,0,2665,-170,2495,0,-1.45434635686238,-0.0637898686679175
"United States","Ohio","OH",2020-02-16,2020-02-22,7,2020,"8",11689100,2527,0,2629,-102,2527,0,-0.872607814117426,-0.0387980220616204
"United States","Ohio","OH",2020-02-23,2020-02-29,7,2020,"9",11689100,2461,0,2579,-118,2461,0,-1.00948747123388,-0.04575416828228
"United States","Ohio","OH",2020-03-01,2020-03-07,7,2020,"10",11689100,2510,0,2576,-66,2510,0,-0.564628585605393,-0.0256211180124224
"United States","Ohio","OH",2020-03-08,2020-03-14,7,2020,"11",11689100,2555,0,2570,-15,2555,0,-0.12832467854668,-0.00583657587548636
"United States","Ohio","OH",2020-03-15,2020-03-21,7,2020,"12",11689100,2520,3,2571,-51,2517,0.025664935709336,-0.436303907058713,-0.0198366394399067
"United States","Ohio","OH",2020-03-22,2020-03-28,7,2020,"13",11689100,2511,22,2568,-57,2489,0.188209528535131,-0.487633778477385,-0.022196261682243
"United States","Ohio","OH",2020-03-29,2020-04-04,7,2020,"14",11689100,2572,77,2560,12,2495,0.658733349872959,0.102659742837344,0.00468749999999996
"United States","Ohio","OH",2020-04-05,2020-04-11,7,2020,"15",11689100,2633,145,2519,114,2488,1.24047189261791,0.97526755695477,0.0452560539896785
"United States","Ohio","OH",2020-04-12,2020-04-18,7,2020,"16",11689100,2656,204,2520,136,2452,1.74521562823485,1.1634770854899,0.053968253968254
"United States","Ohio","OH",2020-04-19,2020-04-25,7,2020,"17",11689100,2835,258,2473,362,2577,2.2071844710029,3.09690224225988,0.146380913869794
"United States","Ohio","OH",2020-04-26,2020-05-02,7,2020,"18",11689100,2738,312,2421,317,2426,2.66915331377095,2.71192820661984,0.130937629078893
"United States","Ohio","OH",2020-05-03,2020-05-09,7,2020,"19",11689100,2616,310,2370,246,2306,2.65204335663139,2.10452472816556,0.10379746835443
"United States","Ohio","OH",2020-05-10,2020-05-16,7,2020,"20",11689100,2685,279,2335,350,2406,2.38683902096825,2.99424249942254,0.149892933618844
"United States","Ohio","OH",2020-05-17,2020-05-23,7,2020,"21",11689100,2664,341,2328,336,2323,2.91724769229453,2.87447279944564,0.144329896907216
"United States","Ohio","OH",2020-05-24,2020-05-30,7,2020,"22",11689100,2530,195,2318,212,2335,1.66822082110684,1.81365545679308,0.0914581535806729
"United States","Ohio","OH",2020-05-31,2020-06-06,7,2020,"23",11689100,2597,224,2315,282,2373,1.91631519963042,2.41250395667759,0.121814254859611
"United States","Ohio","OH",2020-06-07,2020-06-13,7,2020,"24",11689100,2421,184,2297,124,2237,1.57411605683928,1.06081734265256,0.0539834566826296
"United States","Ohio","OH",2020-06-14,2020-06-20,7,2020,"25",11689100,2404,143,2294,110,2261,1.22336193547835,0.941047642675655,0.0479511769834351
"United States","Ohio","OH",2020-06-21,2020-06-27,7,2020,"26",11689100,2429,107,2308,121,2322,0.915382706966319,1.03515240694322,0.052426343154246
"United States","Ohio","OH",2020-06-28,2020-07-04,7,2020,"27",11689100,2529,103,2315,214,2426,0.881162792687204,1.83076541393264,0.09244060475162
"United States","Ohio","OH",2020-07-05,2020-07-11,7,2020,"28",11689100,2515,129,2278,237,2386,1.10359223550145,2.02752992103755,0.104038630377524
"United States","Ohio","OH",2020-07-12,2020-07-18,7,2020,"29",11689100,2537,96,2272,265,2441,0.821277942698753,2.26706932099135,0.116637323943662
"United States","Ohio","OH",2020-07-19,2020-07-25,7,2020,"30",11689100,2504,165,2276,228,2339,1.41157146401348,1.95053511390954,0.100175746924429
"United States","Ohio","OH",2020-07-26,2020-08-01,7,2020,"31",11689100,2621,218,2283,338,2403,1.86498532821175,2.89158275658519,0.148050810337276
"United States","Ohio","OH",2020-08-02,2020-08-08,7,2020,"32",11689100,2584,153,2269,315,2431,1.30891172117614,2.69481824948029,0.138827677390921
"United States","Ohio","OH",2020-08-09,2020-08-15,7,2020,"33",11689100,2588,156,2268,320,2432,1.33457665688547,2.73759314232918,0.141093474426808
"United States","Ohio","OH",2020-08-16,2020-08-22,7,2020,"34",11689100,2592,151,2277,315,2441,1.29180176403658,2.69481824948029,0.138339920948617
"United States","Ohio","OH",2020-08-23,2020-08-29,7,2020,"35",11689100,2650,286,2274,376,2364,2.4467238709567,3.21667194223678,0.165347405452946
"United States","Ohio","OH",2020-08-30,2020-09-05,7,2020,"36",11689100,2426,-5,2295,131,2431,-0.0427748928488934,1.12070219264101,0.0570806100217864
"United States","Ohio","OH",2020-09-06,2020-09-12,7,2020,"37",11689100,2557,155,2297,260,2402,1.3260216783157,2.22429442814246,0.113191118850675
"United States","Ohio","OH",2020-09-13,2020-09-19,7,2020,"38",11689100,2485,201,2308,177,2284,1.71955069252552,1.51423120685083,0.076689774696707
"United States","Ohio","OH",2020-09-20,2020-09-26,7,2020,"39",11689100,2630,128,2304,326,2502,1.09503725693167,2.78892301374785,0.141493055555556
"United States","Ohio","OH",2020-09-27,2020-10-03,7,2020,"40",11689100,2602,185,2298,304,2417,1.58267103540906,2.60071348521272,0.132288946910357
"United States","Ohio","OH",2020-10-04,2020-10-10,7,2020,"41",11689100,2665,72,2276,389,2593,0.615958457024065,3.32788666364391,0.17091388400703
"United States","Ohio","OH",2020-10-11,2020-10-17,7,2020,"42",11689100,2650,70,2293,357,2580,0.598848499884508,3.05412734941099,0.155691234191016
"United States","Ohio","OH",2020-10-18,2020-10-24,7,2020,"43",11689100,2691,139,2296,395,2552,1.18914202119924,3.37921653506258,0.172038327526132
"United States","Ohio","OH",2020-10-25,2020-10-31,7,2020,"44",11689100,2763,95,2300,463,2668,0.812722964128975,3.96095507780753,0.201304347826087
"United States","Ohio","OH",2020-11-01,2020-11-07,7,2020,"45",11689100,3028,205,2311,717,2823,1.75377060680463,6.13391963453132,0.310255300735612
"United States","Ohio","OH",2020-11-08,2020-11-14,7,2020,"46",11689100,3070,208,2349,721,2862,1.77943554251397,6.16813954881043,0.306939123031077
"United States","Ohio","OH",2020-11-15,2020-11-21,7,2020,"47",11689100,3256,28,2376,880,3228,0.239539399953803,7.52838114140524,0.37037037037037
"United States","Ohio","OH",2020-11-22,2020-11-28,7,2020,"48",11689100,3568,657,2389,1179,2911,5.62062092034459,10.0863197337691,0.493511929677689
"United States","Ohio","OH",2020-11-29,2020-12-05,7,2020,"49",11689100,3910,544,2412,1498,3366,4.6539083419596,12.8153578975285,0.62106135986733
"United States","Ohio","OH",2020-12-06,2020-12-12,7,2020,"50",11689100,4230,530,2433,1797,3700,4.5341386419827,15.3732964898923,0.738594327990136
"United States","Ohio","OH",2020-12-13,2020-12-19,7,2020,"51",11689100,4066,550,2453,1613,3516,4.70523821337828,13.799180433053,0.657562168772931
"United States","Ohio","OH",2020-12-20,2020-12-26,7,2020,"52",11689100,3913,453,2493,1420,3460,3.87540529210974,12.1480695690857,0.569594865623746
"United States","Ohio","OH",2020-12-27,2021-01-02,7,2020,"53",11689100,3911,541,2531,1380,3370,4.62824340625027,11.8058704262946,0.545239035954168
"United States","Ohio","OH",2021-01-03,2021-01-09,7,2021,"1",11689100,3679,582,2569,1110,3097,4.97899752761119,9.49602621245434,0.432074737251849
"United States","Ohio","OH",2021-01-10,2021-01-16,7,2021,"2",11689100,3578,535,2595,983,3043,4.5769135348316,8.40954393409245,0.378805394990366
"United States","Ohio","OH",2021-01-17,2021-01-23,7,2021,"3",11689100,3285,546,2573,712,2739,4.67101829909916,6.09114474168242,0.276719782355227
"United States","Ohio","OH",2021-01-24,2021-01-30,7,2021,"4",11689100,3126,441,2557,569,2685,3.7727455492724,4.86778280620407,0.2225263981228
"United States","Ohio","OH",2021-01-31,2021-02-06,7,2021,"5",11689100,3108,532,2509,599,2576,4.55124859912226,5.12443216329743,0.238740534077322
"United States","Ohio","OH",2021-02-07,2021-02-13,7,2021,"6",11689100,2947,4687,2474,473,-1740,40.0971845565527,4.04650486350532,0.191188358932902
"United States","Ohio","OH",2021-02-14,2021-02-20,7,2021,"7",11689100,2848,422,2459,389,2426,3.6102009564466,3.32788666364391,0.158194387962586
"United States","Ohio","OH",2021-02-21,2021-02-27,7,2021,"8",11689100,2779,484,2468,311,2295,4.14060962777288,2.66059833520117,0.126012965964344
"United States","Ohio","OH",2021-02-28,2021-03-06,7,2021,"9",11689100,2572,637,2462,110,1935,5.44952134894902,0.941047642675655,0.0446791226645005
"United States","Ohio","OH",2021-03-07,2021-03-13,7,2021,"10",11689100,2549,565,2489,60,1984,4.83356289192496,0.513298714186721,0.0241060666934512
"United States","Ohio","OH",2021-03-14,2021-03-20,7,2021,"11",11689100,2414,338,2462,-48,2076,2.89158275658519,-0.410638971349377,-0.0194963444354184
"United States","Ohio","OH",2021-03-21,2021-03-27,7,2021,"12",11689100,2501,127,2444,57,2374,1.08648227836189,0.487633778477385,0.0233224222585924
"United States","Ohio","OH",2021-03-28,2021-04-03,7,2021,"13",11689100,2403,-270,2431,-28,2673,-2.30984421384024,-0.239539399953803,-0.011517893870835
"United States","Ohio","OH",2021-04-04,2021-04-10,7,2021,"14",11689100,2559,184,2430,129,2375,1.57411605683928,1.10359223550145,0.0530864197530865
"United States","Ohio","OH",2021-04-11,2021-04-17,7,2021,"15",11689100,2420,164,2406,14,2256,1.4030164854437,0.119769699976902,0.00581878636741484
"United States","Ohio","OH",2021-04-18,2021-04-24,7,2021,"16",11689100,2579,131,2390,189,2448,1.12070219264101,1.61689094968817,0.0790794979079499
"United States","Ohio","OH",2021-04-25,2021-05-01,7,2021,"17",11689100,2477,162,2340,137,2315,1.38590652830415,1.17203206405968,0.0585470085470086
"United States","Ohio","OH",2021-05-02,2021-05-08,7,2021,"18",11689100,2412,144,2328,84,2268,1.23191691404813,0.718618199861409,0.0360824742268042
"United States","Ohio","OH",2021-05-09,2021-05-15,7,2021,"19",11689100,2420,100,2300,120,2320,0.855497856977868,1.02659742837344,0.0521739130434782
"United States","Ohio","OH",2021-05-16,2021-05-22,7,2021,"20",11689100,2557,181,2291,266,2376,1.54845112112994,2.27562429956113,0.11610650371017
"United States","Ohio","OH",2021-05-23,2021-05-29,7,2021,"21",11689100,2442,152,2272,170,2290,1.30035674260636,1.45434635686238,0.0748239436619718
"United States","Ohio","OH",2021-05-30,2021-06-05,7,2021,"22",11689100,2427,119,2248,179,2308,1.01804244980366,1.53134116399038,0.0796263345195729
"United States","Ohio","OH",2021-06-06,2021-06-12,7,2021,"23",11689100,2303,111,2265,38,2192,0.949602621245434,0.32508918565159,0.0167770419426048
"United States","Ohio","OH",2021-06-13,2021-06-19,7,2021,"24",11689100,2403,75,2259,144,2328,0.641623392733401,1.23191691404813,0.0637450199203187
"United States","Ohio","OH",2021-06-20,2021-06-26,7,2021,"25",11689100,2373,115,2277,96,2258,0.983822535524548,0.821277942698753,0.0421607378129116
"United States","Ohio","OH",2021-06-27,2021-07-03,7,2021,"26",11689100,2359,63,2276,83,2296,0.538963649896057,0.710063221291631,0.0364674868189807
"United States","Ohio","OH",2021-07-04,2021-07-10,7,2021,"27",11689100,2372,36,2260,112,2336,0.307979228512033,0.958157599815212,0.0495575221238937
"United States","Ohio","OH",2021-07-11,2021-07-17,7,2021,"28",11689100,2351,57,2249,102,2294,0.487633778477385,0.872607814117426,0.0453534904401955
"United States","Ohio","OH",2021-07-18,2021-07-24,7,2021,"29",11689100,2355,30,2248,107,2325,0.256649357093361,0.915382706966319,0.0475978647686832
"United States","Ohio","OH",2021-07-25,2021-07-31,7,2021,"30",11689100,2357,25,2246,111,2332,0.213874464244467,0.949602621245434,0.0494211932324131
"United States","Ohio","OH",2021-08-01,2021-08-07,7,2021,"31",11689100,2466,64,2239,227,2402,0.547518628465836,1.94198013533976,0.101384546672622
"United States","Ohio","OH",2021-08-08,2021-08-14,7,2021,"32",11689100,2573,58,2215,358,2515,0.496188757047164,3.06268232798077,0.161625282167043
"United States","Ohio","OH",2021-08-15,2021-08-21,7,2021,"33",11689100,2632,0,2237,395,2632,0,3.37921653506258,0.176575771122038
"United States","Oklahoma","OK",2019-12-29,2020-01-04,7,2020,"1",3956971,901,0,930,-29,901,0,-0.73288381441259,-0.0311827956989247
"United States","Oklahoma","OK",2020-01-05,2020-01-11,7,2020,"2",3956971,823,0,931,-108,823,0,-2.72936041229516,-0.116004296455424
"United States","Oklahoma","OK",2020-01-12,2020-01-18,7,2020,"3",3956971,850,0,947,-97,850,0,-2.45136999993177,-0.102428722280887
"United States","Oklahoma","OK",2020-01-19,2020-01-25,7,2020,"4",3956971,803,0,931,-128,803,0,-3.23479752568316,-0.137486573576799
"United States","Oklahoma","OK",2020-01-26,2020-02-01,7,2020,"5",3956971,833,0,920,-87,833,0,-2.19865144323777,-0.0945652173913043
"United States","Oklahoma","OK",2020-02-02,2020-02-08,7,2020,"6",3956971,816,0,909,-93,816,0,-2.35028257725417,-0.102310231023102
"United States","Oklahoma","OK",2020-02-09,2020-02-15,7,2020,"7",3956971,806,0,898,-92,806,0,-2.32501072158477,-0.102449888641425
"United States","Oklahoma","OK",2020-02-16,2020-02-22,7,2020,"8",3956971,818,0,882,-64,818,0,-1.61739876284158,-0.072562358276644
"United States","Oklahoma","OK",2020-02-23,2020-02-29,7,2020,"9",3956971,829,0,863,-34,829,0,-0.859243092759588,-0.0393974507531866
"United States","Oklahoma","OK",2020-03-01,2020-03-07,7,2020,"10",3956971,799,0,856,-57,799,0,-1.44049577315578,-0.0665887850467289
"United States","Oklahoma","OK",2020-03-08,2020-03-14,7,2020,"11",3956971,792,0,849,-57,792,0,-1.44049577315578,-0.0671378091872792
"United States","Oklahoma","OK",2020-03-15,2020-03-21,7,2020,"12",3956971,827,1,827,0,826,0.0252718556693996,0,0
"United States","Oklahoma","OK",2020-03-22,2020-03-28,7,2020,"13",3956971,856,14,808,48,842,0.353805979371595,1.21304907213118,0.0594059405940595
"United States","Oklahoma","OK",2020-03-29,2020-04-04,7,2020,"14",3956971,784,27,790,-6,757,0.68234010307379,-0.151631134016398,-0.0075949367088608
"United States","Oklahoma","OK",2020-04-05,2020-04-11,7,2020,"15",3956971,857,52,781,76,805,1.31413649480878,1.92066103087437,0.0973111395646606
"United States","Oklahoma","OK",2020-04-12,2020-04-18,7,2020,"16",3956971,799,37,787,12,762,0.935058659767787,0.303262268032796,0.0152477763659467
"United States","Oklahoma","OK",2020-04-19,2020-04-25,7,2020,"17",3956971,780,63,791,-11,717,1.59212690717218,-0.277990412363396,-0.0139064475347661
"United States","Oklahoma","OK",2020-04-26,2020-05-02,7,2020,"18",3956971,759,44,787,-28,715,1.11196164945358,-0.70761195874319,-0.0355781448538754
"United States","Oklahoma","OK",2020-05-03,2020-05-09,7,2020,"19",3956971,776,32,778,-2,744,0.808699381420789,-0.0505437113387993,-0.00257069408740362
"United States","Oklahoma","OK",2020-05-10,2020-05-16,7,2020,"20",3956971,733,18,770,-37,715,0.454893402049194,-0.935058659767787,-0.048051948051948
"United States","Oklahoma","OK",2020-05-17,2020-05-23,7,2020,"21",3956971,815,23,761,54,792,0.581252680396192,1.36468020614758,0.0709592641261498
"United States","Oklahoma","OK",2020-05-24,2020-05-30,7,2020,"22",3956971,740,22,746,-6,718,0.555980824726792,-0.151631134016398,-0.00804289544235925
"United States","Oklahoma","OK",2020-05-31,2020-06-06,7,2020,"23",3956971,789,14,746,43,775,0.353805979371595,1.08668979378419,0.0576407506702412
"United States","Oklahoma","OK",2020-06-07,2020-06-13,7,2020,"24",3956971,770,12,723,47,758,0.303262268032796,1.18777721646178,0.0650069156293223
"United States","Oklahoma","OK",2020-06-14,2020-06-20,7,2020,"25",3956971,741,9,722,19,732,0.227446701024597,0.480165257718593,0.0263157894736843
"United States","Oklahoma","OK",2020-06-21,2020-06-27,7,2020,"26",3956971,765,16,723,42,749,0.404349690710394,1.06141793811479,0.058091286307054
"United States","Oklahoma","OK",2020-06-28,2020-07-04,7,2020,"27",3956971,781,14,727,54,767,0.353805979371595,1.36468020614758,0.0742778541953233
"United States","Oklahoma","OK",2020-07-05,2020-07-11,7,2020,"28",3956971,768,23,729,39,745,0.581252680396192,0.985602371106586,0.0534979423868314
"United States","Oklahoma","OK",2020-07-12,2020-07-18,7,2020,"29",3956971,794,30,727,67,764,0.758155670081989,1.69321432984978,0.0921595598349381
"United States","Oklahoma","OK",2020-07-19,2020-07-25,7,2020,"30",3956971,904,45,733,171,859,1.13723350512298,4.32148731946734,0.233287858117326
"United States","Oklahoma","OK",2020-07-26,2020-08-01,7,2020,"31",3956971,881,53,748,133,828,1.33940835047818,3.36115680403015,0.177807486631016
"United States","Oklahoma","OK",2020-08-02,2020-08-08,7,2020,"32",3956971,814,54,741,73,760,1.36468020614758,1.84484546386617,0.0985155195681511
"United States","Oklahoma","OK",2020-08-09,2020-08-15,7,2020,"33",3956971,860,54,742,118,806,1.36468020614758,2.98207896898916,0.159029649595687
"United States","Oklahoma","OK",2020-08-16,2020-08-22,7,2020,"34",3956971,877,68,740,137,809,1.71848618551918,3.46224422670775,0.185135135135135
"United States","Oklahoma","OK",2020-08-23,2020-08-29,7,2020,"35",3956971,814,72,732,82,742,1.81957360819677,2.07229216489077,0.112021857923497
"United States","Oklahoma","OK",2020-08-30,2020-09-05,7,2020,"36",3956971,828,53,729,99,775,1.33940835047818,2.50191371127057,0.135802469135802
"United States","Oklahoma","OK",2020-09-06,2020-09-12,7,2020,"37",3956971,802,49,732,70,753,1.23832092780058,1.76902989685798,0.0956284153005464
"United States","Oklahoma","OK",2020-09-13,2020-09-19,7,2020,"38",3956971,793,44,731,62,749,1.11196164945358,1.56685505150278,0.0848153214774281
"United States","Oklahoma","OK",2020-09-20,2020-09-26,7,2020,"39",3956971,909,61,729,180,848,1.54158319583338,4.54893402049194,0.246913580246914
"United States","Oklahoma","OK",2020-09-27,2020-10-03,7,2020,"40",3956971,851,47,735,116,804,1.18777721646178,2.93153525765036,0.157823129251701
"United States","Oklahoma","OK",2020-10-04,2020-10-10,7,2020,"41",3956971,970,44,725,245,926,1.11196164945358,6.19160463900291,0.337931034482759
"United States","Oklahoma","OK",2020-10-11,2020-10-17,7,2020,"42",3956971,862,73,727,135,789,1.84484546386617,3.41170051536895,0.185694635488308
"United States","Oklahoma","OK",2020-10-18,2020-10-24,7,2020,"43",3956971,945,77,727,218,868,1.94593288654377,5.50926453592912,0.299862448418157
"United States","Oklahoma","OK",2020-10-25,2020-10-31,7,2020,"44",3956971,1025,92,740,285,933,2.32501072158477,7.2024788657789,0.385135135135135
"United States","Oklahoma","OK",2020-11-01,2020-11-07,7,2020,"45",3956971,1028,92,742,286,936,2.32501072158477,7.2277507214483,0.38544474393531
"United States","Oklahoma","OK",2020-11-08,2020-11-14,7,2020,"46",3956971,1065,87,750,315,978,2.19865144323777,7.96063453586089,0.42
"United States","Oklahoma","OK",2020-11-15,2020-11-21,7,2020,"47",3956971,1148,87,768,380,1061,2.19865144323777,9.60330515437187,0.494791666666667
"United States","Oklahoma","OK",2020-11-22,2020-11-28,7,2020,"48",3956971,1148,114,776,372,1034,2.88099154631156,9.40113030901667,0.479381443298969
"United States","Oklahoma","OK",2020-11-29,2020-12-05,7,2020,"49",3956971,1321,157,776,545,1164,3.96768134009574,13.7731613398228,0.702319587628866
"United States","Oklahoma","OK",2020-12-06,2020-12-12,7,2020,"50",3956971,1212,168,785,427,1044,4.24567175245914,10.7910823708336,0.543949044585987
"United States","Oklahoma","OK",2020-12-13,2020-12-19,7,2020,"51",3956971,1281,147,794,487,1134,3.71496278340175,12.3073937109976,0.613350125944584
"United States","Oklahoma","OK",2020-12-20,2020-12-26,7,2020,"52",3956971,1272,168,793,479,1104,4.24567175245914,12.1052188656424,0.604035308953342
"United States","Oklahoma","OK",2020-12-27,2021-01-02,7,2020,"53",3956971,1337,170,807,530,1167,4.29621546379794,13.3940835047818,0.656753407682776
"United States","Oklahoma","OK",2021-01-03,2021-01-09,7,2021,"1",3956971,1259,211,827,432,1048,5.33236154624333,10.9174416491806,0.522370012091898
"United States","Oklahoma","OK",2021-01-10,2021-01-16,7,2021,"2",3956971,1304,214,847,457,1090,5.40817711325152,11.5492380409156,0.539551357733176
"United States","Oklahoma","OK",2021-01-17,2021-01-23,7,2021,"3",3956971,1306,279,861,445,1027,7.0508477317625,11.2459757728828,0.516840882694541
"United States","Oklahoma","OK",2021-01-24,2021-01-30,7,2021,"4",3956971,1172,273,871,301,899,6.8992165977461,7.60682855648929,0.345579793340987
"United States","Oklahoma","OK",2021-01-31,2021-02-06,7,2021,"5",3956971,1054,257,862,192,797,6.49486690703571,4.85219628852473,0.222737819025522
"United States","Oklahoma","OK",2021-02-07,2021-02-13,7,2021,"6",3956971,985,233,837,148,752,5.88834237097012,3.74023463907115,0.176821983273596
"United States","Oklahoma","OK",2021-02-14,2021-02-20,7,2021,"7",3956971,1013,161,832,181,852,4.06876876277334,4.57420587616134,0.217548076923077
"United States","Oklahoma","OK",2021-02-21,2021-02-27,7,2021,"8",3956971,920,224,824,96,696,5.66089566994552,2.42609814426237,0.116504854368932
"United States","Oklahoma","OK",2021-02-28,2021-03-06,7,2021,"9",3956971,879,156,821,58,723,3.94240948442635,1.46576762882518,0.0706455542021924
"United States","Oklahoma","OK",2021-03-07,2021-03-13,7,2021,"10",3956971,840,167,807,33,673,4.22039989678974,0.833971237090188,0.0408921933085502
"United States","Oklahoma","OK",2021-03-14,2021-03-20,7,2021,"11",3956971,776,86,792,-16,690,2.17337958756837,-0.404349690710394,-0.0202020202020202
"United States","Oklahoma","OK",2021-03-21,2021-03-27,7,2021,"12",3956971,831,62,778,53,769,1.56685505150278,1.33940835047818,0.0681233933161953
"United States","Oklahoma","OK",2021-03-28,2021-04-03,7,2021,"13",3956971,787,103,754,33,684,2.60300113394816,0.833971237090188,0.0437665782493368
"United States","Oklahoma","OK",2021-04-04,2021-04-10,7,2021,"14",3956971,839,1716,748,91,-877,43.3665043286898,2.29973886591537,0.121657754010695
"United States","Oklahoma","OK",2021-04-11,2021-04-17,7,2021,"15",3956971,786,28,737,49,758,0.70761195874319,1.23832092780058,0.0664857530529173
"United States","Oklahoma","OK",2021-04-18,2021-04-24,7,2021,"16",3956971,784,19,738,46,765,0.480165257718593,1.16250536079238,0.0623306233062331
"United States","Oklahoma","OK",2021-04-25,2021-05-01,7,2021,"17",3956971,741,72,737,4,669,1.81957360819677,0.101087422677599,0.00542740841248301
"United States","Oklahoma","OK",2021-05-02,2021-05-08,7,2021,"18",3956971,827,44,732,95,783,1.11196164945358,2.40082628859297,0.129781420765027
"United States","Oklahoma","OK",2021-05-09,2021-05-15,7,2021,"19",3956971,782,46,736,46,736,1.16250536079238,1.16250536079238,0.0625
"United States","Oklahoma","OK",2021-05-16,2021-05-22,7,2021,"20",3956971,787,40,730,57,747,1.01087422677599,1.44049577315578,0.0780821917808219
"United States","Oklahoma","OK",2021-05-23,2021-05-29,7,2021,"21",3956971,749,373,718,31,376,9.42640216468607,0.783427525751389,0.0431754874651811
"United States","Oklahoma","OK",2021-05-30,2021-06-05,7,2021,"22",3956971,752,25,712,40,727,0.631796391734991,1.01087422677599,0.0561797752808988
"United States","Oklahoma","OK",2021-06-06,2021-06-12,7,2021,"23",3956971,833,9,705,128,824,0.227446701024597,3.23479752568316,0.181560283687943
"United States","Oklahoma","OK",2021-06-13,2021-06-19,7,2021,"24",3956971,828,29,706,122,799,0.73288381441259,3.08316639166676,0.172804532577904
"United States","Oklahoma","OK",2021-06-20,2021-06-26,7,2021,"25",3956971,782,30,711,71,752,0.758155670081989,1.79430175252738,0.09985935302391
"United States","Oklahoma","OK",2021-06-27,2021-07-03,7,2021,"26",3956971,796,4,706,90,792,0.101087422677599,2.27446701024597,0.127478753541076
"United States","Oklahoma","OK",2021-07-04,2021-07-10,7,2021,"27",3956971,802,18,700,102,784,0.454893402049194,2.57772927827876,0.145714285714286
"United States","Oklahoma","OK",2021-07-11,2021-07-17,7,2021,"28",3956971,764,11,698,66,753,0.277990412363396,1.66794247418038,0.0945558739255015
"United States","Oklahoma","OK",2021-07-18,2021-07-24,7,2021,"29",3956971,807,37,711,96,770,0.935058659767787,2.42609814426237,0.135021097046413
"United States","Oklahoma","OK",2021-07-25,2021-07-31,7,2021,"30",3956971,855,31,711,144,824,0.783427525751389,3.63914721639355,0.20253164556962
"United States","Oklahoma","OK",2021-08-01,2021-08-07,7,2021,"31",3956971,858,46,706,152,812,1.16250536079238,3.84132206174875,0.215297450424929
"United States","Oklahoma","OK",2021-08-08,2021-08-14,7,2021,"32",3956971,825,63,708,117,762,1.59212690717218,2.95680711331976,0.165254237288136
"United States","Oklahoma","OK",2021-08-15,2021-08-21,7,2021,"33",3956971,783,0,708,75,783,0,1.89538917520497,0.10593220338983
"United States","Oregon","OR",2019-12-29,2020-01-04,7,2020,"1",4217737,737,0,816,-79,737,0,-1.87304234474554,-0.0968137254901961
"United States","Oregon","OR",2020-01-05,2020-01-11,7,2020,"2",4217737,764,0,813,-49,764,0,-1.16176044167761,-0.060270602706027
"United States","Oregon","OR",2020-01-12,2020-01-18,7,2020,"3",4217737,769,0,797,-28,769,0,-0.663863109530063,-0.0351317440401505
"United States","Oregon","OR",2020-01-19,2020-01-25,7,2020,"4",4217737,745,0,769,-24,745,0,-0.56902552245434,-0.0312093628088427
"United States","Oregon","OR",2020-01-26,2020-02-01,7,2020,"5",4217737,728,0,744,-16,728,0,-0.379350348302893,-0.021505376344086
"United States","Oregon","OR",2020-02-02,2020-02-08,7,2020,"6",4217737,727,0,719,8,727,0,0.189675174151447,0.0111265646731571
"United States","Oregon","OR",2020-02-09,2020-02-15,7,2020,"7",4217737,783,0,714,69,783,0,1.63594837705623,0.096638655462185
"United States","Oregon","OR",2020-02-16,2020-02-22,7,2020,"8",4217737,733,0,720,13,733,0,0.308222157996101,0.0180555555555555
"United States","Oregon","OR",2020-02-23,2020-02-29,7,2020,"9",4217737,735,0,728,7,735,0,0.165965777382516,0.00961538461538458
"United States","Oregon","OR",2020-03-01,2020-03-07,7,2020,"10",4217737,788,0,738,50,788,0,1.18546983844654,0.0677506775067751
"United States","Oregon","OR",2020-03-08,2020-03-14,7,2020,"11",4217737,746,1,729,17,745,0.0237093967689308,0.403059745071824,0.0233196159122084
"United States","Oregon","OR",2020-03-15,2020-03-21,7,2020,"12",4217737,775,3,722,53,772,0.0711281903067925,1.25659802875333,0.0734072022160666
"United States","Oregon","OR",2020-03-22,2020-03-28,7,2020,"13",4217737,768,9,713,55,759,0.213384570920377,1.3040168222912,0.0771388499298737
"United States","Oregon","OR",2020-03-29,2020-04-04,7,2020,"14",4217737,778,13,699,79,765,0.308222157996101,1.87304234474554,0.113018597997139
"United States","Oregon","OR",2020-04-05,2020-04-11,7,2020,"15",4217737,769,25,703,66,744,0.592734919223271,1.56482018674943,0.0938833570412518
"United States","Oregon","OR",2020-04-12,2020-04-18,7,2020,"16",4217737,765,21,693,72,744,0.497897332147547,1.70707656736302,0.103896103896104
"United States","Oregon","OR",2020-04-19,2020-04-25,7,2020,"17",4217737,770,15,680,90,755,0.355640951533962,2.13384570920377,0.132352941176471
"United States","Oregon","OR",2020-04-26,2020-05-02,7,2020,"18",4217737,714,22,679,35,692,0.521606728916478,0.829828886912579,0.0515463917525774
"United States","Oregon","OR",2020-05-03,2020-05-09,7,2020,"19",4217737,703,18,676,27,685,0.426769141840755,0.640153712761132,0.0399408284023668
"United States","Oregon","OR",2020-05-10,2020-05-16,7,2020,"20",4217737,716,10,675,41,706,0.237093967689308,0.972085267526164,0.0607407407407408
"United States","Oregon","OR",2020-05-17,2020-05-23,7,2020,"21",4217737,744,10,662,82,734,0.237093967689308,1.94417053505233,0.123867069486405
"United States","Oregon","OR",2020-05-24,2020-05-30,7,2020,"22",4217737,748,6,656,92,742,0.142256380613585,2.18126450274164,0.140243902439024
"United States","Oregon","OR",2020-05-31,2020-06-06,7,2020,"23",4217737,683,8,649,34,675,0.189675174151447,0.806119490143648,0.0523882896764252
"United States","Oregon","OR",2020-06-07,2020-06-13,7,2020,"24",4217737,727,13,649,78,714,0.308222157996101,1.8493329479766,0.120184899845917
"United States","Oregon","OR",2020-06-14,2020-06-20,7,2020,"25",4217737,731,15,655,76,716,0.355640951533962,1.80191415443874,0.116030534351145
"United States","Oregon","OR",2020-06-21,2020-06-27,7,2020,"26",4217737,689,14,653,36,675,0.331931554765032,0.85353828368151,0.0551301684532925
"United States","Oregon","OR",2020-06-28,2020-07-04,7,2020,"27",4217737,760,10,640,120,750,0.237093967689308,2.8451276122717,0.1875
"United States","Oregon","OR",2020-07-05,2020-07-11,7,2020,"28",4217737,713,19,638,75,694,0.450478538609686,1.77820475766981,0.117554858934169
"United States","Oregon","OR",2020-07-12,2020-07-18,7,2020,"29",4217737,759,25,640,119,734,0.592734919223271,2.82141821550277,0.1859375
"United States","Oregon","OR",2020-07-19,2020-07-25,7,2020,"30",4217737,740,29,647,93,711,0.687572506298994,2.20497389951057,0.143740340030912
"United States","Oregon","OR",2020-07-26,2020-08-01,7,2020,"31",4217737,719,39,642,77,680,0.924666473988302,1.82562355120767,0.11993769470405
"United States","Oregon","OR",2020-08-02,2020-08-08,7,2020,"32",4217737,768,30,642,126,738,0.711281903067925,2.98738399288528,0.196261682242991
"United States","Oregon","OR",2020-08-09,2020-08-15,7,2020,"33",4217737,777,31,636,141,746,0.734991299836856,3.34302494441925,0.221698113207547
"United States","Oregon","OR",2020-08-16,2020-08-22,7,2020,"34",4217737,789,31,637,152,758,0.734991299836856,3.60382830887749,0.23861852433281
"United States","Oregon","OR",2020-08-23,2020-08-29,7,2020,"35",4217737,749,38,629,120,711,0.900957077219371,2.8451276122717,0.190779014308426
"United States","Oregon","OR",2020-08-30,2020-09-05,7,2020,"36",4217737,707,25,624,83,682,0.592734919223271,1.96787993182126,0.13301282051282
"United States","Oregon","OR",2020-09-06,2020-09-12,7,2020,"37",4217737,737,25,624,113,712,0.592734919223271,2.67916183488918,0.181089743589744
"United States","Oregon","OR",2020-09-13,2020-09-19,7,2020,"38",4217737,790,19,627,163,771,0.450478538609686,3.86463167333573,0.259968102073365
"United States","Oregon","OR",2020-09-20,2020-09-26,7,2020,"39",4217737,730,19,640,90,711,0.450478538609686,2.13384570920377,0.140625
"United States","Oregon","OR",2020-09-27,2020-10-03,7,2020,"40",4217737,733,20,655,78,713,0.474187935378617,1.8493329479766,0.119083969465649
"United States","Oregon","OR",2020-10-04,2020-10-10,7,2020,"41",4217737,761,34,662,99,727,0.806119490143648,2.34723028012415,0.149546827794562
"United States","Oregon","OR",2020-10-11,2020-10-17,7,2020,"42",4217737,713,23,646,67,690,0.545316125685409,1.58852958351837,0.103715170278638
"United States","Oregon","OR",2020-10-18,2020-10-24,7,2020,"43",4217737,763,33,656,107,730,0.782410093374717,2.5369054542756,0.163109756097561
"United States","Oregon","OR",2020-10-25,2020-10-31,7,2020,"44",4217737,782,35,654,128,747,0.829828886912579,3.03480278642315,0.195718654434251
"United States","Oregon","OR",2020-11-01,2020-11-07,7,2020,"45",4217737,835,41,659,176,794,0.972085267526164,4.17285383133183,0.267071320182094
"United States","Oregon","OR",2020-11-08,2020-11-14,7,2020,"46",4217737,838,30,662,176,808,0.711281903067925,4.17285383133183,0.265861027190332
"United States","Oregon","OR",2020-11-15,2020-11-21,7,2020,"47",4217737,835,60,681,154,775,1.42256380613585,3.65124710241535,0.226138032305433
"United States","Oregon","OR",2020-11-22,2020-11-28,7,2020,"48",4217737,880,77,672,208,803,1.82562355120767,4.93155452793761,0.30952380952381
"United States","Oregon","OR",2020-11-29,2020-12-05,7,2020,"49",4217737,936,131,681,255,805,3.10593097672994,6.04589617607736,0.374449339207048
"United States","Oregon","OR",2020-12-06,2020-12-12,7,2020,"50",4217737,941,110,689,252,831,2.60803364458239,5.97476798577057,0.365747460087083
"United States","Oregon","OR",2020-12-13,2020-12-19,7,2020,"51",4217737,979,165,714,265,814,3.91205046687359,6.28299014376667,0.371148459383754
"United States","Oregon","OR",2020-12-20,2020-12-26,7,2020,"52",4217737,878,113,729,149,765,2.67916183488918,3.53270011857069,0.204389574759945
"United States","Oregon","OR",2020-12-27,2021-01-02,7,2020,"53",4217737,904,62,770,134,842,1.46998259967371,3.17705916703673,0.174025974025974
"United States","Oregon","OR",2021-01-03,2021-01-09,7,2021,"1",4217737,885,98,776,109,787,2.32352088335522,2.58432424781346,0.140463917525773
"United States","Oregon","OR",2021-01-10,2021-01-16,7,2021,"2",4217737,888,183,771,117,705,4.33881960871434,2.77399942196491,0.151750972762646
"United States","Oregon","OR",2021-01-17,2021-01-23,7,2021,"3",4217737,854,107,771,83,747,2.5369054542756,1.96787993182126,0.107652399481193
"United States","Oregon","OR",2021-01-24,2021-01-30,7,2021,"4",4217737,836,73,760,76,763,1.73078596413195,1.80191415443874,0.1
"United States","Oregon","OR",2021-01-31,2021-02-06,7,2021,"5",4217737,835,64,749,86,771,1.51740139321157,2.03900812212805,0.114819759679573
"United States","Oregon","OR",2021-02-07,2021-02-13,7,2021,"6",4217737,791,92,744,47,699,2.18126450274164,1.11434164813975,0.0631720430107527
"United States","Oregon","OR",2021-02-14,2021-02-20,7,2021,"7",4217737,814,55,753,61,759,1.3040168222912,1.44627320290478,0.0810092961487383
"United States","Oregon","OR",2021-02-21,2021-02-27,7,2021,"8",4217737,800,57,762,38,743,1.35143561582906,0.900957077219371,0.0498687664041995
"United States","Oregon","OR",2021-02-28,2021-03-06,7,2021,"9",4217737,793,87,779,14,706,2.06271751889698,0.331931554765032,0.017971758664955
"United States","Oregon","OR",2021-03-07,2021-03-13,7,2021,"10",4217737,779,26,777,2,753,0.616444315992202,0.0474187935378617,0.00257400257400264
"United States","Oregon","OR",2021-03-14,2021-03-20,7,2021,"11",4217737,832,38,771,61,794,0.900957077219371,1.44627320290478,0.0791180285343709
"United States","Oregon","OR",2021-03-21,2021-03-27,7,2021,"12",4217737,809,16,767,42,793,0.379350348302893,0.995794664295095,0.0547588005215125
"United States","Oregon","OR",2021-03-28,2021-04-03,7,2021,"13",4217737,816,12,764,52,804,0.28451276122717,1.2328886319844,0.0680628272251309
"United States","Oregon","OR",2021-04-04,2021-04-10,7,2021,"14",4217737,786,55,749,37,731,1.3040168222912,0.877247680450441,0.0493991989319091
"United States","Oregon","OR",2021-04-11,2021-04-17,7,2021,"15",4217737,746,17,737,9,729,0.403059745071824,0.213384570920377,0.0122116689280869
"United States","Oregon","OR",2021-04-18,2021-04-24,7,2021,"16",4217737,794,19,727,67,775,0.450478538609686,1.58852958351837,0.0921595598349381
"United States","Oregon","OR",2021-04-25,2021-05-01,7,2021,"17",4217737,780,19,722,58,761,0.450478538609686,1.37514501259799,0.0803324099722991
"United States","Oregon","OR",2021-05-02,2021-05-08,7,2021,"18",4217737,778,27,719,59,751,0.640153712761132,1.39885440936692,0.082058414464534
"United States","Oregon","OR",2021-05-09,2021-05-15,7,2021,"19",4217737,812,60,715,97,752,1.42256380613585,2.29981148658629,0.135664335664336
"United States","Oregon","OR",2021-05-16,2021-05-22,7,2021,"20",4217737,824,31,714,110,793,0.734991299836856,2.60803364458239,0.15406162464986
"United States","Oregon","OR",2021-05-23,2021-05-29,7,2021,"21",4217737,784,52,707,77,732,1.2328886319844,1.82562355120767,0.108910891089109
"United States","Oregon","OR",2021-05-30,2021-06-05,7,2021,"22",4217737,805,21,716,89,784,0.497897332147547,2.11013631243484,0.124301675977654
"United States","Oregon","OR",2021-06-06,2021-06-12,7,2021,"23",4217737,794,40,714,80,754,0.948375870757233,1.89675174151447,0.112044817927171
"United States","Oregon","OR",2021-06-13,2021-06-19,7,2021,"24",4217737,775,24,714,61,751,0.56902552245434,1.44627320290478,0.0854341736694677
"United States","Oregon","OR",2021-06-20,2021-06-26,7,2021,"25",4217737,773,11,709,64,762,0.260803364458239,1.51740139321157,0.0902679830747533
"United States","Oregon","OR",2021-06-27,2021-07-03,7,2021,"26",4217737,936,20,715,221,916,0.474187935378617,5.23977668593371,0.309090909090909
"United States","Oregon","OR",2021-07-04,2021-07-10,7,2021,"27",4217737,787,11,706,81,776,0.260803364458239,1.9204611382834,0.114730878186969
"United States","Oregon","OR",2021-07-11,2021-07-17,7,2021,"28",4217737,780,25,704,76,755,0.592734919223271,1.80191415443874,0.107954545454545
"United States","Oregon","OR",2021-07-18,2021-07-24,7,2021,"29",4217737,793,19,707,86,774,0.450478538609686,2.03900812212805,0.121640735502122
"United States","Oregon","OR",2021-07-25,2021-07-31,7,2021,"30",4217737,795,22,709,86,773,0.521606728916478,2.03900812212805,0.1212976022567
"United States","Oregon","OR",2021-08-01,2021-08-07,7,2021,"31",4217737,761,31,703,58,730,0.734991299836856,1.37514501259799,0.0825035561877667
"United States","Oregon","OR",2021-08-08,2021-08-14,7,2021,"32",4217737,825,46,707,118,779,1.09063225137082,2.79770881873384,0.166902404526167
"United States","Oregon","OR",2021-08-15,2021-08-21,7,2021,"33",4217737,795,14,713,82,781,0.331931554765032,1.94417053505233,0.115007012622721
"United States","Pennsylvania","PA",2019-12-29,2020-01-04,7,2020,"1",12801989,2785,0,3009,-224,2785,0,-1.74972810865562,-0.0744433366566966
"United States","Pennsylvania","PA",2020-01-05,2020-01-11,7,2020,"2",12801989,2849,0,3091,-242,2849,0,-1.89033126024401,-0.0782918149466192
"United States","Pennsylvania","PA",2020-01-12,2020-01-18,7,2020,"3",12801989,2862,0,3039,-177,2862,0,-1.38259765728591,-0.0582428430404739
"United States","Pennsylvania","PA",2020-01-19,2020-01-25,7,2020,"4",12801989,2795,0,3002,-207,2795,0,-1.61693624326657,-0.0689540306462358
"United States","Pennsylvania","PA",2020-01-26,2020-02-01,7,2020,"5",12801989,2810,0,2980,-170,2810,0,-1.32791865389042,-0.0570469798657718
"United States","Pennsylvania","PA",2020-02-02,2020-02-08,7,2020,"6",12801989,2787,0,2954,-167,2787,0,-1.30448479529236,-0.0565335138794855
"United States","Pennsylvania","PA",2020-02-09,2020-02-15,7,2020,"7",12801989,2811,0,2911,-100,2811,0,-0.781128619935543,-0.0343524562006183
"United States","Pennsylvania","PA",2020-02-16,2020-02-22,7,2020,"8",12801989,2704,0,2897,-193,2704,0,-1.5075782364756,-0.0666206420434933
"United States","Pennsylvania","PA",2020-02-23,2020-02-29,7,2020,"9",12801989,2774,0,2851,-77,2774,0,-0.601469037350368,-0.0270080673447913
"United States","Pennsylvania","PA",2020-03-01,2020-03-07,7,2020,"10",12801989,2787,0,2836,-49,2787,0,-0.382753023768416,-0.017277856135402
"United States","Pennsylvania","PA",2020-03-08,2020-03-14,7,2020,"11",12801989,2833,0,2813,20,2833,0,0.156225723987109,0.00710984713828644
"United States","Pennsylvania","PA",2020-03-15,2020-03-21,7,2020,"12",12801989,2603,2,2792,-189,2601,0.0156225723987109,-1.47633309167818,-0.0676934097421203
"United States","Pennsylvania","PA",2020-03-22,2020-03-28,7,2020,"13",12801989,2735,32,2767,-32,2703,0.249961158379374,-0.249961158379374,-0.0115648717022045
"United States","Pennsylvania","PA",2020-03-29,2020-04-04,7,2020,"14",12801989,3004,102,2744,260,2902,0.796751192334254,2.03093441183241,0.0947521865889214
"United States","Pennsylvania","PA",2020-04-05,2020-04-11,7,2020,"15",12801989,3453,355,2699,754,3098,2.77300660077118,5.88970979431399,0.279362726935902
"United States","Pennsylvania","PA",2020-04-12,2020-04-18,7,2020,"16",12801989,3743,345,2666,1077,3398,2.69489373877762,8.4127552367058,0.4039759939985
"United States","Pennsylvania","PA",2020-04-19,2020-04-25,7,2020,"17",12801989,3823,700,2617,1206,3123,5.4679003395488,9.42041115642265,0.46083301490256
"United States","Pennsylvania","PA",2020-04-26,2020-05-02,7,2020,"18",12801989,3564,881,2554,1010,2683,6.88174314163213,7.88939906134898,0.395458104933438
"United States","Pennsylvania","PA",2020-05-03,2020-05-09,7,2020,"19",12801989,3439,1252,2506,933,2187,9.779730321593,7.28793002399861,0.372306464485235
"United States","Pennsylvania","PA",2020-05-10,2020-05-16,7,2020,"20",12801989,3284,534,2472,812,2750,4.1712268304558,6.34276439387661,0.328478964401294
"United States","Pennsylvania","PA",2020-05-17,2020-05-23,7,2020,"21",12801989,2977,893,2443,534,2084,6.9754785760244,4.1712268304558,0.218583708555055
"United States","Pennsylvania","PA",2020-05-24,2020-05-30,7,2020,"22",12801989,2792,440,2445,347,2352,3.43696592771639,2.71051631117633,0.141922290388548
"United States","Pennsylvania","PA",2020-05-31,2020-06-06,7,2020,"23",12801989,2730,394,2454,276,2336,3.07764676254604,2.1559149910221,0.112469437652812
"United States","Pennsylvania","PA",2020-06-07,2020-06-13,7,2020,"24",12801989,2573,280,2427,146,2293,2.18716013581952,1.14044778510589,0.0601565718994643
"United States","Pennsylvania","PA",2020-06-14,2020-06-20,7,2020,"25",12801989,2624,209,2447,177,2415,1.63255881566528,1.38259765728591,0.0723334695545566
"United States","Pennsylvania","PA",2020-06-21,2020-06-27,7,2020,"26",12801989,2561,183,2405,156,2378,1.42946537448204,1.21856064709945,0.0648648648648649
"United States","Pennsylvania","PA",2020-06-28,2020-07-04,7,2020,"27",12801989,2595,147,2386,209,2448,1.14825907130525,1.63255881566528,0.0875943000838224
"United States","Pennsylvania","PA",2020-07-05,2020-07-11,7,2020,"28",12801989,2677,148,2382,295,2529,1.1560703575046,2.30432942880985,0.12384550797649
"United States","Pennsylvania","PA",2020-07-12,2020-07-18,7,2020,"29",12801989,2560,110,2353,207,2450,0.859241481929097,1.61693624326657,0.0879728006799829
"United States","Pennsylvania","PA",2020-07-19,2020-07-25,7,2020,"30",12801989,2535,107,2355,180,2428,0.835807623331031,1.40603151588398,0.0764331210191083
"United States","Pennsylvania","PA",2020-07-26,2020-08-01,7,2020,"31",12801989,2645,90,2353,292,2555,0.703015757941989,2.28089557021179,0.12409689757756
"United States","Pennsylvania","PA",2020-08-02,2020-08-08,7,2020,"32",12801989,2540,109,2349,191,2431,0.851430195729742,1.49195566407689,0.081311196253725
"United States","Pennsylvania","PA",2020-08-09,2020-08-15,7,2020,"33",12801989,2661,152,2349,312,2509,1.18731550230203,2.43712129419889,0.132822477650064
"United States","Pennsylvania","PA",2020-08-16,2020-08-22,7,2020,"34",12801989,2634,111,2357,277,2523,0.867052768128453,2.16372627722145,0.117522274077217
"United States","Pennsylvania","PA",2020-08-23,2020-08-29,7,2020,"35",12801989,2589,95,2372,217,2494,0.742072188938766,1.69504910526013,0.0914839797639122
"United States","Pennsylvania","PA",2020-08-30,2020-09-05,7,2020,"36",12801989,2604,89,2387,217,2515,0.695204471742633,1.69504910526013,0.0909090909090908
"United States","Pennsylvania","PA",2020-09-06,2020-09-12,7,2020,"37",12801989,2619,77,2369,250,2542,0.601469037350368,1.95282154983886,0.105529759392148
"United States","Pennsylvania","PA",2020-09-13,2020-09-19,7,2020,"38",12801989,2618,119,2369,249,2499,0.929543057723296,1.9450102636395,0.10510764035458
"United States","Pennsylvania","PA",2020-09-20,2020-09-26,7,2020,"39",12801989,2678,147,2383,295,2531,1.14825907130525,2.30432942880985,0.1237935375577
"United States","Pennsylvania","PA",2020-09-27,2020-10-03,7,2020,"40",12801989,2681,96,2407,274,2585,0.749883475138121,2.14029241862339,0.11383464894059
"United States","Pennsylvania","PA",2020-10-04,2020-10-10,7,2020,"41",12801989,2769,73,2445,324,2696,0.570223892552946,2.53085672859116,0.132515337423313
"United States","Pennsylvania","PA",2020-10-11,2020-10-17,7,2020,"42",12801989,2669,194,2464,205,2475,1.51538952267495,1.60131367086786,0.083198051948052
"United States","Pennsylvania","PA",2020-10-18,2020-10-24,7,2020,"43",12801989,2766,188,2459,307,2578,1.46852180547882,2.39806486320212,0.124847498983327
"United States","Pennsylvania","PA",2020-10-25,2020-10-31,7,2020,"44",12801989,2758,158,2459,299,2600,1.23418321949816,2.33557457360727,0.12159414396096
"United States","Pennsylvania","PA",2020-11-01,2020-11-07,7,2020,"45",12801989,2984,203,2479,505,2781,1.58569109846915,3.94469953067449,0.203711173860428
"United States","Pennsylvania","PA",2020-11-08,2020-11-14,7,2020,"46",12801989,3123,259,2480,643,2864,2.02312312563306,5.02265702618554,0.259274193548387
"United States","Pennsylvania","PA",2020-11-15,2020-11-21,7,2020,"47",12801989,3355,415,2511,844,2940,3.2416837727325,6.59272555225598,0.336121067303863
"United States","Pennsylvania","PA",2020-11-22,2020-11-28,7,2020,"48",12801989,3659,586,2542,1117,3073,4.57741371282228,8.72520668468001,0.439417781274587
"United States","Pennsylvania","PA",2020-11-29,2020-12-05,7,2020,"49",12801989,3903,987,2575,1328,2916,7.70973947876381,10.373388072744,0.515728155339806
"United States","Pennsylvania","PA",2020-12-06,2020-12-12,7,2020,"50",12801989,4355,1174,2587,1768,3181,9.17044999804327,13.8103540004604,0.683417085427136
"United States","Pennsylvania","PA",2020-12-13,2020-12-19,7,2020,"51",12801989,4456,1389,2613,1843,3067,10.8498765309047,14.3962004654121,0.705319556065825
"United States","Pennsylvania","PA",2020-12-20,2020-12-26,7,2020,"52",12801989,4490,1054,2661,1829,3436,8.23309565412062,14.2868424586211,0.687335588124765
"United States","Pennsylvania","PA",2020-12-27,2021-01-02,7,2020,"53",12801989,4425,1360,2685,1740,3065,10.6233492311234,13.5916379868784,0.64804469273743
"United States","Pennsylvania","PA",2021-01-03,2021-01-09,7,2021,"1",12801989,4003,1428,2723,1280,2575,11.1545166926796,9.99844633517495,0.470069775982372
"United States","Pennsylvania","PA",2021-01-10,2021-01-16,7,2021,"2",12801989,3886,1521,2771,1115,2365,11.8809663092196,8.7095841122813,0.402381811620354
"United States","Pennsylvania","PA",2021-01-17,2021-01-23,7,2021,"3",12801989,3846,1338,2777,1069,2508,10.4515009347376,8.35026494711095,0.384947785379906
"United States","Pennsylvania","PA",2021-01-24,2021-01-30,7,2021,"4",12801989,3585,1076,2786,799,2509,8.40494395050644,6.24121767328499,0.286791098348887
"United States","Pennsylvania","PA",2021-01-31,2021-02-06,7,2021,"5",12801989,3393,794,2783,610,2599,6.20216124228821,4.76488458160681,0.219187926697808
"United States","Pennsylvania","PA",2021-02-07,2021-02-13,7,2021,"6",12801989,3230,564,2740,490,2666,4.40556541643646,3.82753023768416,0.178832116788321
"United States","Pennsylvania","PA",2021-02-14,2021-02-20,7,2021,"7",12801989,3116,611,2724,392,2505,4.77269586780617,3.06202419014733,0.143906020558003
"United States","Pennsylvania","PA",2021-02-21,2021-02-27,7,2021,"8",12801989,2888,370,2721,167,2518,2.89017589376151,1.30448479529236,0.0613744946710768
"United States","Pennsylvania","PA",2021-02-28,2021-03-06,7,2021,"9",12801989,2759,381,2700,59,2378,2.97610004195442,0.46086588576197,0.0218518518518518
"United States","Pennsylvania","PA",2021-03-07,2021-03-13,7,2021,"10",12801989,2698,253,2671,27,2445,1.97625540843692,0.210904727382597,0.010108573567952
"United States","Pennsylvania","PA",2021-03-14,2021-03-20,7,2021,"11",12801989,2807,207,2657,150,2600,1.61693624326657,1.17169292990331,0.0564546480993602
"United States","Pennsylvania","PA",2021-03-21,2021-03-27,7,2021,"12",12801989,2697,207,2638,59,2490,1.61693624326657,0.46086588576197,0.0223654283548143
"United States","Pennsylvania","PA",2021-03-28,2021-04-03,7,2021,"13",12801989,2621,201,2630,-9,2420,1.57006852607044,-0.0703015757941989,-0.00342205323193912
"United States","Pennsylvania","PA",2021-04-04,2021-04-10,7,2021,"14",12801989,2776,172,2603,173,2604,1.34354122628913,1.35135251248849,0.0664617748751442
"United States","Pennsylvania","PA",2021-04-11,2021-04-17,7,2021,"15",12801989,2845,299,2565,280,2546,2.33557457360727,2.18716013581952,0.10916179337232
"United States","Pennsylvania","PA",2021-04-18,2021-04-24,7,2021,"16",12801989,2799,277,2551,248,2522,2.16372627722145,1.93719897744015,0.0972167777342219
"United States","Pennsylvania","PA",2021-04-25,2021-05-01,7,2021,"17",12801989,2687,315,2511,176,2372,2.46055515279696,1.37478637108656,0.0700915969733173
"United States","Pennsylvania","PA",2021-05-02,2021-05-08,7,2021,"18",12801989,2735,279,2468,267,2456,2.17934884962016,2.0856134152279,0.108184764991896
"United States","Pennsylvania","PA",2021-05-09,2021-05-15,7,2021,"19",12801989,2705,192,2456,249,2513,1.49976695027624,1.9450102636395,0.101384364820847
"United States","Pennsylvania","PA",2021-05-16,2021-05-22,7,2021,"20",12801989,2703,305,2427,276,2398,2.38244229080341,2.1559149910221,0.11372064276885
"United States","Pennsylvania","PA",2021-05-23,2021-05-29,7,2021,"21",12801989,2529,158,2418,111,2371,1.23418321949816,0.867052768128453,0.0459057071960298
"United States","Pennsylvania","PA",2021-05-30,2021-06-05,7,2021,"22",12801989,2609,162,2413,196,2447,1.26542836429558,1.53101209507366,0.0812266887691671
"United States","Pennsylvania","PA",2021-06-06,2021-06-12,7,2021,"23",12801989,2418,125,2429,-11,2293,0.976410774919429,-0.0859241481929097,-0.00452861259777682
"United States","Pennsylvania","PA",2021-06-13,2021-06-19,7,2021,"24",12801989,2510,86,2414,96,2424,0.671770613144567,0.749883475138121,0.03976801988401
"United States","Pennsylvania","PA",2021-06-20,2021-06-26,7,2021,"25",12801989,2487,83,2404,83,2404,0.648336754546501,0.648336754546501,0.0345257903494176
"United States","Pennsylvania","PA",2021-06-27,2021-07-03,7,2021,"26",12801989,2522,62,2394,128,2460,0.484299744360037,0.999844633517495,0.0534670008354219
"United States","Pennsylvania","PA",2021-07-04,2021-07-10,7,2021,"27",12801989,2497,40,2375,122,2457,0.312451447974217,0.952976916321362,0.0513684210526315
"United States","Pennsylvania","PA",2021-07-11,2021-07-17,7,2021,"28",12801989,2393,45,2380,13,2348,0.351507878970994,0.101546720591621,0.00546218487394956
"United States","Pennsylvania","PA",2021-07-18,2021-07-24,7,2021,"29",12801989,2465,33,2369,96,2432,0.257772444578729,0.749883475138121,0.0405234276065851
"United States","Pennsylvania","PA",2021-07-25,2021-07-31,7,2021,"30",12801989,2462,27,2378,84,2435,0.210904727382597,0.656148040745856,0.0353238015138773
"United States","Pennsylvania","PA",2021-08-01,2021-08-07,7,2021,"31",12801989,2496,52,2370,126,2444,0.406186882366482,0.984222061118784,0.0531645569620254
"United States","Pennsylvania","PA",2021-08-08,2021-08-14,7,2021,"32",12801989,2643,64,2364,279,2579,0.499922316758747,2.17934884962016,0.118020304568528
"United States","Pennsylvania","PA",2021-08-15,2021-08-21,7,2021,"33",12801989,2607,0,2376,231,2607,0,1.8044071120511,0.0972222222222223
"United States","Rhode Island","RI",2019-12-29,2020-01-04,7,2020,"1",1059361,225,0,229,-4,225,0,-0.377586110872498,-0.017467248908297
"United States","Rhode Island","RI",2020-01-05,2020-01-11,7,2020,"2",1059361,201,0,228,-27,201,0,-2.54870624838936,-0.118421052631579
"United States","Rhode Island","RI",2020-01-12,2020-01-18,7,2020,"3",1059361,204,0,229,-25,204,0,-2.35991319295311,-0.109170305676856
"United States","Rhode Island","RI",2020-01-19,2020-01-25,7,2020,"4",1059361,199,0,226,-27,199,0,-2.54870624838936,-0.119469026548673
"United States","Rhode Island","RI",2020-01-26,2020-02-01,7,2020,"5",1059361,220,0,228,-8,220,0,-0.755172221744995,-0.0350877192982456
"United States","Rhode Island","RI",2020-02-02,2020-02-08,7,2020,"6",1059361,244,0,229,15,244,0,1.41594791577187,0.0655021834061136
"United States","Rhode Island","RI",2020-02-09,2020-02-15,7,2020,"7",1059361,183,0,228,-45,183,0,-4.2478437473156,-0.197368421052632
"United States","Rhode Island","RI",2020-02-16,2020-02-22,7,2020,"8",1059361,206,0,228,-22,206,0,-2.07672360979874,-0.0964912280701754
"United States","Rhode Island","RI",2020-02-23,2020-02-29,7,2020,"9",1059361,235,0,219,16,235,0,1.51034444348999,0.0730593607305936
"United States","Rhode Island","RI",2020-03-01,2020-03-07,7,2020,"10",1059361,251,0,218,33,251,0,3.11508541469811,0.151376146788991
"United States","Rhode Island","RI",2020-03-08,2020-03-14,7,2020,"11",1059361,196,0,216,-20,196,0,-1.88793055436249,-0.0925925925925926
"United States","Rhode Island","RI",2020-03-15,2020-03-21,7,2020,"12",1059361,220,0,218,2,220,0,0.188793055436249,0.00917431192660545
"United States","Rhode Island","RI",2020-03-22,2020-03-28,7,2020,"13",1059361,200,2,211,-11,198,0.188793055436249,-1.03836180489937,-0.0521327014218009
"United States","Rhode Island","RI",2020-03-29,2020-04-04,7,2020,"14",1059361,236,13,216,20,223,1.22715486033562,1.88793055436249,0.0925925925925926
"United States","Rhode Island","RI",2020-04-05,2020-04-11,7,2020,"15",1059361,246,41,219,27,205,3.8702576364431,2.54870624838936,0.123287671232877
"United States","Rhode Island","RI",2020-04-12,2020-04-18,7,2020,"16",1059361,273,81,219,54,192,7.64611874516808,5.09741249677872,0.246575342465754
"United States","Rhode Island","RI",2020-04-19,2020-04-25,7,2020,"17",1059361,297,78,215,82,219,7.3629291620137,7.7405152728862,0.381395348837209
"United States","Rhode Island","RI",2020-04-26,2020-05-02,7,2020,"18",1059361,332,81,218,114,251,7.64611874516808,10.7612041598662,0.522935779816514
"United States","Rhode Island","RI",2020-05-03,2020-05-09,7,2020,"19",1059361,381,122,219,162,259,11.5163763816112,15.2922374903362,0.73972602739726
"United States","Rhode Island","RI",2020-05-10,2020-05-16,7,2020,"20",1059361,303,71,214,89,232,6.70215346798683,8.40129096691307,0.41588785046729
"United States","Rhode Island","RI",2020-05-17,2020-05-23,7,2020,"21",1059361,279,108,203,76,171,10.1948249935574,7.17413610657746,0.374384236453202
"United States","Rhode Island","RI",2020-05-24,2020-05-30,7,2020,"22",1059361,254,121,197,57,133,11.4219798538931,5.38060207993309,0.289340101522843
"United States","Rhode Island","RI",2020-05-31,2020-06-06,7,2020,"23",1059361,241,54,193,48,187,5.09741249677872,4.53103333046997,0.248704663212435
"United States","Rhode Island","RI",2020-06-07,2020-06-13,7,2020,"24",1059361,209,61,195,14,148,5.75818819080559,1.32155138805374,0.0717948717948718
"United States","Rhode Island","RI",2020-06-14,2020-06-20,7,2020,"25",1059361,237,61,195,42,176,5.75818819080559,3.96465416416123,0.215384615384615
"United States","Rhode Island","RI",2020-06-21,2020-06-27,7,2020,"26",1059361,200,33,193,7,167,3.11508541469811,0.660775694026871,0.0362694300518134
"United States","Rhode Island","RI",2020-06-28,2020-07-04,7,2020,"27",1059361,177,33,192,-15,144,3.11508541469811,-1.41594791577187,-0.078125
"United States","Rhode Island","RI",2020-07-05,2020-07-11,7,2020,"28",1059361,190,16,193,-3,174,1.51034444348999,-0.283189583154373,-0.0155440414507773
"United States","Rhode Island","RI",2020-07-12,2020-07-18,7,2020,"29",1059361,190,14,190,0,176,1.32155138805374,0,0
"United States","Rhode Island","RI",2020-07-19,2020-07-25,7,2020,"30",1059361,173,4,189,-16,169,0.377586110872498,-1.51034444348999,-0.0846560846560847
"United States","Rhode Island","RI",2020-07-26,2020-08-01,7,2020,"31",1059361,200,-5,189,11,205,-0.471982638590622,1.03836180489937,0.0582010582010581
"United States","Rhode Island","RI",2020-08-02,2020-08-08,7,2020,"32",1059361,209,5,187,22,204,0.471982638590622,2.07672360979874,0.117647058823529
"United States","Rhode Island","RI",2020-08-09,2020-08-15,7,2020,"33",1059361,211,7,184,27,204,0.660775694026871,2.54870624838936,0.146739130434783
"United States","Rhode Island","RI",2020-08-16,2020-08-22,7,2020,"34",1059361,198,7,194,4,191,0.660775694026871,0.377586110872498,0.0206185567010309
"United States","Rhode Island","RI",2020-08-23,2020-08-29,7,2020,"35",1059361,187,12,195,-8,175,1.13275833261749,-0.755172221744995,-0.041025641025641
"United States","Rhode Island","RI",2020-08-30,2020-09-05,7,2020,"36",1059361,207,11,194,13,196,1.03836180489937,1.22715486033562,0.0670103092783505
"United States","Rhode Island","RI",2020-09-06,2020-09-12,7,2020,"37",1059361,190,11,196,-6,179,1.03836180489937,-0.566379166308747,-0.0306122448979592
"United States","Rhode Island","RI",2020-09-13,2020-09-19,7,2020,"38",1059361,194,13,196,-2,181,1.22715486033562,-0.188793055436249,-0.0102040816326531
"United States","Rhode Island","RI",2020-09-20,2020-09-26,7,2020,"39",1059361,208,23,197,11,185,2.17112013751686,1.03836180489937,0.0558375634517767
"United States","Rhode Island","RI",2020-09-27,2020-10-03,7,2020,"40",1059361,218,14,197,21,204,1.32155138805374,1.98232708208061,0.106598984771574
"United States","Rhode Island","RI",2020-10-04,2020-10-10,7,2020,"41",1059361,214,12,198,16,202,1.13275833261749,1.51034444348999,0.0808080808080809
"United States","Rhode Island","RI",2020-10-11,2020-10-17,7,2020,"42",1059361,214,12,200,14,202,1.13275833261749,1.32155138805374,0.0700000000000001
"United States","Rhode Island","RI",2020-10-18,2020-10-24,7,2020,"43",1059361,196,23,198,-2,173,2.17112013751686,-0.188793055436249,-0.0101010101010101
"United States","Rhode Island","RI",2020-10-25,2020-10-31,7,2020,"44",1059361,204,27,202,2,177,2.54870624838936,0.188793055436249,0.00990099009900991
"United States","Rhode Island","RI",2020-11-01,2020-11-07,7,2020,"45",1059361,228,23,203,25,205,2.17112013751686,2.35991319295311,0.123152709359606
"United States","Rhode Island","RI",2020-11-08,2020-11-14,7,2020,"46",1059361,235,24,197,38,211,2.26551666523499,3.58706805328873,0.192893401015228
"United States","Rhode Island","RI",2020-11-15,2020-11-21,7,2020,"47",1059361,226,31,204,22,195,2.92629235926186,2.07672360979874,0.107843137254902
"United States","Rhode Island","RI",2020-11-22,2020-11-28,7,2020,"48",1059361,268,33,208,60,235,3.11508541469811,5.66379166308746,0.288461538461539
"United States","Rhode Island","RI",2020-11-29,2020-12-05,7,2020,"49",1059361,289,62,210,79,227,5.85258471852371,7.45732568973183,0.376190476190476
"United States","Rhode Island","RI",2020-12-06,2020-12-12,7,2020,"50",1059361,325,74,216,109,251,6.98534305114121,10.2892215212756,0.50462962962963
"United States","Rhode Island","RI",2020-12-13,2020-12-19,7,2020,"51",1059361,329,98,217,112,231,9.25085971637619,10.5724111044299,0.516129032258065
"United States","Rhode Island","RI",2020-12-20,2020-12-26,7,2020,"52",1059361,302,116,222,80,186,10.9499972153024,7.55172221744995,0.36036036036036
"United States","Rhode Island","RI",2020-12-27,2021-01-02,7,2020,"53",1059361,284,85,224,60,199,8.02370485604058,5.66379166308746,0.267857142857143
"United States","Rhode Island","RI",2021-01-03,2021-01-09,7,2021,"1",1059361,295,132,220,75,163,12.4603416587924,7.07973957885933,0.340909090909091
"United States","Rhode Island","RI",2021-01-10,2021-01-16,7,2021,"2",1059361,295,71,224,71,224,6.70215346798683,6.70215346798683,0.316964285714286
"United States","Rhode Island","RI",2021-01-17,2021-01-23,7,2021,"3",1059361,309,88,226,83,221,8.30689443919495,7.83491180060433,0.367256637168142
"United States","Rhode Island","RI",2021-01-24,2021-01-30,7,2021,"4",1059361,263,73,223,40,190,6.89094652342308,3.77586110872498,0.179372197309417
"United States","Rhode Island","RI",2021-01-31,2021-02-06,7,2021,"5",1059361,269,74,220,49,195,6.98534305114121,4.6254298581881,0.222727272727273
"United States","Rhode Island","RI",2021-02-07,2021-02-13,7,2021,"6",1059361,248,67,214,34,181,6.32456735711434,3.20948194241623,0.158878504672897
"United States","Rhode Island","RI",2021-02-14,2021-02-20,7,2021,"7",1059361,222,94,214,8,128,8.87327360550369,0.755172221744995,0.0373831775700935
"United States","Rhode Island","RI",2021-02-21,2021-02-27,7,2021,"8",1059361,227,137,212,15,90,12.932324297383,1.41594791577187,0.070754716981132
"United States","Rhode Island","RI",2021-02-28,2021-03-06,7,2021,"9",1059361,227,55,212,15,172,5.19180902449684,1.41594791577187,0.070754716981132
"United States","Rhode Island","RI",2021-03-07,2021-03-13,7,2021,"10",1059361,240,33,209,31,207,3.11508541469811,2.92629235926186,0.148325358851675
"United States","Rhode Island","RI",2021-03-14,2021-03-20,7,2021,"11",1059361,213,26,212,1,187,2.45430972067123,0.0943965277181244,0.00471698113207553
"United States","Rhode Island","RI",2021-03-21,2021-03-27,7,2021,"12",1059361,212,32,210,2,180,3.02068888697998,0.188793055436249,0.00952380952380949
"United States","Rhode Island","RI",2021-03-28,2021-04-03,7,2021,"13",1059361,198,36,206,-8,162,3.39827499785248,-0.755172221744995,-0.0388349514563107
"United States","Rhode Island","RI",2021-04-04,2021-04-10,7,2021,"14",1059361,220,8,206,14,212,0.755172221744995,1.32155138805374,0.0679611650485437
"United States","Rhode Island","RI",2021-04-11,2021-04-17,7,2021,"15",1059361,193,9,210,-17,184,0.84956874946312,-1.60474097120812,-0.080952380952381
"United States","Rhode Island","RI",2021-04-18,2021-04-24,7,2021,"16",1059361,204,13,215,-11,191,1.22715486033562,-1.03836180489937,-0.0511627906976744
"United States","Rhode Island","RI",2021-04-25,2021-05-01,7,2021,"17",1059361,211,11,212,-1,200,1.03836180489937,-0.0943965277181244,-0.00471698113207553
"United States","Rhode Island","RI",2021-05-02,2021-05-08,7,2021,"18",1059361,217,19,215,2,198,1.79353402664436,0.188793055436249,0.00930232558139532
"United States","Rhode Island","RI",2021-05-09,2021-05-15,7,2021,"19",1059361,243,10,214,29,233,0.943965277181244,2.73749930382561,0.135514018691589
"United States","Rhode Island","RI",2021-05-16,2021-05-22,7,2021,"20",1059361,196,4,204,-8,192,0.377586110872498,-0.755172221744995,-0.0392156862745098
"United States","Rhode Island","RI",2021-05-23,2021-05-29,7,2021,"21",1059361,194,4,201,-7,190,0.377586110872498,-0.660775694026871,-0.0348258706467661
"United States","Rhode Island","RI",2021-05-30,2021-06-05,7,2021,"22",1059361,192,9,199,-7,183,0.84956874946312,-0.660775694026871,-0.035175879396985
"United States","Rhode Island","RI",2021-06-06,2021-06-12,7,2021,"23",1059361,210,5,198,12,205,0.471982638590622,1.13275833261749,0.0606060606060606
"United States","Rhode Island","RI",2021-06-13,2021-06-19,7,2021,"24",1059361,170,2,202,-32,168,0.188793055436249,-3.02068888697998,-0.158415841584158
"United States","Rhode Island","RI",2021-06-20,2021-06-26,7,2021,"25",1059361,192,4,201,-9,188,0.377586110872498,-0.84956874946312,-0.0447761194029851
"United States","Rhode Island","RI",2021-06-27,2021-07-03,7,2021,"26",1059361,188,2,201,-13,186,0.188793055436249,-1.22715486033562,-0.0646766169154229
"United States","Rhode Island","RI",2021-07-04,2021-07-10,7,2021,"27",1059361,187,0,201,-14,187,0,-1.32155138805374,-0.0696517412935324
"United States","Rhode Island","RI",2021-07-11,2021-07-17,7,2021,"28",1059361,199,6,199,0,193,0.566379166308747,0,0
"United States","Rhode Island","RI",2021-07-18,2021-07-24,7,2021,"29",1059361,177,3,194,-17,174,0.283189583154373,-1.60474097120812,-0.0876288659793815
"United States","Rhode Island","RI",2021-07-25,2021-07-31,7,2021,"30",1059361,189,1,190,-1,188,0.0943965277181244,-0.0943965277181244,-0.00526315789473686
"United States","Rhode Island","RI",2021-08-01,2021-08-07,7,2021,"31",1059361,237,3,192,45,234,0.283189583154373,4.2478437473156,0.234375
"United States","Rhode Island","RI",2021-08-08,2021-08-14,7,2021,"32",1059361,186,1,194,-8,185,0.0943965277181244,-0.755172221744995,-0.0412371134020618
"United States","Rhode Island","RI",2021-08-15,2021-08-21,7,2021,"33",1059361,191,0,196,-5,191,0,-0.471982638590622,-0.0255102040816326
"United States","South Carolina","SC",2019-12-29,2020-01-04,7,2020,"1",5148714,1085,0,1121,-36,1085,0,-0.699203723492896,-0.032114183764496
"United States","South Carolina","SC",2020-01-05,2020-01-11,7,2020,"2",5148714,1081,0,1120,-39,1081,0,-0.757470700450637,-0.0348214285714286
"United States","South Carolina","SC",2020-01-12,2020-01-18,7,2020,"3",5148714,1048,0,1142,-94,1048,0,-1.82569861134256,-0.0823117338003503
"United States","South Carolina","SC",2020-01-19,2020-01-25,7,2020,"4",5148714,1033,0,1137,-104,1033,0,-2.01992186786836,-0.0914687774846086
"United States","South Carolina","SC",2020-01-26,2020-02-01,7,2020,"5",5148714,1032,0,1134,-102,1032,0,-1.9810772165632,-0.08994708994709
"United States","South Carolina","SC",2020-02-02,2020-02-08,7,2020,"6",5148714,1096,0,1098,-2,1096,0,-0.0388446513051609,-0.00182149362477235
"United States","South Carolina","SC",2020-02-09,2020-02-15,7,2020,"7",5148714,1003,0,1081,-78,1003,0,-1.51494140090127,-0.0721554116558741
"United States","South Carolina","SC",2020-02-16,2020-02-22,7,2020,"8",5148714,1035,0,1079,-44,1035,0,-0.854582328713539,-0.040778498609824
"United States","South Carolina","SC",2020-02-23,2020-02-29,7,2020,"9",5148714,1044,0,1059,-15,1044,0,-0.291334884788706,-0.0141643059490085
"United States","South Carolina","SC",2020-03-01,2020-03-07,7,2020,"10",5148714,1133,0,1052,81,1133,0,1.57320837785901,0.0769961977186311
"United States","South Carolina","SC",2020-03-08,2020-03-14,7,2020,"11",5148714,1103,0,1041,62,1103,0,1.20418419045999,0.0595581171950048
"United States","South Carolina","SC",2020-03-15,2020-03-21,7,2020,"12",5148714,1067,3,1030,37,1064,0.0582669769577413,0.718626049145476,0.0359223300970875
"United States","South Carolina","SC",2020-03-22,2020-03-28,7,2020,"13",5148714,1039,12,1041,-2,1027,0.233067907830965,-0.0388446513051609,-0.00192122958693564
"United States","South Carolina","SC",2020-03-29,2020-04-04,7,2020,"14",5148714,1048,25,1028,20,1023,0.485558141314511,0.388446513051609,0.0194552529182879
"United States","South Carolina","SC",2020-04-05,2020-04-11,7,2020,"15",5148714,1138,32,1020,118,1106,0.621514420882574,2.29183442700449,0.115686274509804
"United States","South Carolina","SC",2020-04-12,2020-04-18,7,2020,"16",5148714,1049,47,1008,41,1002,0.91284930567128,0.796315351755798,0.0406746031746033
"United States","South Carolina","SC",2020-04-19,2020-04-25,7,2020,"17",5148714,1023,47,989,34,976,0.91284930567128,0.660359072187735,0.0343781597573307
"United States","South Carolina","SC",2020-04-26,2020-05-02,7,2020,"18",5148714,1033,101,977,56,932,1.96165489091062,1.0876502365445,0.0573183213920163
"United States","South Carolina","SC",2020-05-03,2020-05-09,7,2020,"19",5148714,1060,62,961,99,998,1.20418419045999,1.92281023960546,0.103017689906348
"United States","South Carolina","SC",2020-05-10,2020-05-16,7,2020,"20",5148714,1110,51,961,149,1059,0.990538608281602,2.89392652223448,0.155046826222685
"United States","South Carolina","SC",2020-05-17,2020-05-23,7,2020,"21",5148714,1046,45,952,94,1001,0.874004654366119,1.82569861134256,0.0987394957983194
"United States","South Carolina","SC",2020-05-24,2020-05-30,7,2020,"22",5148714,1048,58,956,92,990,1.12649488784967,1.7868539600374,0.096234309623431
"United States","South Carolina","SC",2020-05-31,2020-06-06,7,2020,"23",5148714,1037,62,958,79,975,1.20418419045999,1.53436372655385,0.0824634655532359
"United States","South Carolina","SC",2020-06-07,2020-06-13,7,2020,"24",5148714,1079,53,953,126,1026,1.02938325958676,2.44721303222513,0.132214060860441
"United States","South Carolina","SC",2020-06-14,2020-06-20,7,2020,"25",5148714,1052,45,943,109,1007,0.874004654366119,2.11703349613127,0.11558854718982
"United States","South Carolina","SC",2020-06-21,2020-06-27,7,2020,"26",5148714,1099,64,944,155,1035,1.24302884176515,3.01046047614997,0.164194915254237
"United States","South Carolina","SC",2020-06-28,2020-07-04,7,2020,"27",5148714,1197,99,939,258,1098,1.92281023960546,5.01096001836575,0.274760383386581
"United States","South Carolina","SC",2020-07-05,2020-07-11,7,2020,"28",5148714,1218,134,940,278,1084,2.60259163744578,5.39940653141736,0.295744680851064
"United States","South Carolina","SC",2020-07-12,2020-07-18,7,2020,"29",5148714,1335,177,947,388,1158,3.43775164050674,7.53586235320121,0.409714889123548
"United States","South Carolina","SC",2020-07-19,2020-07-25,7,2020,"30",5148714,1352,295,952,400,1057,5.72958606751123,7.76893026103217,0.420168067226891
"United States","South Carolina","SC",2020-07-26,2020-08-01,7,2020,"31",5148714,1329,271,959,370,1058,5.2634502518493,7.18626049145476,0.385818561001043
"United States","South Carolina","SC",2020-08-02,2020-08-08,7,2020,"32",5148714,1368,233,945,423,1135,4.52540187705124,8.21564375104152,0.447619047619048
"United States","South Carolina","SC",2020-08-09,2020-08-15,7,2020,"33",5148714,1319,344,948,371,975,6.68128002448767,7.20568281710734,0.391350210970464
"United States","South Carolina","SC",2020-08-16,2020-08-22,7,2020,"34",5148714,1181,233,934,247,948,4.52540187705124,4.79731443618737,0.264453961456103
"United States","South Carolina","SC",2020-08-23,2020-08-29,7,2020,"35",5148714,1240,205,935,305,1035,3.98157675877899,5.92380932403703,0.32620320855615
"United States","South Carolina","SC",2020-08-30,2020-09-05,7,2020,"36",5148714,1243,179,939,304,1064,3.4765962918119,5.90438699838445,0.323748668796592
"United States","South Carolina","SC",2020-09-06,2020-09-12,7,2020,"37",5148714,1186,163,947,239,1023,3.16583908137061,4.64193583096672,0.252375923970433
"United States","South Carolina","SC",2020-09-13,2020-09-19,7,2020,"38",5148714,1142,148,954,188,994,2.8745041965819,3.65139722268512,0.19706498951782
"United States","South Carolina","SC",2020-09-20,2020-09-26,7,2020,"39",5148714,1152,135,954,198,1017,2.62201396309836,3.84562047921093,0.207547169811321
"United States","South Carolina","SC",2020-09-27,2020-10-03,7,2020,"40",5148714,1142,119,960,182,1023,2.31125675265707,3.53486326876964,0.189583333333333
"United States","South Carolina","SC",2020-10-04,2020-10-10,7,2020,"41",5148714,1133,109,953,180,1024,2.11703349613127,3.49601861746448,0.18887722980063
"United States","South Carolina","SC",2020-10-11,2020-10-17,7,2020,"42",5148714,1062,86,949,113,976,1.67032000612192,2.19472279874159,0.119072708113804
"United States","South Carolina","SC",2020-10-18,2020-10-24,7,2020,"43",5148714,1147,156,955,192,991,3.02988280180255,3.72908652529544,0.201047120418848
"United States","South Carolina","SC",2020-10-25,2020-10-31,7,2020,"44",5148714,1225,139,966,259,1086,2.69970326570868,5.03038234401833,0.268115942028986
"United States","South Carolina","SC",2020-11-01,2020-11-07,7,2020,"45",5148714,1185,83,973,212,1102,1.61205302916418,4.11753303834705,0.217882836587873
"United States","South Carolina","SC",2020-11-08,2020-11-14,7,2020,"46",5148714,1138,95,983,155,1043,1.84512093699514,3.01046047614997,0.157680569684639
"United States","South Carolina","SC",2020-11-15,2020-11-21,7,2020,"47",5148714,1192,90,989,203,1102,1.74800930873224,3.94273210747383,0.20525783619818
"United States","South Carolina","SC",2020-11-22,2020-11-28,7,2020,"48",5148714,1214,153,995,219,1061,2.97161582484481,4.25348931791511,0.220100502512563
"United States","South Carolina","SC",2020-11-29,2020-12-05,7,2020,"49",5148714,1287,164,1002,285,1123,3.18526140702319,5.53536281098542,0.284431137724551
"United States","South Carolina","SC",2020-12-06,2020-12-12,7,2020,"50",5148714,1281,168,1011,270,1113,3.26295070963351,5.24402792619672,0.267062314540059
"United States","South Carolina","SC",2020-12-13,2020-12-19,7,2020,"51",5148714,1367,210,1025,342,1157,4.07868838704189,6.64243537318251,0.333658536585366
"United States","South Carolina","SC",2020-12-20,2020-12-26,7,2020,"52",5148714,1420,229,1036,384,1191,4.44771257444092,7.45817305059089,0.370656370656371
"United States","South Carolina","SC",2020-12-27,2021-01-02,7,2020,"53",5148714,1511,260,1036,475,1251,5.04980466967091,9.22560468497571,0.458494208494209
"United States","South Carolina","SC",2021-01-03,2021-01-09,7,2021,"1",5148714,1589,374,1056,533,1215,7.26394979406508,10.3520995728254,0.504734848484848
"United States","South Carolina","SC",2021-01-10,2021-01-16,7,2021,"2",5148714,1641,350,1064,577,1291,6.79781397840315,11.2066819015389,0.542293233082707
"United States","South Carolina","SC",2021-01-17,2021-01-23,7,2021,"3",5148714,1699,371,1069,630,1328,7.20568281710734,12.2360651611257,0.58933582787652
"United States","South Carolina","SC",2021-01-24,2021-01-30,7,2021,"4",5148714,1581,535,1074,507,1046,10.3909442241305,9.84711910585828,0.472067039106145
"United States","South Carolina","SC",2021-01-31,2021-02-06,7,2021,"5",5148714,1501,597,1073,428,904,11.5951284145905,8.31275537930442,0.398881640260951
"United States","South Carolina","SC",2021-02-07,2021-02-13,7,2021,"6",5148714,1367,302,1035,332,1065,5.86554234707929,6.4482121166567,0.320772946859903
"United States","South Carolina","SC",2021-02-14,2021-02-20,7,2021,"7",5148714,1250,344,1024,226,906,6.68128002448767,4.38944559748318,0.220703125
"United States","South Carolina","SC",2021-02-21,2021-02-27,7,2021,"8",5148714,1238,241,1017,221,997,4.68078048227188,4.29233396922028,0.217305801376598
"United States","South Carolina","SC",2021-02-28,2021-03-06,7,2021,"9",5148714,1195,221,1013,182,974,4.29233396922028,3.53486326876964,0.179664363277394
"United States","South Carolina","SC",2021-03-07,2021-03-13,7,2021,"10",5148714,1166,152,998,168,1014,2.95219349919223,3.26295070963351,0.168336673346693
"United States","South Carolina","SC",2021-03-14,2021-03-20,7,2021,"11",5148714,1058,108,1006,52,950,2.09761117047869,1.00996093393418,0.0516898608349901
"United States","South Carolina","SC",2021-03-21,2021-03-27,7,2021,"12",5148714,1107,129,998,109,978,2.50548000918288,2.11703349613127,0.109218436873747
"United States","South Carolina","SC",2021-03-28,2021-04-03,7,2021,"13",5148714,1002,92,987,15,910,1.7868539600374,0.291334884788706,0.0151975683890577
"United States","South Carolina","SC",2021-04-04,2021-04-10,7,2021,"14",5148714,1134,73,971,163,1061,1.41782977263837,3.16583908137061,0.167868177136972
"United States","South Carolina","SC",2021-04-11,2021-04-17,7,2021,"15",5148714,1101,48,969,132,1053,0.932271631323861,2.56374698614062,0.136222910216718
"United States","South Carolina","SC",2021-04-18,2021-04-24,7,2021,"16",5148714,1069,93,959,110,976,1.80627628568998,2.13645582178385,0.114702815432743
"United States","South Carolina","SC",2021-04-25,2021-05-01,7,2021,"17",5148714,1155,92,955,200,1063,1.7868539600374,3.88446513051609,0.209424083769634
"United States","South Carolina","SC",2021-05-02,2021-05-08,7,2021,"18",5148714,1075,80,952,123,995,1.55378605220643,2.38894605526739,0.129201680672269
"United States","South Carolina","SC",2021-05-09,2021-05-15,7,2021,"19",5148714,1090,52,946,144,1038,1.00996093393418,2.79681489397158,0.152219873150106
"United States","South Carolina","SC",2021-05-16,2021-05-22,7,2021,"20",5148714,1027,36,948,79,991,0.699203723492896,1.53436372655385,0.0833333333333333
"United States","South Carolina","SC",2021-05-23,2021-05-29,7,2021,"21",5148714,1025,54,948,77,971,1.04880558523934,1.49551907524869,0.0812236286919832
"United States","South Carolina","SC",2021-05-30,2021-06-05,7,2021,"22",5148714,1035,24,941,94,1011,0.46613581566193,1.82569861134256,0.099893730074389
"United States","South Carolina","SC",2021-06-06,2021-06-12,7,2021,"23",5148714,1035,24,932,103,1011,0.46613581566193,2.00049954221578,0.110515021459227
"United States","South Carolina","SC",2021-06-13,2021-06-19,7,2021,"24",5148714,1081,16,932,149,1065,0.310757210441287,2.89392652223448,0.159871244635193
"United States","South Carolina","SC",2021-06-20,2021-06-26,7,2021,"25",5148714,1030,27,921,109,1003,0.524402792619672,2.11703349613127,0.118349619978285
"United States","South Carolina","SC",2021-06-27,2021-07-03,7,2021,"26",5148714,1026,11,911,115,1015,0.213645582178385,2.23356745004675,0.126234906695939
"United States","South Carolina","SC",2021-07-04,2021-07-10,7,2021,"27",5148714,1041,16,917,124,1025,0.310757210441287,2.40836838091997,0.135223555070883
"United States","South Carolina","SC",2021-07-11,2021-07-17,7,2021,"28",5148714,1029,16,911,118,1013,0.310757210441287,2.29183442700449,0.129527991218441
"United States","South Carolina","SC",2021-07-18,2021-07-24,7,2021,"29",5148714,1078,16,917,161,1062,0.310757210441287,3.12699443006545,0.175572519083969
"United States","South Carolina","SC",2021-07-25,2021-07-31,7,2021,"30",5148714,1109,26,930,179,1083,0.504980466967091,3.4765962918119,0.19247311827957
"United States","South Carolina","SC",2021-08-01,2021-08-07,7,2021,"31",5148714,1122,46,932,190,1076,0.8934269800187,3.69024187399028,0.203862660944206
"United States","South Carolina","SC",2021-08-08,2021-08-14,7,2021,"32",5148714,1238,89,926,312,1149,1.72858698307966,6.05976560360509,0.336933045356371
"United States","South Carolina","SC",2021-08-15,2021-08-21,7,2021,"33",5148714,1272,69,933,339,1203,1.34014047002805,6.58416839622477,0.363344051446945
"United States","South Dakota","SD",2019-12-29,2020-01-04,7,2020,"1",884659,170,0,166,4,170,0,0.452151620002736,0.0240963855421688
"United States","South Dakota","SD",2020-01-05,2020-01-11,7,2020,"2",884659,170,0,167,3,170,0,0.339113715002052,0.0179640718562875
"United States","South Dakota","SD",2020-01-12,2020-01-18,7,2020,"3",884659,168,0,170,-2,168,0,-0.226075810001368,-0.0117647058823529
"United States","South Dakota","SD",2020-01-19,2020-01-25,7,2020,"4",884659,151,0,168,-17,151,0,-1.92164438501163,-0.101190476190476
"United States","South Dakota","SD",2020-01-26,2020-02-01,7,2020,"5",884659,162,0,167,-5,162,0,-0.565189525003419,-0.0299401197604791
"United States","South Dakota","SD",2020-02-02,2020-02-08,7,2020,"6",884659,150,0,167,-17,150,0,-1.92164438501163,-0.101796407185629
"United States","South Dakota","SD",2020-02-09,2020-02-15,7,2020,"7",884659,178,0,163,15,178,0,1.69556857501026,0.0920245398773005
"United States","South Dakota","SD",2020-02-16,2020-02-22,7,2020,"8",884659,177,0,165,12,177,0,1.35645486000821,0.0727272727272728
"United States","South Dakota","SD",2020-02-23,2020-02-29,7,2020,"9",884659,163,0,162,1,163,0,0.113037905000684,0.00617283950617287
"United States","South Dakota","SD",2020-03-01,2020-03-07,7,2020,"10",884659,194,0,160,34,194,0,3.84328877002325,0.2125
"United States","South Dakota","SD",2020-03-08,2020-03-14,7,2020,"11",884659,166,1,160,6,165,0.113037905000684,0.678227430004103,0.0375000000000001
"United States","South Dakota","SD",2020-03-15,2020-03-21,7,2020,"12",884659,162,0,157,5,162,0,0.565189525003419,0.0318471337579618
"United States","South Dakota","SD",2020-03-22,2020-03-28,7,2020,"13",884659,149,0,156,-7,149,0,-0.791265335004787,-0.0448717948717948
"United States","South Dakota","SD",2020-03-29,2020-04-04,7,2020,"14",884659,170,1,159,11,169,0.113037905000684,1.24341695500752,0.0691823899371069
"United States","South Dakota","SD",2020-04-05,2020-04-11,7,2020,"15",884659,150,3,157,-7,147,0.339113715002052,-0.791265335004787,-0.0445859872611465
"United States","South Dakota","SD",2020-04-12,2020-04-18,7,2020,"16",884659,154,2,156,-2,152,0.226075810001368,-0.226075810001368,-0.0128205128205128
"United States","South Dakota","SD",2020-04-19,2020-04-25,7,2020,"17",884659,176,3,152,24,173,0.339113715002052,2.71290972001641,0.157894736842105
"United States","South Dakota","SD",2020-04-26,2020-05-02,7,2020,"18",884659,159,11,151,8,148,1.24341695500752,0.904303240005471,0.0529801324503312
"United States","South Dakota","SD",2020-05-03,2020-05-09,7,2020,"19",884659,181,13,146,35,168,1.46949276500889,3.95632667502394,0.23972602739726
"United States","South Dakota","SD",2020-05-10,2020-05-16,7,2020,"20",884659,147,10,145,2,137,1.13037905000684,0.226075810001368,0.0137931034482759
"United States","South Dakota","SD",2020-05-17,2020-05-23,7,2020,"21",884659,162,6,146,16,156,0.678227430004103,1.80860648001094,0.10958904109589
"United States","South Dakota","SD",2020-05-24,2020-05-30,7,2020,"22",884659,157,10,151,6,147,1.13037905000684,0.678227430004103,0.0397350993377483
"United States","South Dakota","SD",2020-05-31,2020-06-06,7,2020,"23",884659,147,5,146,1,142,0.565189525003419,0.113037905000684,0.00684931506849318
"United States","South Dakota","SD",2020-06-07,2020-06-13,7,2020,"24",884659,159,10,146,13,149,1.13037905000684,1.46949276500889,0.0890410958904109
"United States","South Dakota","SD",2020-06-14,2020-06-20,7,2020,"25",884659,176,6,147,29,170,0.678227430004103,3.27809924501983,0.197278911564626
"United States","South Dakota","SD",2020-06-21,2020-06-27,7,2020,"26",884659,163,10,145,18,153,1.13037905000684,2.03468229001231,0.124137931034483
"United States","South Dakota","SD",2020-06-28,2020-07-04,7,2020,"27",884659,160,6,148,12,154,0.678227430004103,1.35645486000821,0.0810810810810811
"United States","South Dakota","SD",2020-07-05,2020-07-11,7,2020,"28",884659,172,12,146,26,160,1.35645486000821,2.93898553001778,0.178082191780822
"United States","South Dakota","SD",2020-07-12,2020-07-18,7,2020,"29",884659,158,7,149,9,151,0.791265335004787,1.01734114500615,0.0604026845637584
"United States","South Dakota","SD",2020-07-19,2020-07-25,7,2020,"30",884659,173,6,144,29,167,0.678227430004103,3.27809924501983,0.201388888888889
"United States","South Dakota","SD",2020-07-26,2020-08-01,7,2020,"31",884659,151,12,143,8,139,1.35645486000821,0.904303240005471,0.055944055944056
"United States","South Dakota","SD",2020-08-02,2020-08-08,7,2020,"32",884659,187,12,140,47,175,1.35645486000821,5.31278153503214,0.335714285714286
"United States","South Dakota","SD",2020-08-09,2020-08-15,7,2020,"33",884659,162,6,144,18,156,0.678227430004103,2.03468229001231,0.125
"United States","South Dakota","SD",2020-08-16,2020-08-22,7,2020,"34",884659,169,7,141,28,162,0.791265335004787,3.16506134001915,0.198581560283688
"United States","South Dakota","SD",2020-08-23,2020-08-29,7,2020,"35",884659,189,8,138,51,181,0.904303240005471,5.76493315503488,0.369565217391304
"United States","South Dakota","SD",2020-08-30,2020-09-05,7,2020,"36",884659,209,6,137,72,203,0.678227430004103,8.13872916004924,0.525547445255474
"United States","South Dakota","SD",2020-09-06,2020-09-12,7,2020,"37",884659,182,10,140,42,172,1.13037905000684,4.74759201002872,0.3
"United States","South Dakota","SD",2020-09-13,2020-09-19,7,2020,"38",884659,181,17,140,41,164,1.92164438501163,4.63455410502804,0.292857142857143
"United States","South Dakota","SD",2020-09-20,2020-09-26,7,2020,"39",884659,191,18,145,46,173,2.03468229001231,5.19974363003146,0.317241379310345
"United States","South Dakota","SD",2020-09-27,2020-10-03,7,2020,"40",884659,206,30,151,55,176,3.39113715002052,6.21708477503761,0.364238410596027
"United States","South Dakota","SD",2020-10-04,2020-10-10,7,2020,"41",884659,215,38,152,63,177,4.29544039002599,7.12138801504308,0.414473684210526
"United States","South Dakota","SD",2020-10-11,2020-10-17,7,2020,"42",884659,201,29,158,43,172,3.27809924501983,4.86062991502941,0.272151898734177
"United States","South Dakota","SD",2020-10-18,2020-10-24,7,2020,"43",884659,243,51,158,85,192,5.76493315503488,9.60822192505813,0.537974683544304
"United States","South Dakota","SD",2020-10-25,2020-10-31,7,2020,"44",884659,243,59,157,86,184,6.66923639504035,9.72125983005881,0.547770700636943
"United States","South Dakota","SD",2020-11-01,2020-11-07,7,2020,"45",884659,356,98,150,206,258,11.077714690067,23.2858084301409,1.37333333333333
"United States","South Dakota","SD",2020-11-08,2020-11-14,7,2020,"46",884659,343,98,152,191,245,11.077714690067,21.5902398551306,1.25657894736842
"United States","South Dakota","SD",2020-11-15,2020-11-21,7,2020,"47",884659,335,120,151,184,215,13.5645486000821,20.7989745201258,1.21854304635762
"United States","South Dakota","SD",2020-11-22,2020-11-28,7,2020,"48",884659,335,201,151,184,134,22.7206189051375,20.7989745201258,1.21854304635762
"United States","South Dakota","SD",2020-11-29,2020-12-05,7,2020,"49",884659,305,148,155,150,157,16.7296099401012,16.9556857501026,0.967741935483871
"United States","South Dakota","SD",2020-12-06,2020-12-12,7,2020,"50",884659,283,153,154,129,130,17.2947994651046,14.5818897450882,0.837662337662338
"United States","South Dakota","SD",2020-12-13,2020-12-19,7,2020,"51",884659,236,107,153,83,129,12.0950558350732,9.38214611505676,0.542483660130719
"United States","South Dakota","SD",2020-12-20,2020-12-26,7,2020,"52",884659,206,31,155,51,175,3.5041750550212,5.76493315503488,0.329032258064516
"United States","South Dakota","SD",2020-12-27,2021-01-02,7,2020,"53",884659,211,120,159,52,91,13.5645486000821,5.87797106003556,0.327044025157233
"United States","South Dakota","SD",2021-01-03,2021-01-09,7,2021,"1",884659,219,69,161,58,150,7.79961544504719,6.55619849003967,0.360248447204969
"United States","South Dakota","SD",2021-01-10,2021-01-16,7,2021,"2",884659,188,63,167,21,125,7.12138801504308,2.37379600501436,0.125748502994012
"United States","South Dakota","SD",2021-01-17,2021-01-23,7,2021,"3",884659,190,63,169,21,127,7.12138801504308,2.37379600501436,0.124260355029586
"United States","South Dakota","SD",2021-01-24,2021-01-30,7,2021,"4",884659,204,79,170,34,125,8.92999449505403,3.84328877002325,0.2
"United States","South Dakota","SD",2021-01-31,2021-02-06,7,2021,"5",884659,189,29,172,17,160,3.27809924501983,1.92164438501163,0.0988372093023255
"United States","South Dakota","SD",2021-02-07,2021-02-13,7,2021,"6",884659,180,34,173,7,146,3.84328877002325,0.791265335004787,0.0404624277456647
"United States","South Dakota","SD",2021-02-14,2021-02-20,7,2021,"7",884659,167,21,171,-4,146,2.37379600501436,-0.452151620002736,-0.0233918128654971
"United States","South Dakota","SD",2021-02-21,2021-02-27,7,2021,"8",884659,180,29,175,5,151,3.27809924501983,0.565189525003419,0.0285714285714285
"United States","South Dakota","SD",2021-02-28,2021-03-06,7,2021,"9",884659,168,8,173,-5,160,0.904303240005471,-0.565189525003419,-0.0289017341040463
"United States","South Dakota","SD",2021-03-07,2021-03-13,7,2021,"10",884659,185,12,173,12,173,1.35645486000821,1.35645486000821,0.0693641618497109
"United States","South Dakota","SD",2021-03-14,2021-03-20,7,2021,"11",884659,157,11,174,-17,146,1.24341695500752,-1.92164438501163,-0.0977011494252874
"United States","South Dakota","SD",2021-03-21,2021-03-27,7,2021,"12",884659,170,14,170,0,156,1.58253067000957,0,0
"United States","South Dakota","SD",2021-03-28,2021-04-03,7,2021,"13",884659,155,14,166,-11,141,1.58253067000957,-1.24341695500752,-0.0662650602409639
"United States","South Dakota","SD",2021-04-04,2021-04-10,7,2021,"14",884659,144,-1,164,-20,145,-0.113037905000684,-2.26075810001368,-0.121951219512195
"United States","South Dakota","SD",2021-04-11,2021-04-17,7,2021,"15",884659,176,7,168,8,169,0.791265335004787,0.904303240005471,0.0476190476190477
"United States","South Dakota","SD",2021-04-18,2021-04-24,7,2021,"16",884659,172,0,170,2,172,0,0.226075810001368,0.0117647058823529
"United States","South Dakota","SD",2021-04-25,2021-05-01,7,2021,"17",884659,160,14,168,-8,146,1.58253067000957,-0.904303240005471,-0.0476190476190477
"United States","South Dakota","SD",2021-05-02,2021-05-08,7,2021,"18",884659,180,12,166,14,168,1.35645486000821,1.58253067000957,0.0843373493975903
"United States","South Dakota","SD",2021-05-09,2021-05-15,7,2021,"19",884659,164,12,166,-2,152,1.35645486000821,-0.226075810001368,-0.0120481927710844
"United States","South Dakota","SD",2021-05-16,2021-05-22,7,2021,"20",884659,158,10,164,-6,148,1.13037905000684,-0.678227430004103,-0.0365853658536586
"United States","South Dakota","SD",2021-05-23,2021-05-29,7,2021,"21",884659,139,9,164,-25,130,1.01734114500615,-2.8259476250171,-0.152439024390244
"United States","South Dakota","SD",2021-05-30,2021-06-05,7,2021,"22",884659,154,12,169,-15,142,1.35645486000821,-1.69556857501026,-0.0887573964497042
"United States","South Dakota","SD",2021-06-06,2021-06-12,7,2021,"23",884659,165,4,166,-1,161,0.452151620002736,-0.113037905000684,-0.00602409638554213
"United States","South Dakota","SD",2021-06-13,2021-06-19,7,2021,"24",884659,147,1,165,-18,146,0.113037905000684,-2.03468229001231,-0.109090909090909
"United States","South Dakota","SD",2021-06-20,2021-06-26,7,2021,"25",884659,153,3,168,-15,150,0.339113715002052,-1.69556857501026,-0.0892857142857143
"United States","South Dakota","SD",2021-06-27,2021-07-03,7,2021,"26",884659,172,8,162,10,164,0.904303240005471,1.13037905000684,0.0617283950617284
"United States","South Dakota","SD",2021-07-04,2021-07-10,7,2021,"27",884659,155,1,161,-6,154,0.113037905000684,-0.678227430004103,-0.0372670807453416
"United States","South Dakota","SD",2021-07-11,2021-07-17,7,2021,"28",884659,162,1,162,0,161,0.113037905000684,0,0
"United States","South Dakota","SD",2021-07-18,2021-07-24,7,2021,"29",884659,163,1,164,-1,162,0.113037905000684,-0.113037905000684,-0.00609756097560976
"United States","South Dakota","SD",2021-07-25,2021-07-31,7,2021,"30",884659,162,2,165,-3,160,0.226075810001368,-0.339113715002052,-0.0181818181818182
"United States","South Dakota","SD",2021-08-01,2021-08-07,7,2021,"31",884659,154,7,169,-15,147,0.791265335004787,-1.69556857501026,-0.0887573964497042
"United States","South Dakota","SD",2021-08-08,2021-08-14,7,2021,"32",884659,152,1,165,-13,151,0.113037905000684,-1.46949276500889,-0.0787878787878787
"United States","South Dakota","SD",2021-08-15,2021-08-21,7,2021,"33",884659,172,0,165,7,172,0,0.791265335004787,0.0424242424242425
"United States","Tennessee","TN",2019-12-29,2020-01-04,7,2020,"1",6833174,1614,0,1653,-39,1614,0,-0.57074501542036,-0.0235934664246824
"United States","Tennessee","TN",2020-01-05,2020-01-11,7,2020,"2",6833174,1687,0,1685,2,1687,0,0.029268975149762,0.00118694362017813
"United States","Tennessee","TN",2020-01-12,2020-01-18,7,2020,"3",6833174,1597,0,1678,-81,1597,0,-1.18539349356536,-0.0482717520858165
"United States","Tennessee","TN",2020-01-19,2020-01-25,7,2020,"4",6833174,1532,0,1648,-116,1532,0,-1.6976005586862,-0.0703883495145631
"United States","Tennessee","TN",2020-01-26,2020-02-01,7,2020,"5",6833174,1591,0,1637,-46,1591,0,-0.673186428444527,-0.0281001832620648
"United States","Tennessee","TN",2020-02-02,2020-02-08,7,2020,"6",6833174,1612,0,1604,8,1612,0,0.117075900599048,0.00498753117206974
"United States","Tennessee","TN",2020-02-09,2020-02-15,7,2020,"7",6833174,1454,0,1584,-130,1454,0,-1.90248338473453,-0.0820707070707071
"United States","Tennessee","TN",2020-02-16,2020-02-22,7,2020,"8",6833174,1516,0,1563,-47,1516,0,-0.687820916019408,-0.0300703774792066
"United States","Tennessee","TN",2020-02-23,2020-02-29,7,2020,"9",6833174,1504,0,1555,-51,1504,0,-0.746358866318932,-0.0327974276527331
"United States","Tennessee","TN",2020-03-01,2020-03-07,7,2020,"10",6833174,1611,0,1541,70,1611,0,1.02441413024167,0.045425048669695
"United States","Tennessee","TN",2020-03-08,2020-03-14,7,2020,"11",6833174,1601,0,1536,65,1601,0,0.951241692367266,0.0423177083333333
"United States","Tennessee","TN",2020-03-15,2020-03-21,7,2020,"12",6833174,1526,1,1546,-20,1525,0.014634487574881,-0.29268975149762,-0.0129366106080206
"United States","Tennessee","TN",2020-03-22,2020-03-28,7,2020,"13",6833174,1528,5,1533,-5,1523,0.0731724378744051,-0.0731724378744051,-0.00326157860404441
"United States","Tennessee","TN",2020-03-29,2020-04-04,7,2020,"14",6833174,1593,37,1510,83,1556,0.541476040270597,1.21466246871512,0.0549668874172184
"United States","Tennessee","TN",2020-04-05,2020-04-11,7,2020,"15",6833174,1514,58,1512,2,1456,0.848800279343099,0.029268975149762,0.00132275132275139
"United States","Tennessee","TN",2020-04-12,2020-04-18,7,2020,"16",6833174,1541,44,1509,32,1497,0.643917453294765,0.468303602396192,0.0212060967528165
"United States","Tennessee","TN",2020-04-19,2020-04-25,7,2020,"17",6833174,1483,33,1486,-3,1450,0.482938089971073,-0.043903462724643,-0.00201884253028262
"United States","Tennessee","TN",2020-04-26,2020-05-02,7,2020,"18",6833174,1495,31,1456,39,1464,0.453669114821311,0.57074501542036,0.0267857142857142
"United States","Tennessee","TN",2020-05-03,2020-05-09,7,2020,"19",6833174,1492,33,1450,42,1459,0.482938089971073,0.614648478145003,0.0289655172413794
"United States","Tennessee","TN",2020-05-10,2020-05-16,7,2020,"20",6833174,1544,53,1428,116,1491,0.775627841468694,1.6976005586862,0.0812324929971988
"United States","Tennessee","TN",2020-05-17,2020-05-23,7,2020,"21",6833174,1557,30,1424,133,1527,0.43903462724643,1.94638684745917,0.0933988764044944
"United States","Tennessee","TN",2020-05-24,2020-05-30,7,2020,"22",6833174,1467,39,1429,38,1428,0.57074501542036,0.556110527845479,0.0265920223932821
"United States","Tennessee","TN",2020-05-31,2020-06-06,7,2020,"23",6833174,1485,49,1420,65,1436,0.71708989116917,0.951241692367266,0.045774647887324
"United States","Tennessee","TN",2020-06-07,2020-06-13,7,2020,"24",6833174,1500,52,1410,90,1448,0.760993353893813,1.31710388173929,0.0638297872340425
"United States","Tennessee","TN",2020-06-14,2020-06-20,7,2020,"25",6833174,1570,51,1412,158,1519,0.746358866318932,2.3122490368312,0.111898016997167
"United States","Tennessee","TN",2020-06-21,2020-06-27,7,2020,"26",6833174,1562,61,1420,142,1501,0.892703742067742,2.0780972356331,0.1
"United States","Tennessee","TN",2020-06-28,2020-07-04,7,2020,"27",6833174,1533,52,1402,131,1481,0.760993353893813,1.91711787230941,0.093437945791726
"United States","Tennessee","TN",2020-07-05,2020-07-11,7,2020,"28",6833174,1634,99,1406,228,1535,1.44881426991322,3.33666316707287,0.162162162162162
"United States","Tennessee","TN",2020-07-12,2020-07-18,7,2020,"29",6833174,1650,100,1419,231,1550,1.4634487574881,3.38056662979751,0.162790697674419
"United States","Tennessee","TN",2020-07-19,2020-07-25,7,2020,"30",6833174,1710,136,1417,293,1574,1.99029031018382,4.28790485944014,0.206774876499647
"United States","Tennessee","TN",2020-07-26,2020-08-01,7,2020,"31",6833174,1713,103,1411,302,1610,1.50735222021274,4.41961524761407,0.214032600992204
"United States","Tennessee","TN",2020-08-02,2020-08-08,7,2020,"32",6833174,1707,148,1411,296,1559,2.16590416108239,4.33180832216478,0.209780297661233
"United States","Tennessee","TN",2020-08-09,2020-08-15,7,2020,"33",6833174,1678,130,1402,276,1548,1.90248338473453,4.03911857066716,0.196861626248217
"United States","Tennessee","TN",2020-08-16,2020-08-22,7,2020,"34",6833174,1687,218,1389,298,1469,3.19031829132406,4.36107729731454,0.214542836573074
"United States","Tennessee","TN",2020-08-23,2020-08-29,7,2020,"35",6833174,1709,162,1395,314,1547,2.37078698713072,4.59522909851264,0.225089605734767
"United States","Tennessee","TN",2020-08-30,2020-09-05,7,2020,"36",6833174,1624,137,1410,214,1487,2.0049247977587,3.13178034102454,0.15177304964539
"United States","Tennessee","TN",2020-09-06,2020-09-12,7,2020,"37",6833174,1727,202,1394,333,1525,2.95616649012596,4.87328436243538,0.238880918220947
"United States","Tennessee","TN",2020-09-13,2020-09-19,7,2020,"38",6833174,1620,152,1402,218,1468,2.22444211138191,3.19031829132406,0.15549215406562
"United States","Tennessee","TN",2020-09-20,2020-09-26,7,2020,"39",6833174,1743,158,1416,327,1585,2.3122490368312,4.78547743698609,0.23093220338983
"United States","Tennessee","TN",2020-09-27,2020-10-03,7,2020,"40",6833174,1732,186,1397,335,1546,2.72201468892787,4.90255333758514,0.239799570508232
"United States","Tennessee","TN",2020-10-04,2020-10-10,7,2020,"41",6833174,1769,198,1397,372,1571,2.89762853982644,5.44402937785574,0.266284896206156
"United States","Tennessee","TN",2020-10-11,2020-10-17,7,2020,"42",6833174,1784,145,1403,381,1639,2.12200069835775,5.57573976602967,0.271560940841055
"United States","Tennessee","TN",2020-10-18,2020-10-24,7,2020,"43",6833174,1788,197,1410,378,1591,2.88299405225156,5.53183630330502,0.268085106382979
"United States","Tennessee","TN",2020-10-25,2020-10-31,7,2020,"44",6833174,1841,251,1406,435,1590,3.67325638129513,6.36600209507324,0.309388335704125
"United States","Tennessee","TN",2020-11-01,2020-11-07,7,2020,"45",6833174,1815,236,1435,380,1579,3.45373906767192,5.56110527845479,0.264808362369338
"United States","Tennessee","TN",2020-11-08,2020-11-14,7,2020,"46",6833174,1935,290,1440,495,1645,4.24400139671549,7.2440713495661,0.34375
"United States","Tennessee","TN",2020-11-15,2020-11-21,7,2020,"47",6833174,2001,324,1453,548,1677,4.74157397426145,8.0196991910348,0.377150722642808
"United States","Tennessee","TN",2020-11-22,2020-11-28,7,2020,"48",6833174,1919,333,1480,439,1586,4.87328436243538,6.42454004537277,0.296621621621622
"United States","Tennessee","TN",2020-11-29,2020-12-05,7,2020,"49",6833174,2200,365,1504,696,1835,5.34158796483157,10.1856033521172,0.462765957446809
"United States","Tennessee","TN",2020-12-06,2020-12-12,7,2020,"50",6833174,2188,499,1508,680,1689,7.30260929986563,9.95145155091909,0.450928381962865
"United States","Tennessee","TN",2020-12-13,2020-12-19,7,2020,"51",6833174,2174,562,1535,639,1612,8.22458201708313,9.35143756034897,0.41628664495114
"United States","Tennessee","TN",2020-12-20,2020-12-26,7,2020,"52",6833174,2361,481,1554,807,1880,7.03918852351777,11.810031472929,0.519305019305019
"United States","Tennessee","TN",2020-12-27,2021-01-02,7,2020,"53",6833174,2365,529,1553,812,1836,7.74164392711206,11.8832039108034,0.522858982614295
"United States","Tennessee","TN",2021-01-03,2021-01-09,7,2021,"1",6833174,2428,734,1576,852,1694,10.7417138799627,12.4685834137986,0.540609137055837
"United States","Tennessee","TN",2021-01-10,2021-01-16,7,2021,"2",6833174,2306,651,1584,722,1655,9.52705141124754,10.5661000290641,0.455808080808081
"United States","Tennessee","TN",2021-01-17,2021-01-23,7,2021,"3",6833174,2286,463,1578,708,1823,6.77576774716991,10.3612172030158,0.448669201520913
"United States","Tennessee","TN",2021-01-24,2021-01-30,7,2021,"4",6833174,2080,756,1584,496,1324,11.06367260661,7.25870583714098,0.313131313131313
"United States","Tennessee","TN",2021-01-31,2021-02-06,7,2021,"5",6833174,1951,889,1598,353,1062,13.0100594540692,5.165974113933,0.22090112640801
"United States","Tennessee","TN",2021-02-07,2021-02-13,7,2021,"6",6833174,1773,468,1581,192,1305,6.84894018504431,2.80982161437715,0.121442125237192
"United States","Tennessee","TN",2021-02-14,2021-02-20,7,2021,"7",6833174,1793,199,1557,236,1594,2.91226302740132,3.45373906767192,0.151573538856776
"United States","Tennessee","TN",2021-02-21,2021-02-27,7,2021,"8",6833174,1752,274,1535,217,1478,4.0098495955174,3.17568380374918,0.141368078175896
"United States","Tennessee","TN",2021-02-28,2021-03-06,7,2021,"9",6833174,1662,146,1526,136,1516,2.13663518593263,1.99029031018382,0.089121887287025
"United States","Tennessee","TN",2021-03-07,2021-03-13,7,2021,"10",6833174,1599,96,1516,83,1503,1.40491080718858,1.21466246871512,0.0547493403693931
"United States","Tennessee","TN",2021-03-14,2021-03-20,7,2021,"11",6833174,1580,73,1517,63,1507,1.06831759296631,0.921972717217504,0.0415293342122611
"United States","Tennessee","TN",2021-03-21,2021-03-27,7,2021,"12",6833174,1657,102,1516,141,1555,1.49271773263786,2.06346274805822,0.0930079155672823
"United States","Tennessee","TN",2021-03-28,2021-04-03,7,2021,"13",6833174,1572,94,1518,54,1478,1.37564183203882,0.790262329043575,0.0355731225296443
"United States","Tennessee","TN",2021-04-04,2021-04-10,7,2021,"14",6833174,1697,86,1502,195,1611,1.25856593143977,2.8537250771018,0.12982689747004
"United States","Tennessee","TN",2021-04-11,2021-04-17,7,2021,"15",6833174,1621,65,1508,113,1556,0.951241692367266,1.65369709596155,0.0749336870026525
"United States","Tennessee","TN",2021-04-18,2021-04-24,7,2021,"16",6833174,1675,80,1484,191,1595,1.17075900599048,2.79518712680227,0.128706199460916
"United States","Tennessee","TN",2021-04-25,2021-05-01,7,2021,"17",6833174,1650,58,1466,184,1592,0.848800279343099,2.69274571377811,0.125511596180082
"United States","Tennessee","TN",2021-05-02,2021-05-08,7,2021,"18",6833174,1647,53,1461,186,1594,0.775627841468694,2.72201468892787,0.127310061601643
"United States","Tennessee","TN",2021-05-09,2021-05-15,7,2021,"19",6833174,1641,55,1460,181,1586,0.804896816618456,2.64884225105346,0.123972602739726
"United States","Tennessee","TN",2021-05-16,2021-05-22,7,2021,"20",6833174,1567,68,1454,113,1499,0.995145155091909,1.65369709596155,0.077716643741403
"United States","Tennessee","TN",2021-05-23,2021-05-29,7,2021,"21",6833174,1541,61,1447,94,1480,0.892703742067742,1.37564183203882,0.06496199032481
"United States","Tennessee","TN",2021-05-30,2021-06-05,7,2021,"22",6833174,1552,35,1429,123,1517,0.512207065120835,1.80004197171036,0.086074177746676
"United States","Tennessee","TN",2021-06-06,2021-06-12,7,2021,"23",6833174,1656,22,1427,229,1634,0.321958726647382,3.35129765464775,0.160476524176594
"United States","Tennessee","TN",2021-06-13,2021-06-19,7,2021,"24",6833174,1569,18,1421,148,1551,0.263420776347858,2.16590416108239,0.104152005629838
"United States","Tennessee","TN",2021-06-20,2021-06-26,7,2021,"25",6833174,1541,34,1412,129,1507,0.497572577545954,1.88784889715965,0.0913597733711049
"United States","Tennessee","TN",2021-06-27,2021-07-03,7,2021,"26",6833174,1506,21,1407,99,1485,0.307324239072501,1.44881426991322,0.0703624733475481
"United States","Tennessee","TN",2021-07-04,2021-07-10,7,2021,"27",6833174,1450,25,1414,36,1425,0.365862189372025,0.526841552695717,0.0254596888260255
"United States","Tennessee","TN",2021-07-11,2021-07-17,7,2021,"28",6833174,1505,32,1407,98,1473,0.468303602396192,1.43417978233834,0.0696517412935322
"United States","Tennessee","TN",2021-07-18,2021-07-24,7,2021,"29",6833174,1532,45,1417,115,1487,0.658551940869646,1.68296607111132,0.0811573747353564
"United States","Tennessee","TN",2021-07-25,2021-07-31,7,2021,"30",6833174,1577,59,1419,158,1518,0.86343476691798,2.3122490368312,0.111346018322763
"United States","Tennessee","TN",2021-08-01,2021-08-07,7,2021,"31",6833174,1684,95,1404,280,1589,1.3902763196137,4.09765652096668,0.199430199430199
"United States","Tennessee","TN",2021-08-08,2021-08-14,7,2021,"32",6833174,1732,114,1400,332,1618,1.66833158353644,4.8586498748605,0.237142857142857
"United States","Tennessee","TN",2021-08-15,2021-08-21,7,2021,"33",6833174,1722,45,1401,321,1677,0.658551940869646,4.69767051153681,0.229122055674518
"United States","Texas","TX",2019-12-29,2020-01-04,7,2020,"1",28995881,4325,0,4589,-264,4325,0,-0.910474146310643,-0.057528873392896
"United States","Texas","TX",2020-01-05,2020-01-11,7,2020,"2",28995881,4564,0,4547,17,4564,0,0.0586290169972763,0.00373872883219706
"United States","Texas","TX",2020-01-12,2020-01-18,7,2020,"3",28995881,4250,0,4556,-306,4250,0,-1.05532230595097,-0.0671641791044776
"United States","Texas","TX",2020-01-19,2020-01-25,7,2020,"4",28995881,4128,0,4569,-441,4128,0,-1.52090567622346,-0.0965200262639527
"United States","Texas","TX",2020-01-26,2020-02-01,7,2020,"5",28995881,4174,0,4543,-369,4174,0,-1.27259454541147,-0.0812238608848779
"United States","Texas","TX",2020-02-02,2020-02-08,7,2020,"6",28995881,4322,0,4468,-146,4322,0,-0.503519793035431,-0.0326768128916741
"United States","Texas","TX",2020-02-09,2020-02-15,7,2020,"7",28995881,4343,0,4443,-100,4343,0,-0.344876570572213,-0.0225073148773351
"United States","Texas","TX",2020-02-16,2020-02-22,7,2020,"8",28995881,4221,0,4406,-185,4221,0,-0.638021655558595,-0.0419881979119383
"United States","Texas","TX",2020-02-23,2020-02-29,7,2020,"9",28995881,4146,0,4336,-190,4146,0,-0.655265484087205,-0.0438191881918819
"United States","Texas","TX",2020-03-01,2020-03-07,7,2020,"10",28995881,4173,0,4279,-106,4173,0,-0.365569164806546,-0.024772143024071
"United States","Texas","TX",2020-03-08,2020-03-14,7,2020,"11",28995881,4169,0,4231,-62,4169,0,-0.213823473754772,-0.0146537461593004
"United States","Texas","TX",2020-03-15,2020-03-21,7,2020,"12",28995881,4256,5,4144,112,4251,0.0172438285286107,0.386261759040879,0.027027027027027
"United States","Texas","TX",2020-03-22,2020-03-28,7,2020,"13",28995881,4259,25,4102,157,4234,0.0862191426430533,0.541456215798375,0.0382740126767431
"United States","Texas","TX",2020-03-29,2020-04-04,7,2020,"14",28995881,4186,77,4057,129,4109,0.265554959340604,0.444890776038155,0.0317968942568401
"United States","Texas","TX",2020-04-05,2020-04-11,7,2020,"15",28995881,4266,147,4018,248,4119,0.506968558741154,0.855293895019089,0.0617222498755601
"United States","Texas","TX",2020-04-12,2020-04-18,7,2020,"16",28995881,4294,199,4017,277,4095,0.686304375438704,0.955308100485031,0.0689569330346029
"United States","Texas","TX",2020-04-19,2020-04-25,7,2020,"17",28995881,4464,169,3969,495,4295,0.582841404267041,1.70713902433246,0.124716553287982
"United States","Texas","TX",2020-04-26,2020-05-02,7,2020,"18",28995881,4263,224,3961,302,4039,0.772523518081758,1.04152724312808,0.0762433728856349
"United States","Texas","TX",2020-05-03,2020-05-09,7,2020,"19",28995881,4278,202,3959,319,4076,0.696650672555871,1.10015626012536,0.0805759030058095
"United States","Texas","TX",2020-05-10,2020-05-16,7,2020,"20",28995881,4280,256,3945,335,4024,0.882884020664866,1.15533651141691,0.084917617237009
"United States","Texas","TX",2020-05-17,2020-05-23,7,2020,"21",28995881,4255,199,3904,351,4056,0.686304375438704,1.21051676270847,0.0899077868852458
"United States","Texas","TX",2020-05-24,2020-05-30,7,2020,"22",28995881,4156,142,3876,280,4014,0.489724730212543,0.965654397602197,0.0722394220846234
"United States","Texas","TX",2020-05-31,2020-06-06,7,2020,"23",28995881,4229,169,3874,355,4060,0.582841404267041,1.22431182553136,0.091636551368095
"United States","Texas","TX",2020-06-07,2020-06-13,7,2020,"24",28995881,4396,141,3879,517,4255,0.486275964506821,1.78301186985834,0.133281773653003
"United States","Texas","TX",2020-06-14,2020-06-20,7,2020,"25",28995881,4509,207,3852,657,4302,0.713894501084482,2.26583906865944,0.170560747663551
"United States","Texas","TX",2020-06-21,2020-06-27,7,2020,"26",28995881,4566,204,3855,711,4362,0.703548203967315,2.45207241676844,0.18443579766537
"United States","Texas","TX",2020-06-28,2020-07-04,7,2020,"27",28995881,5036,242,3820,1216,4794,0.834601300784756,4.19369909815811,0.318324607329843
"United States","Texas","TX",2020-07-05,2020-07-11,7,2020,"28",28995881,5772,504,3810,1962,5268,1.73817791568396,6.76647831462683,0.51496062992126
"United States","Texas","TX",2020-07-12,2020-07-18,7,2020,"29",28995881,6264,753,3818,2446,5511,2.59692057640877,8.43568091619634,0.640649554740702
"United States","Texas","TX",2020-07-19,2020-07-25,7,2020,"30",28995881,6310,1020,3834,2476,5290,3.51774101983658,8.539143887368,0.645800730307773
"United States","Texas","TX",2020-07-26,2020-08-01,7,2020,"31",28995881,5953,1950,3837,2116,4003,6.72509312615816,7.29758823330804,0.551472504560855
"United States","Texas","TX",2020-08-02,2020-08-08,7,2020,"32",28995881,5712,1506,3849,1863,4206,5.19384115281753,6.42505050976033,0.484021823850351
"United States","Texas","TX",2020-08-09,2020-08-15,7,2020,"33",28995881,5782,1498,3864,1918,4284,5.16625102717176,6.61473262357505,0.496376811594203
"United States","Texas","TX",2020-08-16,2020-08-22,7,2020,"34",28995881,5033,1423,3847,1186,3610,4.9075935992426,4.09023612698645,0.308292175721341
"United States","Texas","TX",2020-08-23,2020-08-29,7,2020,"35",28995881,5137,1154,3855,1282,3983,3.97987562440334,4.42131763473578,0.332555123216602
"United States","Texas","TX",2020-08-30,2020-09-05,7,2020,"36",28995881,4942,987,3869,1073,3955,3.40393175154775,3.70052560223985,0.277332644094081
"United States","Texas","TX",2020-09-06,2020-09-12,7,2020,"37",28995881,4654,735,3858,796,3919,2.53484279370577,2.74521750175482,0.206324520476931
"United States","Texas","TX",2020-09-13,2020-09-19,7,2020,"38",28995881,4601,705,3854,747,3896,2.4313798225341,2.57622798217443,0.193824597820446
"United States","Texas","TX",2020-09-20,2020-09-26,7,2020,"39",28995881,4544,634,3879,665,3910,2.18651745742783,2.29342919430522,0.17143593709719
"United States","Texas","TX",2020-09-27,2020-10-03,7,2020,"40",28995881,4589,507,3887,702,4082,1.74852421280112,2.42103352541694,0.180602006688963
"United States","Texas","TX",2020-10-04,2020-10-10,7,2020,"41",28995881,4720,534,3884,836,4186,1.84164088685562,2.8831681299837,0.21524201853759
"United States","Texas","TX",2020-10-11,2020-10-17,7,2020,"42",28995881,4535,457,3919,616,4078,1.57608592751501,2.12443967472483,0.157182954835417
"United States","Texas","TX",2020-10-18,2020-10-24,7,2020,"43",28995881,4813,472,3950,863,4341,1.62781741310085,2.9762848040382,0.218481012658228
"United States","Texas","TX",2020-10-25,2020-10-31,7,2020,"44",28995881,5165,566,3978,1187,4599,1.95200138943873,4.09368489269217,0.298391151332328
"United States","Texas","TX",2020-11-01,2020-11-07,7,2020,"45",28995881,5402,674,3993,1409,4728,2.32446808565672,4.85931087936249,0.352867518156774
"United States","Texas","TX",2020-11-08,2020-11-14,7,2020,"46",28995881,5444,767,4006,1438,4677,2.64520329628888,4.95932508482843,0.358961557663505
"United States","Texas","TX",2020-11-15,2020-11-21,7,2020,"47",28995881,5431,827,4044,1387,4604,2.8521292386322,4.7834380338366,0.34297725024728
"United States","Texas","TX",2020-11-22,2020-11-28,7,2020,"48",28995881,5595,1013,4052,1543,4582,3.49359965989652,5.32144548392925,0.380799605133268
"United States","Texas","TX",2020-11-29,2020-12-05,7,2020,"49",28995881,5636,1194,4096,1540,4442,4.11782625263223,5.31109918681209,0.3759765625
"United States","Texas","TX",2020-12-06,2020-12-12,7,2020,"50",28995881,6057,1297,4134,1923,4760,4.47304912032161,6.63197645210366,0.465166908563135
"United States","Texas","TX",2020-12-13,2020-12-19,7,2020,"51",28995881,6185,861,4204,1981,5324,2.96938727262676,6.83200486303555,0.471217887725975
"United States","Texas","TX",2020-12-20,2020-12-26,7,2020,"52",28995881,6134,1775,4281,1853,4359,6.12155912765679,6.39056285270311,0.432842793739781
"United States","Texas","TX",2020-12-27,2021-01-02,7,2020,"53",28995881,6544,1431,4336,2208,5113,4.93518372488837,7.61487467823447,0.509225092250922
"United States","Texas","TX",2021-01-03,2021-01-09,7,2021,"1",28995881,6969,1825,4343,2626,5144,6.29399741294289,9.05645874322632,0.604651162790698
"United States","Texas","TX",2021-01-10,2021-01-16,7,2021,"2",28995881,7203,2140,4359,2844,5063,7.38035861024536,9.80828966707375,0.65244322092223
"United States","Texas","TX",2021-01-17,2021-01-23,7,2021,"3",28995881,6993,2282,4343,2650,4711,7.87008334045791,9.13922912016365,0.610177296799447
"United States","Texas","TX",2021-01-24,2021-01-30,7,2021,"4",28995881,6636,2204,4334,2302,4432,7.60107961541158,7.93905865457235,0.531149053991694
"United States","Texas","TX",2021-01-31,2021-02-06,7,2021,"5",28995881,6241,2156,4328,1913,4085,7.43553886153692,6.59748879504644,0.442005545286506
"United States","Texas","TX",2021-02-07,2021-02-13,7,2021,"6",28995881,5891,1902,4279,1612,3989,6.5595523722835,5.55941031762408,0.376723533535873
"United States","Texas","TX",2021-02-14,2021-02-20,7,2021,"7",28995881,6405,834,4292,2113,5571,2.87627059857226,7.28724193619087,0.492311276794035
"United States","Texas","TX",2021-02-21,2021-02-27,7,2021,"8",28995881,5655,1526,4256,1399,4129,5.26281646693198,4.82482322230526,0.328712406015037
"United States","Texas","TX",2021-02-28,2021-03-06,7,2021,"9",28995881,5186,1627,4200,986,3559,5.61114180320991,3.40048298584202,0.234761904761905
"United States","Texas","TX",2021-03-07,2021-03-13,7,2021,"10",28995881,4919,1104,4138,781,3815,3.80743733911724,2.69348601616899,0.188738521024649
"United States","Texas","TX",2021-03-14,2021-03-20,7,2021,"11",28995881,4628,881,4118,510,3747,3.0383625867412,1.75887050991829,0.123846527440505
"United States","Texas","TX",2021-03-21,2021-03-27,7,2021,"12",28995881,4581,740,4054,527,3841,2.55208662223438,1.81749952691556,0.129995066600888
"United States","Texas","TX",2021-03-28,2021-04-03,7,2021,"13",28995881,4448,629,3992,456,3819,2.16927362889922,1.57263716180929,0.114228456913828
"United States","Texas","TX",2021-04-04,2021-04-10,7,2021,"14",28995881,4590,460,3933,657,4130,1.58643222463218,2.26583906865944,0.167048054919908
"United States","Texas","TX",2021-04-11,2021-04-17,7,2021,"15",28995881,4308,388,3923,385,3920,1.33812109382019,1.32777479670302,0.0981391791995923
"United States","Texas","TX",2021-04-18,2021-04-24,7,2021,"16",28995881,4571,372,3924,647,4199,1.28294084252863,2.23135141160222,0.164882772680938
"United States","Texas","TX",2021-04-25,2021-05-01,7,2021,"17",28995881,4452,341,3903,549,4111,1.17602910565125,1.89337237244145,0.140661029976941
"United States","Texas","TX",2021-05-02,2021-05-08,7,2021,"18",28995881,4357,293,3884,473,4064,1.01048835177659,1.63126617880657,0.12178166838311
"United States","Texas","TX",2021-05-09,2021-05-15,7,2021,"19",28995881,4389,305,3851,538,4084,1.05187354024525,1.85543594967851,0.139703972994027
"United States","Texas","TX",2021-05-16,2021-05-22,7,2021,"20",28995881,4280,261,3851,429,4019,0.900127849193477,1.4795204877548,0.111399636458063
"United States","Texas","TX",2021-05-23,2021-05-29,7,2021,"21",28995881,4281,263,3841,440,4018,0.907025380604921,1.51745691051774,0.114553501692268
"United States","Texas","TX",2021-05-30,2021-06-05,7,2021,"22",28995881,4230,218,3830,400,4012,0.751830923847425,1.37950628228885,0.10443864229765
"United States","Texas","TX",2021-06-06,2021-06-12,7,2021,"23",28995881,4296,223,3824,472,4073,0.769074752376036,1.62781741310085,0.123430962343096
"United States","Texas","TX",2021-06-13,2021-06-19,7,2021,"24",28995881,4337,173,3827,510,4164,0.596636467089929,1.75887050991829,0.1332636529919
"United States","Texas","TX",2021-06-20,2021-06-26,7,2021,"25",28995881,4290,171,3798,492,4119,0.589738935678485,1.69679272721529,0.12954186413902
"United States","Texas","TX",2021-06-27,2021-07-03,7,2021,"26",28995881,4318,150,3787,531,4168,0.51731485585832,1.83129458973845,0.140216530235014
"United States","Texas","TX",2021-07-04,2021-07-10,7,2021,"27",28995881,4238,140,3775,463,4098,0.482827198801099,1.59677852174935,0.122649006622517
"United States","Texas","TX",2021-07-11,2021-07-17,7,2021,"28",28995881,4414,162,3797,617,4252,0.558700044326986,2.12788844043056,0.162496707927311
"United States","Texas","TX",2021-07-18,2021-07-24,7,2021,"29",28995881,4399,189,3793,606,4210,0.651816718381483,2.08995201766761,0.159767993672555
"United States","Texas","TX",2021-07-25,2021-07-31,7,2021,"30",28995881,4714,255,3803,911,4459,0.879435254959144,3.14182555791286,0.239547725479884
"United States","Texas","TX",2021-08-01,2021-08-07,7,2021,"31",28995881,4932,350,3821,1111,4582,1.20706799700275,3.83157869905729,0.290761580738027
"United States","Texas","TX",2021-08-08,2021-08-14,7,2021,"32",28995881,5429,613,3839,1590,4816,2.11409337760767,5.48353747209819,0.414170356863767
"United States","Texas","TX",2021-08-15,2021-08-21,7,2021,"33",28995881,5142,52,3820,1322,5090,0.179335816697551,4.55926826296466,0.346073298429319
"United States","Utah","UT",2019-12-29,2020-01-04,7,2020,"1",3205958,392,0,389,3,392,0,0.0935757736065164,0.00771208226221076
"United States","Utah","UT",2020-01-05,2020-01-11,7,2020,"2",3205958,438,0,398,40,438,0,1.24767698142022,0.100502512562814
"United States","Utah","UT",2020-01-12,2020-01-18,7,2020,"3",3205958,409,0,393,16,409,0,0.499070792568087,0.0407124681933841
"United States","Utah","UT",2020-01-19,2020-01-25,7,2020,"4",3205958,390,0,391,-1,390,0,-0.0311919245355055,-0.00255754475703329
"United States","Utah","UT",2020-01-26,2020-02-01,7,2020,"5",3205958,364,0,385,-21,364,0,-0.655030415245615,-0.0545454545454546
"United States","Utah","UT",2020-02-02,2020-02-08,7,2020,"6",3205958,395,0,391,4,395,0,0.124767698142022,0.0102301790281329
"United States","Utah","UT",2020-02-09,2020-02-15,7,2020,"7",3205958,414,0,389,25,414,0,0.779798113387636,0.0642673521850901
"United States","Utah","UT",2020-02-16,2020-02-22,7,2020,"8",3205958,368,0,395,-27,368,0,-0.842181962458647,-0.0683544303797469
"United States","Utah","UT",2020-02-23,2020-02-29,7,2020,"9",3205958,417,0,392,25,417,0,0.779798113387636,0.0637755102040816
"United States","Utah","UT",2020-03-01,2020-03-07,7,2020,"10",3205958,427,0,389,38,427,0,1.18529313234921,0.0976863753213368
"United States","Utah","UT",2020-03-08,2020-03-14,7,2020,"11",3205958,406,0,387,19,406,0,0.592646566174604,0.0490956072351421
"United States","Utah","UT",2020-03-15,2020-03-21,7,2020,"12",3205958,412,0,381,31,412,0,0.966949660600669,0.0813648293963254
"United States","Utah","UT",2020-03-22,2020-03-28,7,2020,"13",3205958,395,3,378,17,392,0.0935757736065164,0.530262717103593,0.0449735449735449
"United States","Utah","UT",2020-03-29,2020-04-04,7,2020,"14",3205958,408,5,379,29,403,0.155959622677527,0.904565811529658,0.0765171503957784
"United States","Utah","UT",2020-04-05,2020-04-11,7,2020,"15",3205958,382,10,385,-3,372,0.311919245355055,-0.0935757736065164,-0.00779220779220779
"United States","Utah","UT",2020-04-12,2020-04-18,7,2020,"16",3205958,388,7,380,8,381,0.218343471748538,0.249535396284044,0.0210526315789474
"United States","Utah","UT",2020-04-19,2020-04-25,7,2020,"17",3205958,410,16,379,31,394,0.499070792568087,0.966949660600669,0.0817941952506596
"United States","Utah","UT",2020-04-26,2020-05-02,7,2020,"18",3205958,381,8,377,4,373,0.249535396284044,0.124767698142022,0.0106100795755968
"United States","Utah","UT",2020-05-03,2020-05-09,7,2020,"19",3205958,372,19,375,-3,353,0.592646566174604,-0.0935757736065164,-0.00800000000000001
"United States","Utah","UT",2020-05-10,2020-05-16,7,2020,"20",3205958,403,10,371,32,393,0.311919245355055,0.998141585136175,0.0862533692722371
"United States","Utah","UT",2020-05-17,2020-05-23,7,2020,"21",3205958,374,19,374,0,355,0.592646566174604,0,0
"United States","Utah","UT",2020-05-24,2020-05-30,7,2020,"22",3205958,390,11,374,16,379,0.34311116989056,0.499070792568087,0.0427807486631016
"United States","Utah","UT",2020-05-31,2020-06-06,7,2020,"23",3205958,410,13,379,31,397,0.405495018961571,0.966949660600669,0.0817941952506596
"United States","Utah","UT",2020-06-07,2020-06-13,7,2020,"24",3205958,388,18,375,13,370,0.561454641639098,0.405495018961571,0.0346666666666666
"United States","Utah","UT",2020-06-14,2020-06-20,7,2020,"25",3205958,402,16,377,25,386,0.499070792568087,0.779798113387636,0.0663129973474801
"United States","Utah","UT",2020-06-21,2020-06-27,7,2020,"26",3205958,388,12,371,17,376,0.374303094426065,0.530262717103593,0.045822102425876
"United States","Utah","UT",2020-06-28,2020-07-04,7,2020,"27",3205958,438,14,374,64,424,0.436686943497076,1.99628317027235,0.171122994652406
"United States","Utah","UT",2020-07-05,2020-07-11,7,2020,"28",3205958,407,31,371,36,376,0.966949660600669,1.1229092832782,0.0970350404312668
"United States","Utah","UT",2020-07-12,2020-07-18,7,2020,"29",3205958,435,31,374,61,404,0.966949660600669,1.90270739666583,0.163101604278075
"United States","Utah","UT",2020-07-19,2020-07-25,7,2020,"30",3205958,437,31,372,65,406,0.966949660600669,2.02747509480785,0.174731182795699
"United States","Utah","UT",2020-07-26,2020-08-01,7,2020,"31",3205958,435,36,374,61,399,1.1229092832782,1.90270739666583,0.163101604278075
"United States","Utah","UT",2020-08-02,2020-08-08,7,2020,"32",3205958,449,25,371,78,424,0.779798113387636,2.43297011376943,0.210242587601078
"United States","Utah","UT",2020-08-09,2020-08-15,7,2020,"33",3205958,450,28,374,76,422,0.873373886994153,2.37058626469841,0.203208556149733
"United States","Utah","UT",2020-08-16,2020-08-22,7,2020,"34",3205958,422,23,371,51,399,0.717414264316625,1.59078815131078,0.137466307277628
"United States","Utah","UT",2020-08-23,2020-08-29,7,2020,"35",3205958,377,21,365,12,356,0.655030415245615,0.374303094426065,0.0328767123287672
"United States","Utah","UT",2020-08-30,2020-09-05,7,2020,"36",3205958,367,13,366,1,354,0.405495018961571,0.0311919245355055,0.00273224043715836
"United States","Utah","UT",2020-09-06,2020-09-12,7,2020,"37",3205958,382,13,371,11,369,0.405495018961571,0.34311116989056,0.0296495956873315
"United States","Utah","UT",2020-09-13,2020-09-19,7,2020,"38",3205958,400,7,369,31,393,0.218343471748538,0.966949660600669,0.084010840108401
"United States","Utah","UT",2020-09-20,2020-09-26,7,2020,"39",3205958,440,8,377,63,432,0.249535396284044,1.96509124573684,0.16710875331565
"United States","Utah","UT",2020-09-27,2020-10-03,7,2020,"40",3205958,393,28,382,11,365,0.873373886994153,0.34311116989056,0.0287958115183247
"United States","Utah","UT",2020-10-04,2020-10-10,7,2020,"41",3205958,443,37,384,59,406,1.1541012078137,1.84032354759482,0.153645833333333
"United States","Utah","UT",2020-10-11,2020-10-17,7,2020,"42",3205958,424,28,380,44,396,0.873373886994153,1.37244467956224,0.11578947368421
"United States","Utah","UT",2020-10-18,2020-10-24,7,2020,"43",3205958,442,27,375,67,415,0.842181962458647,2.08985894387887,0.178666666666667
"United States","Utah","UT",2020-10-25,2020-10-31,7,2020,"44",3205958,460,36,371,89,424,1.1229092832782,2.77608128365999,0.23989218328841
"United States","Utah","UT",2020-11-01,2020-11-07,7,2020,"45",3205958,453,54,371,82,399,1.68436392491729,2.55773781191145,0.221024258760108
"United States","Utah","UT",2020-11-08,2020-11-14,7,2020,"46",3205958,482,53,375,107,429,1.65317200038179,3.33753592529908,0.285333333333333
"United States","Utah","UT",2020-11-15,2020-11-21,7,2020,"47",3205958,544,64,380,164,480,1.99628317027235,5.11547562382289,0.431578947368421
"United States","Utah","UT",2020-11-22,2020-11-28,7,2020,"48",3205958,487,88,379,108,399,2.74488935912448,3.36872784983459,0.284960422163588
"United States","Utah","UT",2020-11-29,2020-12-05,7,2020,"49",3205958,538,76,380,158,462,2.37058626469841,4.92832407660986,0.41578947368421
"United States","Utah","UT",2020-12-06,2020-12-12,7,2020,"50",3205958,552,101,380,172,451,3.15038437808605,5.36501102010694,0.452631578947368
"United States","Utah","UT",2020-12-13,2020-12-19,7,2020,"51",3205958,545,109,385,160,436,3.39991977437009,4.99070792568087,0.415584415584416
"United States","Utah","UT",2020-12-20,2020-12-26,7,2020,"52",3205958,502,7,399,103,495,0.218343471748538,3.21276822715706,0.258145363408521
"United States","Utah","UT",2020-12-27,2021-01-02,7,2020,"53",3205958,486,140,411,75,346,4.36686943497076,2.33939434016291,0.182481751824818
"United States","Utah","UT",2021-01-03,2021-01-09,7,2021,"1",3205958,533,97,412,121,436,3.02561667994403,3.77422286879616,0.293689320388349
"United States","Utah","UT",2021-01-10,2021-01-16,7,2021,"2",3205958,484,94,418,66,390,2.93204090633751,2.05866701934336,0.157894736842105
"United States","Utah","UT",2021-01-17,2021-01-23,7,2021,"3",3205958,496,97,415,81,399,3.02561667994403,2.52654588737594,0.195180722891566
"United States","Utah","UT",2021-01-24,2021-01-30,7,2021,"4",3205958,502,81,410,92,421,2.52654588737594,2.8696570572665,0.224390243902439
"United States","Utah","UT",2021-01-31,2021-02-06,7,2021,"5",3205958,466,71,408,58,395,2.21462664202089,1.80913162305932,0.142156862745098
"United States","Utah","UT",2021-02-07,2021-02-13,7,2021,"6",3205958,450,57,407,43,393,1.77793969852381,1.34125275502673,0.105651105651106
"United States","Utah","UT",2021-02-14,2021-02-20,7,2021,"7",3205958,428,50,409,19,378,1.55959622677527,0.592646566174604,0.0464547677261613
"United States","Utah","UT",2021-02-21,2021-02-27,7,2021,"8",3205958,379,65,413,-34,314,2.02747509480785,-1.06052543420719,-0.0823244552058111
"United States","Utah","UT",2021-02-28,2021-03-06,7,2021,"9",3205958,415,62,409,6,353,1.93389932120134,0.187151547213033,0.0146699266503667
"United States","Utah","UT",2021-03-07,2021-03-13,7,2021,"10",3205958,411,49,409,2,362,1.52840430223977,0.0623838490710109,0.00488997555012216
"United States","Utah","UT",2021-03-14,2021-03-20,7,2021,"11",3205958,398,41,400,-2,357,1.27886890595572,-0.0623838490710109,-0.005
"United States","Utah","UT",2021-03-21,2021-03-27,7,2021,"12",3205958,394,60,389,5,334,1.87151547213033,0.155959622677527,0.012853470437018
"United States","Utah","UT",2021-03-28,2021-04-03,7,2021,"13",3205958,406,15,388,18,391,0.467878868032582,0.561454641639098,0.0463917525773196
"United States","Utah","UT",2021-04-04,2021-04-10,7,2021,"14",3205958,382,27,385,-3,355,0.842181962458647,-0.0935757736065164,-0.00779220779220779
"United States","Utah","UT",2021-04-11,2021-04-17,7,2021,"15",3205958,373,4,386,-13,369,0.124767698142022,-0.405495018961571,-0.0336787564766839
"United States","Utah","UT",2021-04-18,2021-04-24,7,2021,"16",3205958,394,14,386,8,380,0.436686943497076,0.249535396284044,0.0207253886010363
"United States","Utah","UT",2021-04-25,2021-05-01,7,2021,"17",3205958,430,23,384,46,407,0.717414264316625,1.43482852863325,0.119791666666667
"United States","Utah","UT",2021-05-02,2021-05-08,7,2021,"18",3205958,388,20,382,6,368,0.623838490710109,0.187151547213033,0.0157068062827226
"United States","Utah","UT",2021-05-09,2021-05-15,7,2021,"19",3205958,383,35,383,0,348,1.09171735874269,0,0
"United States","Utah","UT",2021-05-16,2021-05-22,7,2021,"20",3205958,408,32,377,31,376,0.998141585136175,0.966949660600669,0.0822281167108754
"United States","Utah","UT",2021-05-23,2021-05-29,7,2021,"21",3205958,438,11,375,63,427,0.34311116989056,1.96509124573684,0.168
"United States","Utah","UT",2021-05-30,2021-06-05,7,2021,"22",3205958,394,10,375,19,384,0.311919245355055,0.592646566174604,0.0506666666666666
"United States","Utah","UT",2021-06-06,2021-06-12,7,2021,"23",3205958,389,8,373,16,381,0.249535396284044,0.499070792568087,0.0428954423592494
"United States","Utah","UT",2021-06-13,2021-06-19,7,2021,"24",3205958,418,7,367,51,411,0.218343471748538,1.59078815131078,0.138964577656676
"United States","Utah","UT",2021-06-20,2021-06-26,7,2021,"25",3205958,424,25,365,59,399,0.779798113387636,1.84032354759482,0.161643835616438
"United States","Utah","UT",2021-06-27,2021-07-03,7,2021,"26",3205958,423,27,362,61,396,0.842181962458647,1.90270739666583,0.168508287292818
"United States","Utah","UT",2021-07-04,2021-07-10,7,2021,"27",3205958,437,15,362,75,422,0.467878868032582,2.33939434016291,0.207182320441989
"United States","Utah","UT",2021-07-11,2021-07-17,7,2021,"28",3205958,387,20,359,28,367,0.623838490710109,0.873373886994153,0.0779944289693593
"United States","Utah","UT",2021-07-18,2021-07-24,7,2021,"29",3205958,449,12,358,91,437,0.374303094426065,2.838465132731,0.254189944134078
"United States","Utah","UT",2021-07-25,2021-07-31,7,2021,"30",3205958,435,26,357,78,409,0.810990037923142,2.43297011376943,0.218487394957983
"United States","Utah","UT",2021-08-01,2021-08-07,7,2021,"31",3205958,449,43,359,90,406,1.34125275502673,2.80727320819549,0.250696378830084
"United States","Utah","UT",2021-08-08,2021-08-14,7,2021,"32",3205958,433,31,359,74,402,0.966949660600669,2.3082024156274,0.206128133704735
"United States","Utah","UT",2021-08-15,2021-08-21,7,2021,"33",3205958,455,12,360,95,443,0.374303094426065,2.96323283087302,0.263888888888889
"United States","Vermont","VT",2019-12-29,2020-01-04,7,2020,"1",623989,109,0,126,-17,109,0,-2.72440700076444,-0.134920634920635
"United States","Vermont","VT",2020-01-05,2020-01-11,7,2020,"2",623989,102,0,125,-23,102,0,-3.68596241279894,-0.184
"United States","Vermont","VT",2020-01-12,2020-01-18,7,2020,"3",623989,134,0,121,13,134,0,2.0833700594081,0.107438016528926
"United States","Vermont","VT",2020-01-19,2020-01-25,7,2020,"4",623989,119,0,117,2,119,0,0.320518470678169,0.017094017094017
"United States","Vermont","VT",2020-01-26,2020-02-01,7,2020,"5",623989,105,0,113,-8,105,0,-1.28207388271268,-0.0707964601769911
"United States","Vermont","VT",2020-02-02,2020-02-08,7,2020,"6",623989,112,0,112,0,112,0,0,0
"United States","Vermont","VT",2020-02-09,2020-02-15,7,2020,"7",623989,126,0,107,19,126,0,3.04492547144261,0.177570093457944
"United States","Vermont","VT",2020-02-16,2020-02-22,7,2020,"8",623989,107,0,111,-4,107,0,-0.641036941356338,-0.036036036036036
"United States","Vermont","VT",2020-02-23,2020-02-29,7,2020,"9",623989,146,0,113,33,146,0,5.28855476618979,0.292035398230089
"United States","Vermont","VT",2020-03-01,2020-03-07,7,2020,"10",623989,115,0,117,-2,115,0,-0.320518470678169,-0.0170940170940171
"United States","Vermont","VT",2020-03-08,2020-03-14,7,2020,"11",623989,162,0,114,48,162,0,7.69244329627606,0.421052631578947
"United States","Vermont","VT",2020-03-15,2020-03-21,7,2020,"12",623989,135,2,113,22,133,0.320518470678169,3.52570317745986,0.194690265486726
"United States","Vermont","VT",2020-03-22,2020-03-28,7,2020,"13",623989,128,10,114,14,118,1.60259235339085,2.24362929474718,0.12280701754386
"United States","Vermont","VT",2020-03-29,2020-04-04,7,2020,"14",623989,130,4,115,15,126,0.641036941356338,2.40388853008627,0.130434782608696
"United States","Vermont","VT",2020-04-05,2020-04-11,7,2020,"15",623989,109,8,109,0,101,1.28207388271268,0,0
"United States","Vermont","VT",2020-04-12,2020-04-18,7,2020,"16",623989,129,12,109,20,117,1.92311082406901,3.20518470678169,0.18348623853211
"United States","Vermont","VT",2020-04-19,2020-04-25,7,2020,"17",623989,138,9,108,30,129,1.44233311805176,4.80777706017254,0.277777777777778
"United States","Vermont","VT",2020-04-26,2020-05-02,7,2020,"18",623989,109,5,106,3,104,0.801296176695423,0.480777706017254,0.0283018867924529
"United States","Vermont","VT",2020-05-03,2020-05-09,7,2020,"19",623989,112,3,103,9,109,0.480777706017254,1.44233311805176,0.087378640776699
"United States","Vermont","VT",2020-05-10,2020-05-16,7,2020,"20",623989,103,0,100,3,103,0,0.480777706017254,0.03
"United States","Vermont","VT",2020-05-17,2020-05-23,7,2020,"21",623989,115,1,99,16,114,0.160259235339084,2.56414776542535,0.161616161616162
"United States","Vermont","VT",2020-05-24,2020-05-30,7,2020,"22",623989,131,1,102,29,130,0.160259235339084,4.64751782483345,0.284313725490196
"United States","Vermont","VT",2020-05-31,2020-06-06,7,2020,"23",623989,116,0,104,12,116,0,1.92311082406901,0.115384615384615
"United States","Vermont","VT",2020-06-07,2020-06-13,7,2020,"24",623989,103,0,104,-1,103,0,-0.160259235339084,-0.00961538461538458
"United States","Vermont","VT",2020-06-14,2020-06-20,7,2020,"25",623989,90,1,101,-11,89,0.160259235339084,-1.76285158872993,-0.108910891089109
"United States","Vermont","VT",2020-06-21,2020-06-27,7,2020,"26",623989,136,0,106,30,136,0,4.80777706017254,0.283018867924528
"United States","Vermont","VT",2020-06-28,2020-07-04,7,2020,"27",623989,103,0,106,-3,103,0,-0.480777706017254,-0.0283018867924528
"United States","Vermont","VT",2020-07-05,2020-07-11,7,2020,"28",623989,112,0,105,7,112,0,1.12181464737359,0.0666666666666667
"United States","Vermont","VT",2020-07-12,2020-07-18,7,2020,"29",623989,104,0,107,-3,104,0,-0.480777706017254,-0.0280373831775701
"United States","Vermont","VT",2020-07-19,2020-07-25,7,2020,"30",623989,132,0,108,24,132,0,3.84622164813803,0.222222222222222
"United States","Vermont","VT",2020-07-26,2020-08-01,7,2020,"31",623989,103,1,106,-3,102,0.160259235339084,-0.480777706017254,-0.0283018867924528
"United States","Vermont","VT",2020-08-02,2020-08-08,7,2020,"32",623989,102,1,106,-4,101,0.160259235339084,-0.641036941356338,-0.0377358490566038
"United States","Vermont","VT",2020-08-09,2020-08-15,7,2020,"33",623989,125,0,104,21,125,0,3.36544394212077,0.201923076923077
"United States","Vermont","VT",2020-08-16,2020-08-22,7,2020,"34",623989,117,0,106,11,117,0,1.76285158872993,0.10377358490566
"United States","Vermont","VT",2020-08-23,2020-08-29,7,2020,"35",623989,100,0,103,-3,100,0,-0.480777706017254,-0.029126213592233
"United States","Vermont","VT",2020-08-30,2020-09-05,7,2020,"36",623989,113,0,101,12,113,0,1.92311082406901,0.118811881188119
"United States","Vermont","VT",2020-09-06,2020-09-12,7,2020,"37",623989,124,0,102,22,124,0,3.52570317745986,0.215686274509804
"United States","Vermont","VT",2020-09-13,2020-09-19,7,2020,"38",623989,113,0,102,11,113,0,1.76285158872993,0.107843137254902
"United States","Vermont","VT",2020-09-20,2020-09-26,7,2020,"39",623989,120,0,103,17,120,0,2.72440700076444,0.16504854368932
"United States","Vermont","VT",2020-09-27,2020-10-03,7,2020,"40",623989,119,0,106,13,119,0,2.0833700594081,0.122641509433962
"United States","Vermont","VT",2020-10-04,2020-10-10,7,2020,"41",623989,118,0,106,12,118,0,1.92311082406901,0.113207547169811
"United States","Vermont","VT",2020-10-11,2020-10-17,7,2020,"42",623989,120,0,107,13,120,0,2.0833700594081,0.121495327102804
"United States","Vermont","VT",2020-10-18,2020-10-24,7,2020,"43",623989,122,0,108,14,122,0,2.24362929474718,0.12962962962963
"United States","Vermont","VT",2020-10-25,2020-10-31,7,2020,"44",623989,137,0,109,28,137,0,4.48725858949437,0.256880733944954
"United States","Vermont","VT",2020-11-01,2020-11-07,7,2020,"45",623989,112,1,107,5,111,0.160259235339084,0.801296176695423,0.0467289719626167
"United States","Vermont","VT",2020-11-08,2020-11-14,7,2020,"46",623989,144,0,106,38,144,0,6.08985094288521,0.358490566037736
"United States","Vermont","VT",2020-11-15,2020-11-21,7,2020,"47",623989,128,3,107,21,125,0.480777706017254,3.36544394212077,0.196261682242991
"United States","Vermont","VT",2020-11-22,2020-11-28,7,2020,"48",623989,123,5,107,16,118,0.801296176695423,2.56414776542535,0.149532710280374
"United States","Vermont","VT",2020-11-29,2020-12-05,7,2020,"49",623989,127,12,106,21,115,1.92311082406901,3.36544394212077,0.19811320754717
"United States","Vermont","VT",2020-12-06,2020-12-12,7,2020,"50",623989,132,16,109,23,116,2.56414776542535,3.68596241279894,0.211009174311927
"United States","Vermont","VT",2020-12-13,2020-12-19,7,2020,"51",623989,124,13,114,10,111,2.0833700594081,1.60259235339085,0.0877192982456141
"United States","Vermont","VT",2020-12-20,2020-12-26,7,2020,"52",623989,150,13,119,31,137,2.0833700594081,4.96803629551162,0.260504201680672
"United States","Vermont","VT",2020-12-27,2021-01-02,7,2020,"53",623989,159,18,123,36,141,2.88466623610352,5.76933247220704,0.292682926829268
"United States","Vermont","VT",2021-01-03,2021-01-09,7,2021,"1",623989,108,17,123,-15,91,2.72440700076444,-2.40388853008627,-0.121951219512195
"United States","Vermont","VT",2021-01-10,2021-01-16,7,2021,"2",623989,149,7,124,25,142,1.12181464737359,4.00648088347711,0.201612903225806
"United States","Vermont","VT",2021-01-17,2021-01-23,7,2021,"3",623989,124,7,118,6,117,1.12181464737359,0.961555412034507,0.0508474576271187
"United States","Vermont","VT",2021-01-24,2021-01-30,7,2021,"4",623989,114,3,116,-2,111,0.480777706017254,-0.320518470678169,-0.0172413793103449
"United States","Vermont","VT",2021-01-31,2021-02-06,7,2021,"5",623989,137,9,114,23,128,1.44233311805176,3.68596241279894,0.201754385964912
"United States","Vermont","VT",2021-02-07,2021-02-13,7,2021,"6",623989,113,7,114,-1,106,1.12181464737359,-0.160259235339084,-0.00877192982456143
"United States","Vermont","VT",2021-02-14,2021-02-20,7,2021,"7",623989,167,7,111,56,160,1.12181464737359,8.97451717898873,0.504504504504504
"United States","Vermont","VT",2021-02-21,2021-02-27,7,2021,"8",623989,169,9,120,49,160,1.44233311805176,7.85270253161514,0.408333333333333
"United States","Vermont","VT",2021-02-28,2021-03-06,7,2021,"9",623989,108,3,118,-10,105,0.480777706017254,-1.60259235339085,-0.0847457627118644
"United States","Vermont","VT",2021-03-07,2021-03-13,7,2021,"10",623989,129,6,120,9,123,0.961555412034507,1.44233311805176,0.075
"United States","Vermont","VT",2021-03-14,2021-03-20,7,2021,"11",623989,130,5,121,9,125,0.801296176695423,1.44233311805176,0.0743801652892562
"United States","Vermont","VT",2021-03-21,2021-03-27,7,2021,"12",623989,123,5,114,9,118,0.801296176695423,1.44233311805176,0.0789473684210527
"United States","Vermont","VT",2021-03-28,2021-04-03,7,2021,"13",623989,104,5,112,-8,99,0.801296176695423,-1.28207388271268,-0.0714285714285714
"United States","Vermont","VT",2021-04-04,2021-04-10,7,2021,"14",623989,130,2,118,12,128,0.320518470678169,1.92311082406901,0.101694915254237
"United States","Vermont","VT",2021-04-11,2021-04-17,7,2021,"15",623989,111,11,114,-3,100,1.76285158872993,-0.480777706017254,-0.0263157894736842
"United States","Vermont","VT",2021-04-18,2021-04-24,7,2021,"16",623989,141,2,114,27,139,0.320518470678169,4.32699935415528,0.236842105263158
"United States","Vermont","VT",2021-04-25,2021-05-01,7,2021,"17",623989,139,3,114,25,136,0.480777706017254,4.00648088347711,0.219298245614035
"United States","Vermont","VT",2021-05-02,2021-05-08,7,2021,"18",623989,105,2,104,1,103,0.320518470678169,0.160259235339084,0.00961538461538458
"United States","Vermont","VT",2021-05-09,2021-05-15,7,2021,"19",623989,145,3,104,41,142,0.480777706017254,6.57062864890246,0.394230769230769
"United States","Vermont","VT",2021-05-16,2021-05-22,7,2021,"20",623989,125,3,102,23,122,0.480777706017254,3.68596241279894,0.225490196078431
"United States","Vermont","VT",2021-05-23,2021-05-29,7,2021,"21",623989,99,0,101,-2,99,0,-0.320518470678169,-0.0198019801980198
"United States","Vermont","VT",2021-05-30,2021-06-05,7,2021,"22",623989,86,1,105,-19,85,0.160259235339084,-3.04492547144261,-0.180952380952381
"United States","Vermont","VT",2021-06-06,2021-06-12,7,2021,"23",623989,96,0,107,-11,96,0,-1.76285158872993,-0.102803738317757
"United States","Vermont","VT",2021-06-13,2021-06-19,7,2021,"24",623989,133,0,107,26,133,0,4.1667401188162,0.242990654205608
"United States","Vermont","VT",2021-06-20,2021-06-26,7,2021,"25",623989,132,0,106,26,132,0,4.1667401188162,0.245283018867924
"United States","Vermont","VT",2021-06-27,2021-07-03,7,2021,"26",623989,117,2,106,11,115,0.320518470678169,1.76285158872993,0.10377358490566
"United States","Vermont","VT",2021-07-04,2021-07-10,7,2021,"27",623989,156,0,102,54,156,0,8.65399870831056,0.529411764705882
"United States","Vermont","VT",2021-07-11,2021-07-17,7,2021,"28",623989,106,0,100,6,106,0,0.961555412034507,0.0600000000000001
"United States","Vermont","VT",2021-07-18,2021-07-24,7,2021,"29",623989,113,1,102,11,112,0.160259235339084,1.76285158872993,0.107843137254902
"United States","Vermont","VT",2021-07-25,2021-07-31,7,2021,"30",623989,144,1,105,39,143,0.160259235339084,6.2501101782243,0.371428571428571
"United States","Vermont","VT",2021-08-01,2021-08-07,7,2021,"31",623989,142,0,104,38,142,0,6.08985094288521,0.365384615384615
"United States","Vermont","VT",2021-08-08,2021-08-14,7,2021,"32",623989,120,4,103,17,116,0.641036941356338,2.72440700076444,0.16504854368932
"United States","Vermont","VT",2021-08-15,2021-08-21,7,2021,"33",623989,122,0,99,23,122,0,3.68596241279894,0.232323232323232
"United States","Virginia","VA",2019-12-29,2020-01-04,7,2020,"1",8535519,1438,0,1526,-88,1438,0,-1.03098593067393,-0.0576671035386632
"United States","Virginia","VA",2020-01-05,2020-01-11,7,2020,"2",8535519,1562,0,1535,27,1562,0,0.316325228729501,0.0175895765472314
"United States","Virginia","VA",2020-01-12,2020-01-18,7,2020,"3",8535519,1466,0,1517,-51,1466,0,-0.59750320982239,-0.033618984838497
"United States","Virginia","VA",2020-01-19,2020-01-25,7,2020,"4",8535519,1459,0,1515,-56,1459,0,-0.656081955883409,-0.0369636963696369
"United States","Virginia","VA",2020-01-26,2020-02-01,7,2020,"5",8535519,1479,0,1484,-5,1479,0,-0.0585787460610187,-0.00336927223719674
"United States","Virginia","VA",2020-02-02,2020-02-08,7,2020,"6",8535519,1524,0,1471,53,1524,0,0.620934708246798,0.0360299116247451
"United States","Virginia","VA",2020-02-09,2020-02-15,7,2020,"7",8535519,1377,0,1463,-86,1377,0,-1.00755443224952,-0.0587833219412167
"United States","Virginia","VA",2020-02-16,2020-02-22,7,2020,"8",8535519,1444,0,1453,-9,1444,0,-0.105441742909834,-0.00619408121128695
"United States","Virginia","VA",2020-02-23,2020-02-29,7,2020,"9",8535519,1388,0,1428,-40,1388,0,-0.468629968488149,-0.0280112044817927
"United States","Virginia","VA",2020-03-01,2020-03-07,7,2020,"10",8535519,1480,0,1421,59,1480,0,0.69122920352002,0.0415200562983815
"United States","Virginia","VA",2020-03-08,2020-03-14,7,2020,"11",8535519,1435,1,1413,22,1434,0.0117157492122037,0.257746482668482,0.0155697098372258
"United States","Virginia","VA",2020-03-15,2020-03-21,7,2020,"12",8535519,1455,1,1400,55,1454,0.0117157492122037,0.644366206671205,0.0392857142857144
"United States","Virginia","VA",2020-03-22,2020-03-28,7,2020,"13",8535519,1517,15,1389,128,1502,0.175736238183056,1.49961589916208,0.0921526277897768
"United States","Virginia","VA",2020-03-29,2020-04-04,7,2020,"14",8535519,1467,32,1375,92,1435,0.374903974790519,1.07784892752274,0.0669090909090908
"United States","Virginia","VA",2020-04-05,2020-04-11,7,2020,"15",8535519,1619,80,1351,268,1539,0.937259936976299,3.1398207888706,0.198371576609919
"United States","Virginia","VA",2020-04-12,2020-04-18,7,2020,"16",8535519,1602,128,1335,267,1474,1.49961589916208,3.1281050396584,0.2
"United States","Virginia","VA",2020-04-19,2020-04-25,7,2020,"17",8535519,1633,179,1331,302,1454,2.09711910898447,3.53815626208553,0.226897069872277
"United States","Virginia","VA",2020-04-26,2020-05-02,7,2020,"18",8535519,1669,181,1317,352,1488,2.12055060740888,4.12394372269571,0.267274107820805
"United States","Virginia","VA",2020-05-03,2020-05-09,7,2020,"19",8535519,1593,211,1295,298,1382,2.47202308377499,3.49129326523671,0.23011583011583
"United States","Virginia","VA",2020-05-10,2020-05-16,7,2020,"20",8535519,1565,174,1279,286,1391,2.03854036292345,3.35070427469027,0.223612197028929
"United States","Virginia","VA",2020-05-17,2020-05-23,7,2020,"21",8535519,1464,156,1287,177,1308,1.82765687710378,2.07368761056006,0.137529137529137
"United States","Virginia","VA",2020-05-24,2020-05-30,7,2020,"22",8535519,1443,206,1280,163,1237,2.41344433771397,1.90966712158921,0.12734375
"United States","Virginia","VA",2020-05-31,2020-06-06,7,2020,"23",8535519,1410,89,1277,133,1321,1.04270167988613,1.5581946452231,0.10415035238841
"United States","Virginia","VA",2020-06-07,2020-06-13,7,2020,"24",8535519,1422,83,1271,151,1339,0.97240718461291,1.76907813104276,0.118804091266719
"United States","Virginia","VA",2020-06-14,2020-06-20,7,2020,"25",8535519,1292,68,1264,28,1224,0.796670946429854,0.328040977941705,0.0221518987341771
"United States","Virginia","VA",2020-06-21,2020-06-27,7,2020,"26",8535519,1456,120,1268,188,1336,1.40588990546445,2.2025608518943,0.148264984227129
"United States","Virginia","VA",2020-06-28,2020-07-04,7,2020,"27",8535519,1394,124,1269,125,1270,1.45275290231326,1.46446865152547,0.0985027580772262
"United States","Virginia","VA",2020-07-05,2020-07-11,7,2020,"28",8535519,1488,118,1265,223,1370,1.38245840704004,2.61261207432143,0.176284584980237
"United States","Virginia","VA",2020-07-12,2020-07-18,7,2020,"29",8535519,1390,61,1264,126,1329,0.714660701944428,1.47618440073767,0.0996835443037976
"United States","Virginia","VA",2020-07-19,2020-07-25,7,2020,"30",8535519,1463,48,1260,203,1415,0.562355962185779,2.37829709007736,0.161111111111111
"United States","Virginia","VA",2020-07-26,2020-08-01,7,2020,"31",8535519,1455,140,1273,182,1315,1.64020488970852,2.13226635662108,0.142969363707777
"United States","Virginia","VA",2020-08-02,2020-08-08,7,2020,"32",8535519,1513,107,1266,247,1406,1.2535851657058,2.89379005541432,0.195102685624013
"United States","Virginia","VA",2020-08-09,2020-08-15,7,2020,"33",8535519,1457,59,1266,191,1398,0.69122920352002,2.23770809953091,0.15086887835703
"United States","Virginia","VA",2020-08-16,2020-08-22,7,2020,"34",8535519,1454,62,1271,183,1392,0.726376451156632,2.14398210583328,0.143981117230527
"United States","Virginia","VA",2020-08-23,2020-08-29,7,2020,"35",8535519,1458,125,1264,194,1333,1.46446865152547,2.27285534716752,0.153481012658228
"United States","Virginia","VA",2020-08-30,2020-09-05,7,2020,"36",8535519,1486,109,1274,212,1377,1.27701666413021,2.48373883298719,0.166405023547881
"United States","Virginia","VA",2020-09-06,2020-09-12,7,2020,"37",8535519,1469,45,1279,190,1424,0.527208714549168,2.22599235031871,0.148553557466771
"United States","Virginia","VA",2020-09-13,2020-09-19,7,2020,"38",8535519,1459,268,1277,182,1191,3.1398207888706,2.13226635662108,0.142521534847298
"United States","Virginia","VA",2020-09-20,2020-09-26,7,2020,"39",8535519,1484,154,1279,205,1330,1.80422537867937,2.40172858850177,0.160281469898358
"United States","Virginia","VA",2020-09-27,2020-10-03,7,2020,"40",8535519,1516,126,1295,221,1390,1.47618440073767,2.58918057589702,0.170656370656371
"United States","Virginia","VA",2020-10-04,2020-10-10,7,2020,"41",8535519,1478,84,1304,174,1394,0.984122933825114,2.03854036292345,0.133435582822086
"United States","Virginia","VA",2020-10-11,2020-10-17,7,2020,"42",8535519,1448,68,1311,137,1380,0.796670946429854,1.60505764207191,0.104500381388253
"United States","Virginia","VA",2020-10-18,2020-10-24,7,2020,"43",8535519,1496,156,1313,183,1340,1.82765687710378,2.14398210583328,0.139375476009139
"United States","Virginia","VA",2020-10-25,2020-10-31,7,2020,"44",8535519,1546,60,1324,222,1486,0.702944952732224,2.60089632510923,0.167673716012085
"United States","Virginia","VA",2020-11-01,2020-11-07,7,2020,"45",8535519,1652,59,1322,330,1593,0.69122920352002,3.86619724002723,0.249621785173979
"United States","Virginia","VA",2020-11-08,2020-11-14,7,2020,"46",8535519,1513,90,1332,181,1423,1.05441742909834,2.12055060740888,0.135885885885886
"United States","Virginia","VA",2020-11-15,2020-11-21,7,2020,"47",8535519,1614,120,1336,278,1494,1.40588990546445,3.25697828099264,0.208083832335329
"United States","Virginia","VA",2020-11-22,2020-11-28,7,2020,"48",8535519,1595,144,1352,243,1451,1.68706788655734,2.84692705856551,0.179733727810651
"United States","Virginia","VA",2020-11-29,2020-12-05,7,2020,"49",8535519,1629,143,1366,263,1486,1.67535213734513,3.08124204280958,0.192532942898975
"United States","Virginia","VA",2020-12-06,2020-12-12,7,2020,"50",8535519,1795,215,1380,415,1580,2.5188860806238,4.86203592306455,0.300724637681159
"United States","Virginia","VA",2020-12-13,2020-12-19,7,2020,"51",8535519,1868,233,1396,472,1635,2.72976956644347,5.52983362816016,0.33810888252149
"United States","Virginia","VA",2020-12-20,2020-12-26,7,2020,"52",8535519,1901,193,1409,492,1708,2.26113959795532,5.76414861240424,0.349183818310859
"United States","Virginia","VA",2020-12-27,2021-01-02,7,2020,"53",8535519,2016,280,1412,604,1736,3.28040977941705,7.07631252417106,0.427762039660057
"United States","Virginia","VA",2021-01-03,2021-01-09,7,2021,"1",8535519,2015,266,1418,597,1749,3.11638929044619,6.99430227968563,0.421015514809591
"United States","Virginia","VA",2021-01-10,2021-01-16,7,2021,"2",8535519,2067,323,1435,632,1744,3.78418699554181,7.40435350211276,0.440418118466899
"United States","Virginia","VA",2021-01-17,2021-01-23,7,2021,"3",8535519,2123,371,1450,673,1752,4.34654295772758,7.88469921981311,0.464137931034483
"United States","Virginia","VA",2021-01-24,2021-01-30,7,2021,"4",8535519,1957,374,1462,495,1583,4.3816902053642,5.79929586004085,0.338577291381669
"United States","Virginia","VA",2021-01-31,2021-02-06,7,2021,"5",8535519,2002,325,1456,546,1677,3.80761849396621,6.39679906986324,0.375
"United States","Virginia","VA",2021-02-07,2021-02-13,7,2021,"6",8535519,1799,228,1456,343,1571,2.67119082038245,4.01850197978588,0.235576923076923
"United States","Virginia","VA",2021-02-14,2021-02-20,7,2021,"7",8535519,1738,209,1449,289,1529,2.44859158535058,3.38585152232688,0.199447895100069
"United States","Virginia","VA",2021-02-21,2021-02-27,7,2021,"8",8535519,1710,1173,1435,275,537,13.742573825915,3.22183103335603,0.191637630662021
"United States","Virginia","VA",2021-02-28,2021-03-06,7,2021,"9",8535519,1589,1140,1429,160,449,13.3559541019123,1.8745198739526,0.111966410076977
"United States","Virginia","VA",2021-03-07,2021-03-13,7,2021,"10",8535519,1549,477,1431,118,1072,5.58841237422118,1.38245840704004,0.0824598183088749
"United States","Virginia","VA",2021-03-14,2021-03-20,7,2021,"11",8535519,1528,209,1424,104,1319,2.44859158535058,1.21843791806919,0.0730337078651686
"United States","Virginia","VA",2021-03-21,2021-03-27,7,2021,"12",8535519,1535,62,1419,116,1473,0.726376451156632,1.35902690861563,0.0817477096546864
"United States","Virginia","VA",2021-03-28,2021-04-03,7,2021,"13",8535519,1373,15,1418,-45,1358,0.175736238183056,-0.527208714549168,-0.0317348377997179
"United States","Virginia","VA",2021-04-04,2021-04-10,7,2021,"14",8535519,1579,171,1407,172,1408,2.00339311528684,2.01510886449904,0.122245913290689
"United States","Virginia","VA",2021-04-11,2021-04-17,7,2021,"15",8535519,1435,106,1396,39,1329,1.2418694164936,0.456914219275946,0.0279369627507164
"United States","Virginia","VA",2021-04-18,2021-04-24,7,2021,"16",8535519,1492,111,1385,107,1381,1.30044816255461,1.2535851657058,0.0772563176895307
"United States","Virginia","VA",2021-04-25,2021-05-01,7,2021,"17",8535519,1496,102,1367,129,1394,1.19500641964478,1.51133164837428,0.0943672275054865
"United States","Virginia","VA",2021-05-02,2021-05-08,7,2021,"18",8535519,1487,108,1343,144,1379,1.265300914918,1.68706788655734,0.107222635889799
"United States","Virginia","VA",2021-05-09,2021-05-15,7,2021,"19",8535519,1473,123,1343,130,1350,1.44103715310106,1.52304739758649,0.0967982129560685
"United States","Virginia","VA",2021-05-16,2021-05-22,7,2021,"20",8535519,1402,89,1342,60,1313,1.04270167988613,0.702944952732224,0.0447093889716841
"United States","Virginia","VA",2021-05-23,2021-05-29,7,2021,"21",8535519,1431,63,1336,95,1368,0.738092200368835,1.11299617515935,0.0711077844311376
"United States","Virginia","VA",2021-05-30,2021-06-05,7,2021,"22",8535519,1425,69,1343,82,1356,0.808386695642058,0.960691435400706,0.0610573343261356
"United States","Virginia","VA",2021-06-06,2021-06-12,7,2021,"23",8535519,1386,64,1337,49,1322,0.749807949581039,0.574071711397983,0.036649214659686
"United States","Virginia","VA",2021-06-13,2021-06-19,7,2021,"24",8535519,1333,50,1327,6,1283,0.585787460610187,0.0702944952732224,0.00452147701582506
"United States","Virginia","VA",2021-06-20,2021-06-26,7,2021,"25",8535519,1375,49,1328,47,1326,0.574071711397983,0.550640212973575,0.0353915662650603
"United States","Virginia","VA",2021-06-27,2021-07-03,7,2021,"26",8535519,1429,31,1329,100,1398,0.363188225578316,1.17157492122037,0.0752445447705041
"United States","Virginia","VA",2021-07-04,2021-07-10,7,2021,"27",8535519,1373,27,1313,60,1346,0.316325228729501,0.702944952732224,0.0456968773800457
"United States","Virginia","VA",2021-07-11,2021-07-17,7,2021,"28",8535519,1443,27,1301,142,1416,0.316325228729501,1.66363638813293,0.109146810146042
"United States","Virginia","VA",2021-07-18,2021-07-24,7,2021,"29",8535519,1411,23,1301,110,1388,0.269462231880686,1.28873241334241,0.0845503458877785
"United States","Virginia","VA",2021-07-25,2021-07-31,7,2021,"30",8535519,1515,32,1302,213,1483,0.374903974790519,2.49545458219939,0.163594470046083
"United States","Virginia","VA",2021-08-01,2021-08-07,7,2021,"31",8535519,1529,26,1296,233,1503,0.304609479517297,2.72976956644347,0.179783950617284
"United States","Virginia","VA",2021-08-08,2021-08-14,7,2021,"32",8535519,1557,41,1301,256,1516,0.480345717700353,2.99923179832416,0.196771714066103
"United States","Virginia","VA",2021-08-15,2021-08-21,7,2021,"33",8535519,1501,19,1298,203,1482,0.222599235031871,2.37829709007736,0.156394453004622
"United States","Washington","WA",2019-12-29,2020-01-04,7,2020,"1",7614893,1183,0,1284,-101,1183,0,-1.32634824941073,-0.0786604361370716
"United States","Washington","WA",2020-01-05,2020-01-11,7,2020,"2",7614893,1246,0,1303,-57,1246,0,-0.748533170459519,-0.0437452033768227
"United States","Washington","WA",2020-01-12,2020-01-18,7,2020,"3",7614893,1221,0,1293,-72,1221,0,-0.94551558373834,-0.0556844547563805
"United States","Washington","WA",2020-01-19,2020-01-25,7,2020,"4",7614893,1192,0,1274,-82,1192,0,-1.07683719259089,-0.0643642072213501
"United States","Washington","WA",2020-01-26,2020-02-01,7,2020,"5",7614893,1200,0,1236,-36,1200,0,-0.47275779186917,-0.029126213592233
"United States","Washington","WA",2020-02-02,2020-02-08,7,2020,"6",7614893,1180,0,1211,-31,1180,0,-0.407096987442896,-0.0255986787778695
"United States","Washington","WA",2020-02-09,2020-02-15,7,2020,"7",7614893,1179,0,1206,-27,1179,0,-0.354568343901878,-0.0223880597014925
"United States","Washington","WA",2020-02-16,2020-02-22,7,2020,"8",7614893,1115,0,1192,-77,1115,0,-1.01117638816461,-0.0645973154362416
"United States","Washington","WA",2020-02-23,2020-02-29,7,2020,"9",7614893,1135,1,1186,-51,1134,0.0131321608852547,-0.669740205147991,-0.0430016863406408
"United States","Washington","WA",2020-03-01,2020-03-07,7,2020,"10",7614893,1208,15,1202,6,1193,0.196982413278821,0.0787929653115283,0.00499168053244592
"United States","Washington","WA",2020-03-08,2020-03-14,7,2020,"11",7614893,1165,24,1191,-26,1141,0.315171861246113,-0.341436183016623,-0.0218303946263644
"United States","Washington","WA",2020-03-15,2020-03-21,7,2020,"12",7614893,1224,53,1184,40,1171,0.6960045269185,0.525286435410189,0.0337837837837838
"United States","Washington","WA",2020-03-22,2020-03-28,7,2020,"13",7614893,1294,91,1176,118,1203,1.19502664055818,1.54959498446006,0.100340136054422
"United States","Washington","WA",2020-03-29,2020-04-04,7,2020,"14",7614893,1305,126,1159,146,1179,1.6546522715421,1.91729548924719,0.125970664365833
"United States","Washington","WA",2020-04-05,2020-04-11,7,2020,"15",7614893,1304,181,1150,154,1123,2.3769211202311,2.02235277632923,0.133913043478261
"United States","Washington","WA",2020-04-12,2020-04-18,7,2020,"16",7614893,1251,133,1129,122,1118,1.74657739773888,1.60212362800108,0.108060230292294
"United States","Washington","WA",2020-04-19,2020-04-25,7,2020,"17",7614893,1231,114,1119,112,1117,1.49706634091904,1.47080201914853,0.100089365504915
"United States","Washington","WA",2020-04-26,2020-05-02,7,2020,"18",7614893,1157,91,1099,58,1066,1.19502664055818,0.761665331344774,0.0527752502274794
"United States","Washington","WA",2020-05-03,2020-05-09,7,2020,"19",7614893,1211,91,1088,123,1120,1.19502664055818,1.61525578888633,0.113051470588235
"United States","Washington","WA",2020-05-10,2020-05-16,7,2020,"20",7614893,1138,79,1089,49,1059,1.03744070993512,0.643475883377482,0.0449954086317723
"United States","Washington","WA",2020-05-17,2020-05-23,7,2020,"21",7614893,1114,51,1101,13,1063,0.669740205147991,0.170718091508311,0.0118074477747503
"United States","Washington","WA",2020-05-24,2020-05-30,7,2020,"22",7614893,1058,68,1088,-30,990,0.892986940197321,-0.393964826557642,-0.0275735294117647
"United States","Washington","WA",2020-05-31,2020-06-06,7,2020,"23",7614893,1055,35,1075,-20,1020,0.459625630983915,-0.262643217705094,-0.0186046511627908
"United States","Washington","WA",2020-06-07,2020-06-13,7,2020,"24",7614893,1101,59,1061,40,1042,0.774797492230029,0.525286435410189,0.0377002827521207
"United States","Washington","WA",2020-06-14,2020-06-20,7,2020,"25",7614893,1133,51,1080,53,1082,0.669740205147991,0.6960045269185,0.049074074074074
"United States","Washington","WA",2020-06-21,2020-06-27,7,2020,"26",7614893,1084,47,1082,2,1037,0.617211561606972,0.0262643217705094,0.00184842883548986
"United States","Washington","WA",2020-06-28,2020-07-04,7,2020,"27",7614893,1126,44,1076,50,1082,0.577815078951208,0.656608044262736,0.0464684014869889
"United States","Washington","WA",2020-07-05,2020-07-11,7,2020,"28",7614893,1162,70,1071,91,1092,0.919251261967831,1.19502664055818,0.0849673202614378
"United States","Washington","WA",2020-07-12,2020-07-18,7,2020,"29",7614893,1180,20,1079,101,1160,0.262643217705094,1.32634824941073,0.0936051899907322
"United States","Washington","WA",2020-07-19,2020-07-25,7,2020,"30",7614893,1180,50,1071,109,1130,0.656608044262736,1.43140553649276,0.101774042950514
"United States","Washington","WA",2020-07-26,2020-08-01,7,2020,"31",7614893,1229,98,1061,168,1131,1.28695176675496,2.20620302872279,0.158341187558907
"United States","Washington","WA",2020-08-02,2020-08-08,7,2020,"32",7614893,1234,80,1055,179,1154,1.05057287082038,2.3506567984606,0.169668246445498
"United States","Washington","WA",2020-08-09,2020-08-15,7,2020,"33",7614893,1174,94,1051,123,1080,1.23442312321394,1.61525578888633,0.117031398667935
"United States","Washington","WA",2020-08-16,2020-08-22,7,2020,"34",7614893,1199,91,1056,143,1108,1.19502664055818,1.87789900659143,0.135416666666667
"United States","Washington","WA",2020-08-23,2020-08-29,7,2020,"35",7614893,1118,48,1061,57,1070,0.630343722492227,0.748533170459519,0.0537229029217718
"United States","Washington","WA",2020-08-30,2020-09-05,7,2020,"36",7614893,1240,48,1050,190,1192,0.630343722492227,2.4951105681984,0.180952380952381
"United States","Washington","WA",2020-09-06,2020-09-12,7,2020,"37",7614893,1146,38,1053,93,1108,0.499022113639679,1.22129096232869,0.0883190883190883
"United States","Washington","WA",2020-09-13,2020-09-19,7,2020,"38",7614893,1178,45,1047,131,1133,0.590947239836463,1.72031307596837,0.125119388729704
"United States","Washington","WA",2020-09-20,2020-09-26,7,2020,"39",7614893,1168,62,1050,118,1106,0.814193974885793,1.54959498446006,0.112380952380952
"United States","Washington","WA",2020-09-27,2020-10-03,7,2020,"40",7614893,1143,45,1068,75,1098,0.590947239836463,0.984912066394104,0.0702247191011236
"United States","Washington","WA",2020-10-04,2020-10-10,7,2020,"41",7614893,1162,47,1072,90,1115,0.617211561606972,1.18189447967293,0.083955223880597
"United States","Washington","WA",2020-10-11,2020-10-17,7,2020,"42",7614893,1149,49,1085,64,1100,0.643475883377482,0.840458296656302,0.0589861751152074
"United States","Washington","WA",2020-10-18,2020-10-24,7,2020,"43",7614893,1195,47,1077,118,1148,0.617211561606972,1.54959498446006,0.109563602599814
"United States","Washington","WA",2020-10-25,2020-10-31,7,2020,"44",7614893,1194,79,1068,126,1115,1.03744070993512,1.6546522715421,0.117977528089888
"United States","Washington","WA",2020-11-01,2020-11-07,7,2020,"45",7614893,1274,72,1073,201,1202,0.94551558373834,2.6395643379362,0.187325256290773
"United States","Washington","WA",2020-11-08,2020-11-14,7,2020,"46",7614893,1313,77,1084,229,1236,1.01117638816461,3.00726484272333,0.211254612546125
"United States","Washington","WA",2020-11-15,2020-11-21,7,2020,"47",7614893,1325,100,1090,235,1225,1.31321608852547,3.08605780803486,0.215596330275229
"United States","Washington","WA",2020-11-22,2020-11-28,7,2020,"48",7614893,1246,81,1103,143,1165,1.06370503170563,1.87789900659143,0.129646418857661
"United States","Washington","WA",2020-11-29,2020-12-05,7,2020,"49",7614893,1354,137,1107,247,1217,1.7991060412799,3.24364373865792,0.223125564588979
"United States","Washington","WA",2020-12-06,2020-12-12,7,2020,"50",7614893,1412,47,1112,300,1365,0.617211561606972,3.93964826557642,0.269784172661871
"United States","Washington","WA",2020-12-13,2020-12-19,7,2020,"51",7614893,1381,225,1143,238,1156,2.95473619918231,3.12545429069062,0.2082239720035
"United States","Washington","WA",2020-12-20,2020-12-26,7,2020,"52",7614893,1392,27,1185,207,1365,0.354568343901878,2.71835730324773,0.174683544303798
"United States","Washington","WA",2020-12-27,2021-01-02,7,2020,"53",7614893,1348,56,1218,130,1292,0.735401009574265,1.70718091508311,0.106732348111658
"United States","Washington","WA",2021-01-03,2021-01-09,7,2021,"1",7614893,1427,447,1233,194,980,5.87007591570886,2.54763921173942,0.157339821573398
"United States","Washington","WA",2021-01-10,2021-01-16,7,2021,"2",7614893,1393,209,1251,142,1184,2.74462162501824,1.86476684570617,0.113509192645883
"United States","Washington","WA",2021-01-17,2021-01-23,7,2021,"3",7614893,1306,269,1257,49,1037,3.53255127813352,0.643475883377482,0.0389817024661894
"United States","Washington","WA",2021-01-24,2021-01-30,7,2021,"4",7614893,1330,173,1257,73,1157,2.27186383314907,0.958647744623595,0.0580747812251392
"United States","Washington","WA",2021-01-31,2021-02-06,7,2021,"5",7614893,1343,164,1252,91,1179,2.15367438518177,1.19502664055818,0.0726837060702876
"United States","Washington","WA",2021-02-07,2021-02-13,7,2021,"6",7614893,1235,226,1247,-12,1009,2.96786836006757,-0.157585930623057,-0.00962309542902973
"United States","Washington","WA",2021-02-14,2021-02-20,7,2021,"7",7614893,1253,148,1256,-3,1105,1.9435598110177,-0.0393964826557642,-0.00238853503184711
"United States","Washington","WA",2021-02-21,2021-02-27,7,2021,"8",7614893,1233,134,1257,-24,1099,1.75970955862413,-0.315171861246113,-0.0190930787589498
"United States","Washington","WA",2021-02-28,2021-03-06,7,2021,"9",7614893,1241,89,1252,-11,1152,1.16876231878767,-0.144453769737802,-0.00878594249201281
"United States","Washington","WA",2021-03-07,2021-03-13,7,2021,"10",7614893,1193,85,1251,-58,1108,1.11623367524665,-0.761665331344774,-0.0463629096722622
"United States","Washington","WA",2021-03-14,2021-03-20,7,2021,"11",7614893,1177,47,1247,-70,1130,0.617211561606972,-0.919251261967831,-0.0561347233360064
"United States","Washington","WA",2021-03-21,2021-03-27,7,2021,"12",7614893,1222,43,1237,-15,1179,0.564682918065953,-0.196982413278821,-0.0121261115602264
"United States","Washington","WA",2021-03-28,2021-04-03,7,2021,"13",7614893,1190,58,1226,-36,1132,0.761665331344774,-0.47275779186917,-0.0293637846655791
"United States","Washington","WA",2021-04-04,2021-04-10,7,2021,"14",7614893,1224,43,1193,31,1181,0.564682918065953,0.407096987442896,0.0259849119865885
"United States","Washington","WA",2021-04-11,2021-04-17,7,2021,"15",7614893,1209,58,1175,34,1151,0.761665331344774,0.446493470098661,0.028936170212766
"United States","Washington","WA",2021-04-18,2021-04-24,7,2021,"16",7614893,1221,54,1168,53,1167,0.709136687803755,0.6960045269185,0.0453767123287672
"United States","Washington","WA",2021-04-25,2021-05-01,7,2021,"17",7614893,1237,65,1149,88,1172,0.853590457541557,1.15563015790242,0.0765883376849434
"United States","Washington","WA",2021-05-02,2021-05-08,7,2021,"18",7614893,1221,65,1136,85,1156,0.853590457541557,1.11623367524665,0.0748239436619718
"United States","Washington","WA",2021-05-09,2021-05-15,7,2021,"19",7614893,1193,58,1126,67,1135,0.761665331344774,0.879854779312066,0.0595026642984013
"United States","Washington","WA",2021-05-16,2021-05-22,7,2021,"20",7614893,1156,80,1125,31,1076,1.05057287082038,0.407096987442896,0.0275555555555556
"United States","Washington","WA",2021-05-23,2021-05-29,7,2021,"21",7614893,1205,63,1112,93,1142,0.827326135771048,1.22129096232869,0.0836330935251799
"United States","Washington","WA",2021-05-30,2021-06-05,7,2021,"22",7614893,1251,71,1090,161,1180,0.932383422853086,2.11427790252601,0.147706422018349
"United States","Washington","WA",2021-06-06,2021-06-12,7,2021,"23",7614893,1263,-21,1086,177,1284,-0.275775378590349,2.32439247669009,0.162983425414365
"United States","Washington","WA",2021-06-13,2021-06-19,7,2021,"24",7614893,1163,5,1092,71,1158,0.0656608044262736,0.932383422853086,0.065018315018315
"United States","Washington","WA",2021-06-20,2021-06-26,7,2021,"25",7614893,1276,82,1105,171,1194,1.07683719259089,2.24559951137856,0.154751131221719
"United States","Washington","WA",2021-06-27,2021-07-03,7,2021,"26",7614893,1591,37,1099,492,1554,0.485889952754425,6.46102315554532,0.447679708826206
"United States","Washington","WA",2021-07-04,2021-07-10,7,2021,"27",7614893,1296,58,1101,195,1238,0.761665331344774,2.56077137262467,0.177111716621253
"United States","Washington","WA",2021-07-11,2021-07-17,7,2021,"28",7614893,1239,45,1098,141,1194,0.590947239836463,1.85163468482092,0.128415300546448
"United States","Washington","WA",2021-07-18,2021-07-24,7,2021,"29",7614893,1260,36,1102,158,1224,0.47275779186917,2.07488141987025,0.143375680580762
"United States","Washington","WA",2021-07-25,2021-07-31,7,2021,"30",7614893,1233,44,1087,146,1189,0.577815078951208,1.91729548924719,0.134314627414903
"United States","Washington","WA",2021-08-01,2021-08-07,7,2021,"31",7614893,1290,46,1070,220,1244,0.604079400721717,2.88907539475604,0.205607476635514
"United States","Washington","WA",2021-08-08,2021-08-14,7,2021,"32",7614893,1295,71,1061,234,1224,0.932383422853086,3.07292564714961,0.220546654099906
"United States","Washington","WA",2021-08-15,2021-08-21,7,2021,"33",7614893,1244,9,1067,177,1235,0.118189447967293,2.32439247669009,0.165885660731022
"United States","West Virginia","WV",2019-12-29,2020-01-04,7,2020,"1",1792147,474,0,513,-39,474,0,-2.17616077252591,-0.0760233918128655
"United States","West Virginia","WV",2020-01-05,2020-01-11,7,2020,"2",1792147,494,0,515,-21,494,0,-1.17177887751395,-0.0407766990291262
"United States","West Virginia","WV",2020-01-12,2020-01-18,7,2020,"3",1792147,520,0,518,2,520,0,0.111597988334662,0.00386100386100385
"United States","West Virginia","WV",2020-01-19,2020-01-25,7,2020,"4",1792147,442,0,498,-56,442,0,-3.12474367337054,-0.112449799196787
"United States","West Virginia","WV",2020-01-26,2020-02-01,7,2020,"5",1792147,482,0,488,-6,482,0,-0.334793965003987,-0.0122950819672131
"United States","West Virginia","WV",2020-02-02,2020-02-08,7,2020,"6",1792147,482,0,485,-3,482,0,-0.167396982501993,-0.00618556701030926
"United States","West Virginia","WV",2020-02-09,2020-02-15,7,2020,"7",1792147,478,0,485,-7,478,0,-0.390592959171318,-0.0144329896907216
"United States","West Virginia","WV",2020-02-16,2020-02-22,7,2020,"8",1792147,467,0,475,-8,467,0,-0.446391953338649,-0.0168421052631579
"United States","West Virginia","WV",2020-02-23,2020-02-29,7,2020,"9",1792147,460,0,470,-10,460,0,-0.557989941673311,-0.0212765957446809
"United States","West Virginia","WV",2020-03-01,2020-03-07,7,2020,"10",1792147,483,0,470,13,483,0,0.725386924175305,0.0276595744680852
"United States","West Virginia","WV",2020-03-08,2020-03-14,7,2020,"11",1792147,475,0,474,1,475,0,0.0557989941673311,0.0021097046413503
"United States","West Virginia","WV",2020-03-15,2020-03-21,7,2020,"12",1792147,470,0,478,-8,470,0,-0.446391953338649,-0.0167364016736402
"United States","West Virginia","WV",2020-03-22,2020-03-28,7,2020,"13",1792147,491,0,480,11,491,0,0.613788935840643,0.0229166666666667
"United States","West Virginia","WV",2020-03-29,2020-04-04,7,2020,"14",1792147,467,2,480,-13,465,0.111597988334662,-0.725386924175305,-0.0270833333333333
"United States","West Virginia","WV",2020-04-05,2020-04-11,7,2020,"15",1792147,523,4,468,55,519,0.223195976669325,3.06894467920321,0.117521367521368
"United States","West Virginia","WV",2020-04-12,2020-04-18,7,2020,"16",1792147,419,12,461,-42,407,0.669587930007974,-2.34355775502791,-0.0911062906724512
"United States","West Virginia","WV",2020-04-19,2020-04-25,7,2020,"17",1792147,460,15,450,10,445,0.836984912509967,0.557989941673311,0.0222222222222221
"United States","West Virginia","WV",2020-04-26,2020-05-02,7,2020,"18",1792147,482,16,441,41,466,0.892783906677298,2.28775876086058,0.0929705215419501
"United States","West Virginia","WV",2020-05-03,2020-05-09,7,2020,"19",1792147,449,3,427,22,446,0.167396982501993,1.22757787168129,0.0515222482435598
"United States","West Virginia","WV",2020-05-10,2020-05-16,7,2020,"20",1792147,477,12,422,55,465,0.669587930007974,3.06894467920321,0.130331753554502
"United States","West Virginia","WV",2020-05-17,2020-05-23,7,2020,"21",1792147,440,7,425,15,433,0.390592959171318,0.836984912509967,0.0352941176470589
"United States","West Virginia","WV",2020-05-24,2020-05-30,7,2020,"22",1792147,412,2,426,-14,410,0.111597988334662,-0.781185918342636,-0.0328638497652582
"United States","West Virginia","WV",2020-05-31,2020-06-06,7,2020,"23",1792147,409,11,422,-13,398,0.613788935840643,-0.725386924175305,-0.0308056872037915
"United States","West Virginia","WV",2020-06-07,2020-06-13,7,2020,"24",1792147,458,4,425,33,454,0.223195976669325,1.84136680752193,0.0776470588235294
"United States","West Virginia","WV",2020-06-14,2020-06-20,7,2020,"25",1792147,419,0,421,-2,419,0,-0.111597988334662,-0.00475059382422804
"United States","West Virginia","WV",2020-06-21,2020-06-27,7,2020,"26",1792147,464,5,425,39,459,0.278994970836656,2.17616077252591,0.091764705882353
"United States","West Virginia","WV",2020-06-28,2020-07-04,7,2020,"27",1792147,425,1,421,4,424,0.0557989941673311,0.223195976669325,0.00950118764845609
"United States","West Virginia","WV",2020-07-05,2020-07-11,7,2020,"28",1792147,436,2,422,14,434,0.111597988334662,0.781185918342636,0.033175355450237
"United States","West Virginia","WV",2020-07-12,2020-07-18,7,2020,"29",1792147,426,4,419,7,422,0.223195976669325,0.390592959171318,0.0167064439140812
"United States","West Virginia","WV",2020-07-19,2020-07-25,7,2020,"30",1792147,501,3,410,91,498,0.167396982501993,5.07770846922713,0.221951219512195
"United States","West Virginia","WV",2020-07-26,2020-08-01,7,2020,"31",1792147,474,13,404,70,461,0.725386924175305,3.90592959171318,0.173267326732673
"United States","West Virginia","WV",2020-08-02,2020-08-08,7,2020,"32",1792147,494,15,404,90,479,0.836984912509967,5.0219094750598,0.222772277227723
"United States","West Virginia","WV",2020-08-09,2020-08-15,7,2020,"33",1792147,462,29,406,56,433,1.6181708308526,3.12474367337054,0.137931034482759
"United States","West Virginia","WV",2020-08-16,2020-08-22,7,2020,"34",1792147,497,16,413,84,481,0.892783906677298,4.68711551005582,0.203389830508474
"United States","West Virginia","WV",2020-08-23,2020-08-29,7,2020,"35",1792147,442,36,417,25,406,2.00876379002392,1.39497485418328,0.0599520383693046
"United States","West Virginia","WV",2020-08-30,2020-09-05,7,2020,"36",1792147,460,31,421,39,429,1.72976881918727,2.17616077252591,0.0926365795724466
"United States","West Virginia","WV",2020-09-06,2020-09-12,7,2020,"37",1792147,468,22,423,45,446,1.22757787168129,2.5109547375299,0.106382978723404
"United States","West Virginia","WV",2020-09-13,2020-09-19,7,2020,"38",1792147,484,43,422,62,441,2.39935674919524,3.45953763837453,0.146919431279621
"United States","West Virginia","WV",2020-09-20,2020-09-26,7,2020,"39",1792147,495,24,425,70,471,1.33917586001595,3.90592959171318,0.164705882352941
"United States","West Virginia","WV",2020-09-27,2020-10-03,7,2020,"40",1792147,424,25,426,-2,399,1.39497485418328,-0.111597988334662,-0.00469483568075113
"United States","West Virginia","WV",2020-10-04,2020-10-10,7,2020,"41",1792147,500,24,431,69,476,1.33917586001595,3.85013059754585,0.160092807424594
"United States","West Virginia","WV",2020-10-11,2020-10-17,7,2020,"42",1792147,455,18,438,17,437,1.00438189501196,0.948582900844629,0.0388127853881279
"United States","West Virginia","WV",2020-10-18,2020-10-24,7,2020,"43",1792147,471,23,441,30,448,1.28337686584862,1.67396982501993,0.0680272108843538
"United States","West Virginia","WV",2020-10-25,2020-10-31,7,2020,"44",1792147,485,31,444,41,454,1.72976881918727,2.28775876086058,0.0923423423423424
"United States","West Virginia","WV",2020-11-01,2020-11-07,7,2020,"45",1792147,531,48,439,92,483,2.67835172003189,5.13350746339446,0.209567198177677
"United States","West Virginia","WV",2020-11-08,2020-11-14,7,2020,"46",1792147,554,72,442,112,482,4.01752758004784,6.24948734674109,0.253393665158371
"United States","West Virginia","WV",2020-11-15,2020-11-21,7,2020,"47",1792147,524,65,441,83,459,3.62693462087652,4.63131651588848,0.188208616780045
"United States","West Virginia","WV",2020-11-22,2020-11-28,7,2020,"48",1792147,570,80,446,124,490,4.46391953338649,6.91907527674906,0.278026905829596
"United States","West Virginia","WV",2020-11-29,2020-12-05,7,2020,"49",1792147,637,111,451,186,526,6.19368835257376,10.3786129151236,0.412416851441242
"United States","West Virginia","WV",2020-12-06,2020-12-12,7,2020,"50",1792147,647,137,456,191,510,7.64446220092437,10.6576078859602,0.418859649122807
"United States","West Virginia","WV",2020-12-13,2020-12-19,7,2020,"51",1792147,695,156,465,230,539,8.70464309010366,12.8337686584862,0.494623655913978
"United States","West Virginia","WV",2020-12-20,2020-12-26,7,2020,"52",1792147,669,6,471,198,663,0.334793965003987,11.0482008451316,0.420382165605095
"United States","West Virginia","WV",2020-12-27,2021-01-02,7,2020,"53",1792147,729,245,480,249,484,13.6707535709961,13.8939495476655,0.51875
"United States","West Virginia","WV",2021-01-03,2021-01-09,7,2021,"1",1792147,719,197,486,233,522,10.9924018509642,13.0011656409882,0.479423868312757
"United States","West Virginia","WV",2021-01-10,2021-01-16,7,2021,"2",1792147,680,191,492,188,489,10.6576078859602,10.4902109034583,0.382113821138211
"United States","West Virginia","WV",2021-01-17,2021-01-23,7,2021,"3",1792147,607,111,483,124,496,6.19368835257376,6.91907527674906,0.256728778467909
"United States","West Virginia","WV",2021-01-24,2021-01-30,7,2021,"4",1792147,623,143,484,139,480,7.97925616592835,7.75606018925903,0.287190082644628
"United States","West Virginia","WV",2021-01-31,2021-02-06,7,2021,"5",1792147,586,104,476,110,482,5.80309539340244,6.13788935840643,0.23109243697479
"United States","West Virginia","WV",2021-02-07,2021-02-13,7,2021,"6",1792147,574,80,470,104,494,4.46391953338649,5.80309539340244,0.221276595744681
"United States","West Virginia","WV",2021-02-14,2021-02-20,7,2021,"7",1792147,511,17,464,47,494,0.948582900844629,2.62255272586456,0.101293103448276
"United States","West Virginia","WV",2021-02-21,2021-02-27,7,2021,"8",1792147,489,75,465,24,414,4.18492456254984,1.33917586001595,0.0516129032258064
"United States","West Virginia","WV",2021-02-28,2021-03-06,7,2021,"9",1792147,503,27,462,41,476,1.50657284251794,2.28775876086058,0.0887445887445888
"United States","West Virginia","WV",2021-03-07,2021-03-13,7,2021,"10",1792147,486,212,478,8,274,11.8293867634742,0.446391953338649,0.0167364016736402
"United States","West Virginia","WV",2021-03-14,2021-03-20,7,2021,"11",1792147,507,75,475,32,432,4.18492456254984,1.7855678133546,0.0673684210526315
"United States","West Virginia","WV",2021-03-21,2021-03-27,7,2021,"12",1792147,518,34,477,41,484,1.89716580168926,2.28775876086058,0.0859538784067087
"United States","West Virginia","WV",2021-03-28,2021-04-03,7,2021,"13",1792147,483,59,475,8,424,3.29214065587254,0.446391953338649,0.016842105263158
"United States","West Virginia","WV",2021-04-04,2021-04-10,7,2021,"14",1792147,491,39,475,16,452,2.17616077252591,0.892783906677298,0.0336842105263158
"United States","West Virginia","WV",2021-04-11,2021-04-17,7,2021,"15",1792147,510,43,464,46,467,2.39935674919524,2.56675373169723,0.0991379310344827
"United States","West Virginia","WV",2021-04-18,2021-04-24,7,2021,"16",1792147,467,37,455,12,430,2.06456278419125,0.669587930007974,0.0263736263736263
"United States","West Virginia","WV",2021-04-25,2021-05-01,7,2021,"17",1792147,517,-138,448,69,655,-7.7002611950917,3.85013059754585,0.154017857142857
"United States","West Virginia","WV",2021-05-02,2021-05-08,7,2021,"18",1792147,487,47,441,46,440,2.62255272586456,2.56675373169723,0.104308390022676
"United States","West Virginia","WV",2021-05-09,2021-05-15,7,2021,"19",1792147,479,31,438,41,448,1.72976881918727,2.28775876086058,0.0936073059360731
"United States","West Virginia","WV",2021-05-16,2021-05-22,7,2021,"20",1792147,461,15,437,24,446,0.836984912509967,1.33917586001595,0.0549199084668193
"United States","West Virginia","WV",2021-05-23,2021-05-29,7,2021,"21",1792147,452,20,433,19,432,1.11597988334662,1.06018088917929,0.043879907621247
"United States","West Virginia","WV",2021-05-30,2021-06-05,7,2021,"22",1792147,481,21,430,51,460,1.17177887751395,2.84574870253389,0.118604651162791
"United States","West Virginia","WV",2021-06-06,2021-06-12,7,2021,"23",1792147,457,36,427,30,421,2.00876379002392,1.67396982501993,0.0702576112412179
"United States","West Virginia","WV",2021-06-13,2021-06-19,7,2021,"24",1792147,470,14,427,43,456,0.781185918342636,2.39935674919524,0.100702576112412
"United States","West Virginia","WV",2021-06-20,2021-06-26,7,2021,"25",1792147,426,13,427,-1,413,0.725386924175305,-0.0557989941673311,-0.00234192037470726
"United States","West Virginia","WV",2021-06-27,2021-07-03,7,2021,"26",1792147,447,23,418,29,424,1.28337686584862,1.6181708308526,0.069377990430622
"United States","West Virginia","WV",2021-07-04,2021-07-10,7,2021,"27",1792147,450,9,413,37,441,0.50219094750598,2.06456278419125,0.089588377723971
"United States","West Virginia","WV",2021-07-11,2021-07-17,7,2021,"28",1792147,375,11,412,-37,364,0.613788935840643,-2.06456278419125,-0.0898058252427184
"United States","West Virginia","WV",2021-07-18,2021-07-24,7,2021,"29",1792147,404,17,407,-3,387,0.948582900844629,-0.167396982501993,-0.00737100737100738
"United States","Wisconsin","WI",2019-12-29,2020-01-04,7,2020,"1",5822434,1118,0,1171,-53,1118,0,-0.910272233227547,-0.0452604611443211
"United States","Wisconsin","WI",2020-01-05,2020-01-11,7,2020,"2",5822434,1060,0,1181,-121,1060,0,-2.07816868340629,-0.102455546147333
"United States","Wisconsin","WI",2020-01-12,2020-01-18,7,2020,"3",5822434,1133,0,1187,-54,1133,0,-0.927447181024293,-0.0454928390901432
"United States","Wisconsin","WI",2020-01-19,2020-01-25,7,2020,"4",5822434,1086,0,1180,-94,1086,0,-1.61444509289414,-0.0796610169491525
"United States","Wisconsin","WI",2020-01-26,2020-02-01,7,2020,"5",5822434,1176,0,1160,16,1176,0,0.274799164747939,0.0137931034482759
"United States","Wisconsin","WI",2020-02-02,2020-02-08,7,2020,"6",5822434,1056,0,1154,-98,1056,0,-1.68314488408112,-0.0849220103986135
"United States","Wisconsin","WI",2020-02-09,2020-02-15,7,2020,"7",5822434,1125,0,1132,-7,1125,0,-0.120224634577223,-0.00618374558303891
"United States","Wisconsin","WI",2020-02-16,2020-02-22,7,2020,"8",5822434,1162,0,1124,38,1162,0,0.652648016276354,0.0338078291814947
"United States","Wisconsin","WI",2020-02-23,2020-02-29,7,2020,"9",5822434,1136,0,1099,37,1136,0,0.635473068479608,0.0336669699727024
"United States","Wisconsin","WI",2020-03-01,2020-03-07,7,2020,"10",5822434,1116,0,1099,17,1116,0,0.291974112544685,0.0154686078252957
"United States","Wisconsin","WI",2020-03-08,2020-03-14,7,2020,"11",5822434,1105,0,1105,0,1105,0,0,0
"United States","Wisconsin","WI",2020-03-15,2020-03-21,7,2020,"12",5822434,1115,4,1111,4,1111,0.0686997911869847,0.0686997911869847,0.0036003600360035
"United States","Wisconsin","WI",2020-03-22,2020-03-28,7,2020,"13",5822434,1146,9,1123,23,1137,0.154574530170716,0.395023799325162,0.0204808548530722
"United States","Wisconsin","WI",2020-03-29,2020-04-04,7,2020,"14",5822434,1221,43,1121,100,1178,0.738522755260085,1.71749477967462,0.0892060660124889
"United States","Wisconsin","WI",2020-04-05,2020-04-11,7,2020,"15",5822434,1171,81,1102,69,1090,1.39117077153644,1.18507139797549,0.0626134301270418
"United States","Wisconsin","WI",2020-04-12,2020-04-18,7,2020,"16",5822434,1152,74,1087,65,1078,1.27094613695922,1.1163716067885,0.0597976080956761
"United States","Wisconsin","WI",2020-04-19,2020-04-25,7,2020,"17",5822434,1026,55,1086,-60,971,0.944622128821039,-1.03049686780477,-0.0552486187845304
"United States","Wisconsin","WI",2020-04-26,2020-05-02,7,2020,"18",5822434,1162,68,1066,96,1094,1.16789645017874,1.64879498848763,0.0900562851782365
"United States","Wisconsin","WI",2020-05-03,2020-05-09,7,2020,"19",5822434,1080,64,1047,33,1016,1.09919665899176,0.566773277292624,0.0315186246418337
"United States","Wisconsin","WI",2020-05-10,2020-05-16,7,2020,"20",5822434,1022,54,1045,-23,968,0.927447181024293,-0.395023799325162,-0.0220095693779905
"United States","Wisconsin","WI",2020-05-17,2020-05-23,7,2020,"21",5822434,1078,55,1030,48,1023,0.944622128821039,0.824397494243816,0.0466019417475727
"United States","Wisconsin","WI",2020-05-24,2020-05-30,7,2020,"22",5822434,1139,81,1020,119,1058,1.39117077153644,2.04381878781279,0.116666666666667
"United States","Wisconsin","WI",2020-05-31,2020-06-06,7,2020,"23",5822434,1043,57,1006,37,986,0.978972024414532,0.635473068479608,0.036779324055666
"United States","Wisconsin","WI",2020-06-07,2020-06-13,7,2020,"24",5822434,1026,46,997,29,980,0.790047598650324,0.498073486105639,0.0290872617853561
"United States","Wisconsin","WI",2020-06-14,2020-06-20,7,2020,"25",5822434,1085,52,1005,80,1033,0.893097285430801,1.37399582373969,0.0796019900497513
"United States","Wisconsin","WI",2020-06-21,2020-06-27,7,2020,"26",5822434,1034,34,1015,19,1000,0.58394822508937,0.326324008138177,0.01871921182266
"United States","Wisconsin","WI",2020-06-28,2020-07-04,7,2020,"27",5822434,1066,19,1022,44,1047,0.326324008138177,0.755697703056832,0.0430528375733856
"United States","Wisconsin","WI",2020-07-05,2020-07-11,7,2020,"28",5822434,1049,25,1018,31,1024,0.429373694918654,0.532423381699131,0.0304518664047151
"United States","Wisconsin","WI",2020-07-12,2020-07-18,7,2020,"29",5822434,1039,22,1012,27,1017,0.377848851528416,0.463723590512147,0.0266798418972332
"United States","Wisconsin","WI",2020-07-19,2020-07-25,7,2020,"30",5822434,1101,48,1004,97,1053,0.824397494243816,1.66596993628438,0.096613545816733
"United States","Wisconsin","WI",2020-07-26,2020-08-01,7,2020,"31",5822434,1057,56,998,59,1001,0.961797076617786,1.01332192000802,0.0591182364729459
"United States","Wisconsin","WI",2020-08-02,2020-08-08,7,2020,"32",5822434,1099,49,1003,96,1050,0.841572442040562,1.64879498848763,0.0957128614157527
"United States","Wisconsin","WI",2020-08-09,2020-08-15,7,2020,"33",5822434,1126,42,1004,122,1084,0.721347807463339,2.09534363120303,0.121513944223107
"United States","Wisconsin","WI",2020-08-16,2020-08-22,7,2020,"34",5822434,1061,43,993,68,1018,0.738522755260085,1.16789645017874,0.0684793554884189
"United States","Wisconsin","WI",2020-08-23,2020-08-29,7,2020,"35",5822434,1082,38,1003,79,1044,0.652648016276354,1.35682087594295,0.0787637088733799
"United States","Wisconsin","WI",2020-08-30,2020-09-05,7,2020,"36",5822434,1039,49,1011,28,990,0.841572442040562,0.480898538308893,0.0276953511374876
"United States","Wisconsin","WI",2020-09-06,2020-09-12,7,2020,"37",5822434,1066,41,1007,59,1025,0.704172859666593,1.01332192000802,0.0585898709036743
"United States","Wisconsin","WI",2020-09-13,2020-09-19,7,2020,"38",5822434,1140,32,1009,131,1108,0.549598329495878,2.24991816137375,0.129831516352825
"United States","Wisconsin","WI",2020-09-20,2020-09-26,7,2020,"39",5822434,1102,40,1020,82,1062,0.686997911869847,1.40834571933319,0.080392156862745
"United States","Wisconsin","WI",2020-09-27,2020-10-03,7,2020,"40",5822434,1157,91,1026,131,1066,1.5629202495039,2.24991816137375,0.127680311890838
"United States","Wisconsin","WI",2020-10-04,2020-10-10,7,2020,"41",5822434,1163,86,1032,131,1077,1.47704551052017,2.24991816137375,0.126937984496124
"United States","Wisconsin","WI",2020-10-11,2020-10-17,7,2020,"42",5822434,1244,116,1038,206,1128,1.99229394442256,3.53803924612971,0.198458574181118
"United States","Wisconsin","WI",2020-10-18,2020-10-24,7,2020,"43",5822434,1387,196,1034,353,1191,3.36628976816225,6.0627565722514,0.341392649903288
"United States","Wisconsin","WI",2020-10-25,2020-10-31,7,2020,"44",5822434,1454,259,1048,406,1195,4.44831147935726,6.97302880547895,0.387404580152672
"United States","Wisconsin","WI",2020-11-01,2020-11-07,7,2020,"45",5822434,1601,272,1046,555,1329,4.67158580071496,9.53209602719413,0.530592734225621
"United States","Wisconsin","WI",2020-11-08,2020-11-14,7,2020,"46",5822434,1716,323,1042,674,1393,5.54750813834901,11.5759148150069,0.646833013435701
"United States","Wisconsin","WI",2020-11-15,2020-11-21,7,2020,"47",5822434,1657,327,1033,624,1330,5.616207929536,10.7171674251696,0.60406582768635
"United States","Wisconsin","WI",2020-11-22,2020-11-28,7,2020,"48",5822434,1636,333,1044,592,1303,5.71925761631648,10.1675690956737,0.567049808429119
"United States","Wisconsin","WI",2020-11-29,2020-12-05,7,2020,"49",5822434,1652,415,1044,608,1237,7.12760333564966,10.4423682604217,0.582375478927203
"United States","Wisconsin","WI",2020-12-06,2020-12-12,7,2020,"50",5822434,1569,340,1044,525,1229,5.8394822508937,9.01684759329174,0.502873563218391
"United States","Wisconsin","WI",2020-12-13,2020-12-19,7,2020,"51",5822434,1500,360,1061,439,1140,6.18298120682862,7.53980208277157,0.413760603204524
"United States","Wisconsin","WI",2020-12-20,2020-12-26,7,2020,"52",5822434,1404,283,1077,327,1121,4.86051022647917,5.616207929536,0.303621169916435
"United States","Wisconsin","WI",2020-12-27,2021-01-02,7,2020,"53",5822434,1403,187,1086,317,1216,3.21171523799153,5.44445845156854,0.291896869244936
"United States","Wisconsin","WI",2021-01-03,2021-01-09,7,2021,"1",5822434,1378,286,1096,282,1092,4.91203506986941,4.84333527868242,0.257299270072993
"United States","Wisconsin","WI",2021-01-10,2021-01-16,7,2021,"2",5822434,1257,294,1126,131,963,5.04943465224337,2.24991816137375,0.116341030195382
"United States","Wisconsin","WI",2021-01-17,2021-01-23,7,2021,"3",5822434,1276,235,1126,150,1041,4.03611273223535,2.57624216951193,0.133214920071048
"United States","Wisconsin","WI",2021-01-24,2021-01-30,7,2021,"4",5822434,1190,208,1130,60,982,3.5723891417232,1.03049686780477,0.0530973451327434
"United States","Wisconsin","WI",2021-01-31,2021-02-06,7,2021,"5",5822434,1157,162,1119,38,995,2.78234154307288,0.652648016276354,0.0339588918677391
"United States","Wisconsin","WI",2021-02-07,2021-02-13,7,2021,"6",5822434,1144,110,1103,41,1034,1.88924425764208,0.704172859666593,0.0371713508612874
"United States","Wisconsin","WI",2021-02-14,2021-02-20,7,2021,"7",5822434,1125,121,1083,42,1004,2.07816868340629,0.721347807463339,0.0387811634349031
"United States","Wisconsin","WI",2021-02-21,2021-02-27,7,2021,"8",5822434,1104,130,1076,28,974,2.232743213577,0.480898538308893,0.0260223048327137
"United States","Wisconsin","WI",2021-02-28,2021-03-06,7,2021,"9",5822434,1074,71,1067,7,1003,1.21942129356898,0.120224634577223,0.00656044985941895
"United States","Wisconsin","WI",2021-03-07,2021-03-13,7,2021,"10",5822434,1054,65,1072,-18,989,1.1163716067885,-0.309149060341431,-0.0167910447761194
"United States","Wisconsin","WI",2021-03-14,2021-03-20,7,2021,"11",5822434,1000,55,1065,-65,945,0.944622128821039,-1.1163716067885,-0.0610328638497653
"United States","Wisconsin","WI",2021-03-21,2021-03-27,7,2021,"12",5822434,1032,29,1062,-30,1003,0.498073486105639,-0.515248433902385,-0.0282485875706214
"United States","Wisconsin","WI",2021-03-28,2021-04-03,7,2021,"13",5822434,986,5,1059,-73,981,0.0858747389837309,-1.25377118916247,-0.068932955618508
"United States","Wisconsin","WI",2021-04-04,2021-04-10,7,2021,"14",5822434,1068,36,1060,8,1032,0.618298120682862,0.137399582373969,0.00754716981132075
"United States","Wisconsin","WI",2021-04-11,2021-04-17,7,2021,"15",5822434,990,35,1049,-59,955,0.601123172886116,-1.01332192000802,-0.0562440419447092
"United States","Wisconsin","WI",2021-04-18,2021-04-24,7,2021,"16",5822434,1077,46,1041,36,1031,0.790047598650324,0.618298120682862,0.0345821325648414
"United States","Wisconsin","WI",2021-04-25,2021-05-01,7,2021,"17",5822434,1027,84,1040,-13,943,1.44269561492668,-0.2232743213577,-0.0125
"United States","Wisconsin","WI",2021-05-02,2021-05-08,7,2021,"18",5822434,1030,63,1030,0,967,1.08202171119501,0,0
"United States","Wisconsin","WI",2021-05-09,2021-05-15,7,2021,"19",5822434,1006,54,1028,-22,952,0.927447181024293,-0.377848851528416,-0.0214007782101168
"United States","Wisconsin","WI",2021-05-16,2021-05-22,7,2021,"20",5822434,1030,31,1024,6,999,0.532423381699131,0.103049686780477,0.005859375
"United States","Wisconsin","WI",2021-05-23,2021-05-29,7,2021,"21",5822434,1020,64,998,22,956,1.09919665899176,0.377848851528416,0.0220440881763526
"United States","Wisconsin","WI",2021-05-30,2021-06-05,7,2021,"22",5822434,1047,97,983,64,950,1.66596993628438,1.09919665899176,0.0651068158697863
"United States","Wisconsin","WI",2021-06-06,2021-06-12,7,2021,"23",5822434,1056,56,977,79,1000,0.961797076617786,1.35682087594295,0.0808597748208801
"United States","Wisconsin","WI",2021-06-13,2021-06-19,7,2021,"24",5822434,1037,29,978,59,1008,0.498073486105639,1.01332192000802,0.0603271983640081
"United States","Wisconsin","WI",2021-06-20,2021-06-26,7,2021,"25",5822434,953,45,992,-39,908,0.772872650853578,-0.669822964073101,-0.0393145161290323
"United States","Wisconsin","WI",2021-06-27,2021-07-03,7,2021,"26",5822434,1073,35,1003,70,1038,0.601123172886116,1.20224634577223,0.0697906281156531
"United States","Wisconsin","WI",2021-07-04,2021-07-10,7,2021,"27",5822434,993,41,1010,-17,952,0.704172859666593,-0.291974112544685,-0.0168316831683168
"United States","Wisconsin","WI",2021-07-11,2021-07-17,7,2021,"28",5822434,960,10,1008,-48,950,0.171749477967462,-0.824397494243816,-0.0476190476190477
"United States","Wisconsin","WI",2021-07-18,2021-07-24,7,2021,"29",5822434,1080,32,1016,64,1048,0.549598329495878,1.09919665899176,0.0629921259842521
"United States","Wisconsin","WI",2021-07-25,2021-07-31,7,2021,"30",5822434,1107,41,1017,90,1066,0.704172859666593,1.54574530170716,0.0884955752212389
"United States","Wisconsin","WI",2021-08-01,2021-08-07,7,2021,"31",5822434,1069,9,998,71,1060,0.154574530170716,1.21942129356898,0.0711422845691383
"United States","Wisconsin","WI",2021-08-08,2021-08-14,7,2021,"32",5822434,1055,23,995,60,1032,0.395023799325162,1.03049686780477,0.0603015075376885
"United States","Wisconsin","WI",2021-08-15,2021-08-21,7,2021,"33",5822434,1076,0,1007,69,1076,0,1.18507139797549,0.0685203574975173
"United States","Wyoming","WY",2019-12-29,2020-01-04,7,2020,"1",578759,144,0,93,51,144,0,8.8119579997892,0.548387096774194
"United States","Wyoming","WY",2020-01-05,2020-01-11,7,2020,"2",578759,81,0,93,-12,81,0,-2.07340188230334,-0.129032258064516
"United States","Wyoming","WY",2020-01-12,2020-01-18,7,2020,"3",578759,103,0,95,8,103,0,1.38226792153556,0.0842105263157895
"United States","Wyoming","WY",2020-01-19,2020-01-25,7,2020,"4",578759,96,0,96,0,96,0,0,0
"United States","Wyoming","WY",2020-01-26,2020-02-01,7,2020,"5",578759,94,0,97,-3,94,0,-0.518350470575835,-0.0309278350515464
"United States","Wyoming","WY",2020-02-02,2020-02-08,7,2020,"6",578759,97,0,96,1,97,0,0.172783490191945,0.0104166666666667
"United States","Wyoming","WY",2020-02-09,2020-02-15,7,2020,"7",578759,75,0,95,-20,75,0,-3.4556698038389,-0.210526315789474
"United States","Wyoming","WY",2020-02-16,2020-02-22,7,2020,"8",578759,101,0,95,6,101,0,1.03670094115167,0.0631578947368421
"United States","Wyoming","WY",2020-02-23,2020-02-29,7,2020,"9",578759,100,0,93,7,100,0,1.20948443134362,0.075268817204301
"United States","Wyoming","WY",2020-03-01,2020-03-07,7,2020,"10",578759,80,0,92,-12,80,0,-2.07340188230334,-0.130434782608696
"United States","Wyoming","WY",2020-03-08,2020-03-14,7,2020,"11",578759,85,0,93,-8,85,0,-1.38226792153556,-0.0860215053763441
"United States","Wyoming","WY",2020-03-15,2020-03-21,7,2020,"12",578759,117,0,93,24,117,0,4.14680376460668,0.258064516129032
"United States","Wyoming","WY",2020-03-22,2020-03-28,7,2020,"13",578759,88,0,90,-2,88,0,-0.34556698038389,-0.0222222222222223
"United States","Wyoming","WY",2020-03-29,2020-04-04,7,2020,"14",578759,123,0,92,31,123,0,5.3562881959503,0.33695652173913
"United States","Wyoming","WY",2020-04-05,2020-04-11,7,2020,"15",578759,102,0,90,12,102,0,2.07340188230334,0.133333333333333
"United States","Wyoming","WY",2020-04-12,2020-04-18,7,2020,"16",578759,89,2,88,1,87,0.34556698038389,0.172783490191945,0.0113636363636365
"United States","Wyoming","WY",2020-04-19,2020-04-25,7,2020,"17",578759,98,5,88,10,93,0.863917450959726,1.72783490191945,0.113636363636364
"United States","Wyoming","WY",2020-04-26,2020-05-02,7,2020,"18",578759,68,0,88,-20,68,0,-3.4556698038389,-0.227272727272727
"United States","Wyoming","WY",2020-05-03,2020-05-09,7,2020,"19",578759,83,0,90,-7,83,0,-1.20948443134362,-0.0777777777777777
"United States","Wyoming","WY",2020-05-10,2020-05-16,7,2020,"20",578759,101,0,88,13,101,0,2.24618537249529,0.147727272727273
"United States","Wyoming","WY",2020-05-17,2020-05-23,7,2020,"21",578759,96,5,88,8,91,0.863917450959726,1.38226792153556,0.0909090909090908
"United States","Wyoming","WY",2020-05-24,2020-05-30,7,2020,"22",578759,84,3,88,-4,81,0.518350470575835,-0.691133960767781,-0.0454545454545454
"United States","Wyoming","WY",2020-05-31,2020-06-06,7,2020,"23",578759,105,2,90,15,103,0.34556698038389,2.59175235287918,0.166666666666667
"United States","Wyoming","WY",2020-06-07,2020-06-13,7,2020,"24",578759,96,1,89,7,95,0.172783490191945,1.20948443134362,0.0786516853932584
"United States","Wyoming","WY",2020-06-14,2020-06-20,7,2020,"25",578759,93,2,88,5,91,0.34556698038389,0.863917450959726,0.0568181818181819
"United States","Wyoming","WY",2020-06-21,2020-06-27,7,2020,"26",578759,89,0,90,-1,89,0,-0.172783490191945,-0.0111111111111111
"United States","Wyoming","WY",2020-06-28,2020-07-04,7,2020,"27",578759,102,0,94,8,102,0,1.38226792153556,0.0851063829787233
"United States","Wyoming","WY",2020-07-05,2020-07-11,7,2020,"28",578759,104,1,94,10,103,0.172783490191945,1.72783490191945,0.106382978723404
"United States","Wyoming","WY",2020-07-12,2020-07-18,7,2020,"29",578759,101,3,94,7,98,0.518350470575835,1.20948443134362,0.074468085106383
"United States","Wyoming","WY",2020-07-19,2020-07-25,7,2020,"30",578759,95,1,95,0,94,0.172783490191945,0,0
"United States","Wyoming","WY",2020-07-26,2020-08-01,7,2020,"31",578759,90,0,96,-6,90,0,-1.03670094115167,-0.0625
"United States","Wyoming","WY",2020-08-02,2020-08-08,7,2020,"32",578759,106,2,97,9,104,0.34556698038389,1.55505141172751,0.0927835051546391
"United States","Wyoming","WY",2020-08-09,2020-08-15,7,2020,"33",578759,113,1,97,16,112,0.172783490191945,2.76453584307112,0.164948453608248
"United States","Wyoming","WY",2020-08-16,2020-08-22,7,2020,"34",578759,100,9,99,1,91,1.55505141172751,0.172783490191945,0.0101010101010102
"United States","Wyoming","WY",2020-08-23,2020-08-29,7,2020,"35",578759,89,0,101,-12,89,0,-2.07340188230334,-0.118811881188119
"United States","Wyoming","WY",2020-08-30,2020-09-05,7,2020,"36",578759,107,5,98,9,102,0.863917450959726,1.55505141172751,0.0918367346938775
"United States","Wyoming","WY",2020-09-06,2020-09-12,7,2020,"37",578759,121,0,97,24,121,0,4.14680376460668,0.247422680412371
"United States","Wyoming","WY",2020-09-13,2020-09-19,7,2020,"38",578759,94,7,97,-3,87,1.20948443134362,-0.518350470575835,-0.0309278350515464
"United States","Wyoming","WY",2020-09-20,2020-09-26,7,2020,"39",578759,112,1,95,17,111,0.172783490191945,2.93731933326307,0.178947368421053
"United States","Wyoming","WY",2020-09-27,2020-10-03,7,2020,"40",578759,119,3,97,22,116,0.518350470575835,3.80123678422279,0.22680412371134
"United States","Wyoming","WY",2020-10-04,2020-10-10,7,2020,"41",578759,102,0,98,4,102,0,0.691133960767781,0.0408163265306123
"United States","Wyoming","WY",2020-10-11,2020-10-17,7,2020,"42",578759,107,4,96,11,103,0.691133960767781,1.9006183921114,0.114583333333333
"United States","Wyoming","WY",2020-10-18,2020-10-24,7,2020,"43",578759,131,11,98,33,120,1.9006183921114,5.70185517633419,0.336734693877551
"United States","Wyoming","WY",2020-10-25,2020-10-31,7,2020,"44",578759,114,19,99,15,95,3.28288631364696,2.59175235287918,0.151515151515152
"United States","Wyoming","WY",2020-11-01,2020-11-07,7,2020,"45",578759,136,17,97,39,119,2.93731933326307,6.73855611748586,0.402061855670103
"United States","Wyoming","WY",2020-11-08,2020-11-14,7,2020,"46",578759,132,19,99,33,113,3.28288631364696,5.70185517633419,0.333333333333333
"United States","Wyoming","WY",2020-11-15,2020-11-21,7,2020,"47",578759,135,41,101,34,94,7.08412309786975,5.87463866652614,0.336633663366337
"United States","Wyoming","WY",2020-11-22,2020-11-28,7,2020,"48",578759,138,51,103,35,87,8.8119579997892,6.04742215671808,0.339805825242719
"United States","Wyoming","WY",2020-11-29,2020-12-05,7,2020,"49",578759,123,42,106,17,81,7.2569065880617,2.93731933326307,0.160377358490566
"United States","Wyoming","WY",2020-12-06,2020-12-12,7,2020,"50",578759,143,64,105,38,79,11.0581433722845,6.56577262729392,0.361904761904762
"United States","Wyoming","WY",2020-12-13,2020-12-19,7,2020,"51",578759,165,30,103,62,135,5.18350470575835,10.7125763919006,0.601941747572815
"United States","Wyoming","WY",2020-12-20,2020-12-26,7,2020,"52",578759,130,0,102,28,130,0,4.83793772537446,0.274509803921569
"United States","Wyoming","WY",2020-12-27,2021-01-02,7,2020,"53",578759,129,87,102,27,42,15.0321636466992,4.66515423518252,0.264705882352941
"United States","Wyoming","WY",2021-01-03,2021-01-09,7,2021,"1",578759,127,51,101,26,76,8.8119579997892,4.49237074499058,0.257425742574257
"United States","Wyoming","WY",2021-01-10,2021-01-16,7,2021,"2",578759,110,33,100,10,77,5.70185517633419,1.72783490191945,0.1
"United States","Wyoming","WY",2021-01-17,2021-01-23,7,2021,"3",578759,111,49,103,8,62,8.46639101940531,1.38226792153556,0.0776699029126213
"United States","Wyoming","WY",2021-01-24,2021-01-30,7,2021,"4",578759,118,25,101,17,93,4.31958725479863,2.93731933326307,0.168316831683168
"United States","Wyoming","WY",2021-01-31,2021-02-06,7,2021,"5",578759,112,28,103,9,84,4.83793772537446,1.55505141172751,0.087378640776699
"United States","Wyoming","WY",2021-02-07,2021-02-13,7,2021,"6",578759,102,23,100,2,79,3.97402027441474,0.34556698038389,0.02
"United States","Wyoming","WY",2021-02-14,2021-02-20,7,2021,"7",578759,110,15,102,8,95,2.59175235287918,1.38226792153556,0.0784313725490196
"United States","Wyoming","WY",2021-02-21,2021-02-27,7,2021,"8",578759,102,9,102,0,93,1.55505141172751,0,0
"United States","Wyoming","WY",2021-02-28,2021-03-06,7,2021,"9",578759,86,13,103,-17,73,2.24618537249529,-2.93731933326307,-0.16504854368932
"United States","Wyoming","WY",2021-03-07,2021-03-13,7,2021,"10",578759,104,9,102,2,95,1.55505141172751,0.34556698038389,0.0196078431372548
"United States","Wyoming","WY",2021-03-14,2021-03-20,7,2021,"11",578759,86,1,104,-18,85,0.172783490191945,-3.11010282345501,-0.173076923076923
"United States","Wyoming","WY",2021-03-21,2021-03-27,7,2021,"12",578759,111,2,101,10,109,0.34556698038389,1.72783490191945,0.0990099009900991
"United States","Wyoming","WY",2021-03-28,2021-04-03,7,2021,"13",578759,88,4,96,-8,84,0.691133960767781,-1.38226792153556,-0.0833333333333334
"United States","Wyoming","WY",2021-04-04,2021-04-10,7,2021,"14",578759,93,1,97,-4,92,0.172783490191945,-0.691133960767781,-0.0412371134020618
"United States","Wyoming","WY",2021-04-11,2021-04-17,7,2021,"15",578759,78,2,93,-15,76,0.34556698038389,-2.59175235287918,-0.161290322580645
"United States","Wyoming","WY",2021-04-18,2021-04-24,7,2021,"16",578759,100,2,95,5,98,0.34556698038389,0.863917450959726,0.0526315789473684
"United States","Wyoming","WY",2021-04-25,2021-05-01,7,2021,"17",578759,91,2,95,-4,89,0.34556698038389,-0.691133960767781,-0.0421052631578948
"United States","Wyoming","WY",2021-05-02,2021-05-08,7,2021,"18",578759,93,3,96,-3,90,0.518350470575835,-0.518350470575835,-0.03125
"United States","Wyoming","WY",2021-05-09,2021-05-15,7,2021,"19",578759,92,2,97,-5,90,0.34556698038389,-0.863917450959726,-0.0515463917525774
"United States","Wyoming","WY",2021-05-16,2021-05-22,7,2021,"20",578759,97,1,96,1,96,0.172783490191945,0.172783490191945,0.0104166666666667
"United States","Wyoming","WY",2021-05-23,2021-05-29,7,2021,"21",578759,100,6,93,7,94,1.03670094115167,1.20948443134362,0.075268817204301
"United States","Wyoming","WY",2021-05-30,2021-06-05,7,2021,"22",578759,107,1,92,15,106,0.172783490191945,2.59175235287918,0.16304347826087
"United States","Wyoming","WY",2021-06-06,2021-06-12,7,2021,"23",578759,113,5,92,21,108,0.863917450959726,3.62845329403085,0.228260869565217
"United States","Wyoming","WY",2021-06-13,2021-06-19,7,2021,"24",578759,110,9,91,19,101,1.55505141172751,3.28288631364696,0.208791208791209
"United States","Wyoming","WY",2021-06-20,2021-06-26,7,2021,"25",578759,99,6,93,6,93,1.03670094115167,1.03670094115167,0.064516129032258
"United States","Wyoming","WY",2021-06-27,2021-07-03,7,2021,"26",578759,104,7,93,11,97,1.20948443134362,1.9006183921114,0.118279569892473
"United States","Wyoming","WY",2021-07-04,2021-07-10,7,2021,"27",578759,87,4,95,-8,83,0.691133960767781,-1.38226792153556,-0.0842105263157895
"United States","Wyoming","WY",2021-07-11,2021-07-17,7,2021,"28",578759,111,9,95,16,102,1.55505141172751,2.76453584307112,0.168421052631579
"United States","Wyoming","WY",2021-07-18,2021-07-24,7,2021,"29",578759,99,6,94,5,93,1.03670094115167,0.863917450959726,0.053191489361702
"United States","Wyoming","WY",2021-07-25,2021-07-31,7,2021,"30",578759,98,10,94,4,88,1.72783490191945,0.691133960767781,0.0425531914893618
"United States","Wyoming","WY",2021-08-01,2021-08-07,7,2021,"31",578759,117,10,93,24,107,1.72783490191945,4.14680376460668,0.258064516129032
"United States","Wyoming","WY",2021-08-08,2021-08-14,7,2021,"32",578759,138,7,93,45,131,1.20948443134362,7.77525705863753,0.483870967741935
"United States","Wyoming","WY",2021-08-15,2021-08-21,7,2021,"33",578759,88,0,93,-5,88,0,-0.863917450959726,-0.053763440860215
"United States","United States","USA",2019-12-29,2020-01-04,7,2020,"1",328300544,60192,0,63641,-3449,60192,0,-1.05056176818275,-0.0541946229631841
"United States","United States","USA",2020-01-05,2020-01-11,7,2020,"2",328300544,60734,0,64021,-3287,60734,0,-1.0012167387697,-0.0513425282329236
"United States","United States","USA",2020-01-12,2020-01-18,7,2020,"3",328300544,59372,0,63416,-4044,59372,0,-1.23179814164426,-0.0637693957360919
"United States","United States","USA",2020-01-19,2020-01-25,7,2020,"4",328300544,59164,0,62714,-3550,59164,0,-1.08132626182916,-0.0566061804381797
"United States","United States","USA",2020-01-26,2020-02-01,7,2020,"5",328300544,58843,0,62399,-3556,58843,0,-1.08315385551113,-0.0569880927578967
"United States","United States","USA",2020-02-02,2020-02-08,7,2020,"6",328300544,59482,1,61558,-2076,59481,0.00030459894699413,-0.632347413959814,-0.0337242925371195
"United States","United States","USA",2020-02-09,2020-02-15,7,2020,"7",328300544,58815,0,60921,-2106,58815,0,-0.641485382369637,-0.0345693603191017
"United States","United States","USA",2020-02-16,2020-02-22,7,2020,"8",328300544,58912,1,60433,-1521,58911,0.00030459894699413,-0.463294998378072,-0.025168368275611
"United States","United States","USA",2020-02-23,2020-02-29,7,2020,"9",328300544,59343,1,59676,-333,59342,0.00030459894699413,-0.101431449349045,-0.00558013271667002
"United States","United States","USA",2020-03-01,2020-03-07,7,2020,"10",328300544,59696,19,59455,241,59677,0.00578737999288847,0.0734083462255853,0.00405348582961906
"United States","United States","USA",2020-03-08,2020-03-14,7,2020,"11",328300544,58694,39,59091,-397,58655,0.0118793589327711,-0.12092578195667,-0.00671845120238279
"United States","United States","USA",2020-03-15,2020-03-21,7,2020,"12",328300544,59219,284,58732,487,58935,0.0865061009463329,0.148339687186141,0.0082919021998229
"United States","United States","USA",2020-03-22,2020-03-28,7,2020,"13",328300544,63048,1988,58281,4767,61060,0.60554270662433,1.45202318032102,0.0817933803469397
"United States","United States","USA",2020-03-29,2020-04-04,7,2020,"14",328300544,72296,7056,57630,14666,65240,2.14925016999058,4.46724815661591,0.254485511018567
"United States","United States","USA",2020-04-05,2020-04-11,7,2020,"15",328300544,79096,13519,57052,22044,65577,4.11787316441364,6.7145791875386,0.386384351118278
"United States","United States","USA",2020-04-12,2020-04-18,7,2020,"16",328300544,76809,14155,56568,20241,62654,4.31159809470191,6.16538728610818,0.357817140432753
"United States","United States","USA",2020-04-19,2020-04-25,7,2020,"17",328300544,73930,15605,55927,18003,58325,4.7532665678434,5.48369484273532,0.321901764800544
"United States","United States","USA",2020-04-26,2020-05-02,7,2020,"18",328300544,69304,12860,55084,14220,56444,3.91714245834451,4.33139702625653,0.258151187277612
"United States","United States","USA",2020-05-03,2020-05-09,7,2020,"19",328300544,66814,12666,54372,12442,54148,3.85805026262765,3.78982009850096,0.228831015964099
"United States","United States","USA",2020-05-10,2020-05-16,7,2020,"20",328300544,64480,9576,53919,10561,54904,2.91683951641579,3.21686947920501,0.195867875887906
"United States","United States","USA",2020-05-17,2020-05-23,7,2020,"21",328300544,61642,8548,53515,8127,53094,2.60371179890582,2.47547564222129,0.151863963374755
"United States","United States","USA",2020-05-24,2020-05-30,7,2020,"22",328300544,59682,6656,53269,6413,53026,2.02741059119293,1.95339304707335,0.12038896919409
"United States","United States","USA",2020-05-31,2020-06-06,7,2020,"23",328300544,58908,6391,53138,5770,52517,1.94669187023948,1.75753592415613,0.108585193270353
"United States","United States","USA",2020-06-07,2020-06-13,7,2020,"24",328300544,58034,5207,52798,5236,52827,1.58604671699843,1.59488008646126,0.099170423122088
"United States","United States","USA",2020-06-14,2020-06-20,7,2020,"25",328300544,57999,4306,52878,5121,53693,1.31160306575672,1.55985120755694,0.0968455690457279
"United States","United States","USA",2020-06-21,2020-06-27,7,2020,"26",328300544,58522,5858,52790,5732,52664,1.78434063149161,1.74596116417035,0.108581170676264
"United States","United States","USA",2020-06-28,2020-07-04,7,2020,"27",328300544,59837,4079,52583,7254,55758,1.24245910478906,2.20956076149542,0.137953330924443
"United States","United States","USA",2020-07-05,2020-07-11,7,2020,"28",328300544,61945,4858,52424,9521,57087,1.47974168449748,2.90008657433111,0.181615290706547
"United States","United States","USA",2020-07-12,2020-07-18,7,2020,"29",328300544,63194,5326,52176,11018,57868,1.62229399169074,3.35607119798132,0.211169886537872
"United States","United States","USA",2020-07-19,2020-07-25,7,2020,"30",328300544,64266,6221,52097,12169,58045,1.89491004925048,3.70666458597157,0.233583507687583
"United States","United States","USA",2020-07-26,2020-08-01,7,2020,"31",328300544,64235,8026,52058,12177,56209,2.44471114857489,3.70910137754752,0.233912174881862
"United States","United States","USA",2020-08-02,2020-08-08,7,2020,"32",328300544,63719,7128,52048,11671,56591,2.17118129417416,3.55497431036849,0.224235321241931
"United States","United States","USA",2020-08-09,2020-08-15,7,2020,"33",328300544,63665,7482,51950,11715,56183,2.27900932141008,3.56837666403623,0.225505293551492
"United States","United States","USA",2020-08-16,2020-08-22,7,2020,"34",328300544,62562,6875,51937,10625,55687,2.09411776058464,3.23636381181263,0.204574773283016
"United States","United States","USA",2020-08-23,2020-08-29,7,2020,"35",328300544,61104,6690,51971,9133,54414,2.03776695539073,2.78190218289739,0.175732620115064
"United States","United States","USA",2020-08-30,2020-09-05,7,2020,"36",328300544,60247,5713,52180,8067,54534,1.74017378417746,2.45719970540165,0.154599463395937
"United States","United States","USA",2020-09-06,2020-09-12,7,2020,"37",328300544,59676,5018,52171,7505,54658,1.52847751601654,2.28601509719094,0.143853865174139
"United States","United States","USA",2020-09-13,2020-09-19,7,2020,"38",328300544,59740,5484,52393,7347,54256,1.67042062531581,2.23788846356587,0.140228656499914
"United States","United States","USA",2020-09-20,2020-09-26,7,2020,"39",328300544,60613,5119,52609,8004,55494,1.55924200966295,2.43800997174102,0.152141268604231
"United States","United States","USA",2020-09-27,2020-10-03,7,2020,"40",328300544,59815,4872,52746,7069,54943,1.4840060697554,2.1532099563015,0.134019641299814
"United States","United States","USA",2020-10-04,2020-10-10,7,2020,"41",328300544,61779,4860,52833,8946,56919,1.48035088239147,2.72494217980949,0.169325989438419
"United States","United States","USA",2020-10-11,2020-10-17,7,2020,"42",328300544,60663,4696,53053,7610,55967,1.43039665508443,2.31799798662533,0.143441464196181
"United States","United States","USA",2020-10-18,2020-10-24,7,2020,"43",328300544,62191,5390,53229,8962,56801,1.64178832429836,2.72981576296139,0.168366867684909
"United States","United States","USA",2020-10-25,2020-10-31,7,2020,"44",328300544,63445,5607,53465,9980,57838,1.70788629579609,3.03989749100142,0.186664172823342
"United States","United States","USA",2020-11-01,2020-11-07,7,2020,"45",328300544,67590,6501,53806,13784,61089,1.98019775440884,4.19859188536709,0.256179608222131
"United States","United States","USA",2020-11-08,2020-11-14,7,2020,"46",328300544,68845,7640,54066,14779,61205,2.32713595503515,4.50166783762625,0.273351089409241
"United States","United States","USA",2020-11-15,2020-11-21,7,2020,"47",328300544,71699,9373,54601,17098,62326,2.85500593017598,5.20803279570563,0.313144447903885
"United States","United States","USA",2020-11-22,2020-11-28,7,2020,"48",328300544,73305,10520,55074,18231,62785,3.20438092237825,5.55314340264998,0.331027345026691
"United States","United States","USA",2020-11-29,2020-12-05,7,2020,"49",328300544,77429,14514,55621,21808,62915,4.4209491166728,6.64269383604798,0.392082127254095
"United States","United States","USA",2020-12-06,2020-12-12,7,2020,"50",328300544,82026,16360,56235,25791,65666,4.98323877282396,7.8559114419256,0.458628967724727
"United States","United States","USA",2020-12-13,2020-12-19,7,2020,"51",328300544,82938,17350,57108,25830,65588,5.28479173034815,7.86779080085837,0.452300903551166
"United States","United States","USA",2020-12-20,2020-12-26,7,2020,"52",328300544,84371,13916,57987,26384,70455,4.23879894637031,8.03653861749312,0.454998534154207
"United States","United States","USA",2020-12-27,2021-01-02,7,2020,"53",328300544,87025,19700,58914,28111,67325,6.00059925578436,8.56258099895198,0.477153138473029
"United States","United States","USA",2021-01-03,2021-01-09,7,2021,"1",328300544,86972,21036,59606,27366,65936,6.40754344896852,8.33565478344136,0.459114854209308
"United States","United States","USA",2021-01-10,2021-01-16,7,2021,"2",328300544,87316,23481,60120,27196,63835,7.15228787436916,8.28387296245235,0.452361942781105
"United States","United States","USA",2021-01-17,2021-01-23,7,2021,"3",328300544,83527,21264,60198,23329,62263,6.47699200888318,7.10598883442606,0.387537791953221
"United States","United States","USA",2021-01-24,2021-01-30,7,2021,"4",328300544,79052,21666,60086,18966,57386,6.59944078557482,5.77702362869067,0.315647571813734
"United States","United States","USA",2021-01-31,2021-02-06,7,2021,"5",328300544,76376,22297,59810,16566,54079,6.79164272112811,5.04598615590475,0.276977094131416
"United States","United States","USA",2021-02-07,2021-02-13,7,2021,"6",328300544,71408,21567,59311,12097,49841,6.5692854898224,3.68473346178799,0.203958793478444
"United States","United States","USA",2021-02-14,2021-02-20,7,2021,"7",328300544,69421,13294,58871,10550,56127,4.04933840133996,3.21351889078807,0.179205381257325
"United States","United States","USA",2021-02-21,2021-02-27,7,2021,"8",328300544,66637,14410,58598,8039,52227,4.38927082618541,2.44867093488581,0.137188982559132
"United States","United States","USA",2021-02-28,2021-03-06,7,2021,"9",328300544,63486,12196,58250,5236,51290,3.71488875754041,1.59488008646126,0.0898884120171675
"United States","United States","USA",2021-03-07,2021-03-13,7,2021,"10",328300544,61636,9435,57902,3734,52201,2.87389106488962,1.13737246807608,0.064488273289351
"United States","United States","USA",2021-03-14,2021-03-20,7,2021,"11",328300544,60511,7181,57456,3055,53330,2.18732503836485,0.930549783067067,0.0531711222500697
"United States","United States","USA",2021-03-21,2021-03-27,7,2021,"12",328300544,60924,7145,57046,3878,53779,2.17635947627306,1.18123471644324,0.0679802264838902
"United States","United States","USA",2021-03-28,2021-04-03,7,2021,"13",328300544,58363,9679,56613,1750,48684,2.94821320795618,0.533048157239727,0.0309116280712911
"United States","United States","USA",2021-04-04,2021-04-10,7,2021,"14",317812460,59107,6723,54160,4947,52384,2.11539849633334,1.55657836700298,0.0913404726735598
"United States","United States","USA",2021-04-11,2021-04-17,7,2021,"15",317812460,57345,5026,53747,3598,52319,1.58143579392702,1.13211420345194,0.066943271252349
"United States","United States","USA",2021-04-18,2021-04-24,7,2021,"16",317812460,58440,4670,53270,5170,53770,1.46942004728197,1.626745534143,0.0970527501407923
"United States","United States","USA",2021-04-25,2021-05-01,7,2021,"17",317812460,57918,4644,52713,5205,53274,1.4612391219652,1.63775831822327,0.0987422457458311
"United States","United States","USA",2021-05-02,2021-05-08,7,2021,"18",317812460,57048,4440,52255,4793,52608,1.3970503233259,1.50812211704978,0.091723280068893
"United States","United States","USA",2021-05-09,2021-05-15,7,2021,"19",317812460,56634,4068,51897,4737,52566,1.2800001611013,1.49050166252135,0.0912769524249957
"United States","United States","USA",2021-05-16,2021-05-22,7,2021,"20",317812460,56971,3934,51576,5395,53037,1.23783693062254,1.69754200323046,0.104602916085001
"United States","United States","USA",2021-05-23,2021-05-29,7,2021,"21",317812460,55419,4107,51238,4181,51312,1.29227154907646,1.31555572113189,0.0815995940512901
"United States","United States","USA",2021-05-30,2021-06-05,7,2021,"22",317080915,55474,2883,50883,4591,52591,0.909231638870476,1.44789540549926,0.0902265982744728
"United States","United States","USA",2021-06-06,2021-06-12,7,2021,"23",317080915,55165,2652,50876,4289,52513,0.836379572072321,1.35265157791033,0.0843030112430223
"United States","United States","USA",2021-06-13,2021-06-19,7,2021,"24",317812460,55307,2149,50924,4383,53158,0.676184942528685,1.37911521782374,0.0860694368077921
"United States","United States","USA",2021-06-20,2021-06-26,7,2021,"25",317080915,55013,2115,50861,4152,52898,0.667022170035052,1.30944494089151,0.0816342580759324
"United States","United States","USA",2021-06-27,2021-07-03,7,2021,"26",317812460,55568,1691,50723,4845,53877,0.532074796563986,1.52448396768333,0.0955187981783412
"United States","United States","USA",2021-07-04,2021-07-10,7,2021,"27",317812460,55260,1581,50560,4700,53679,0.497463189454561,1.47885957649363,0.0929588607594938
"United States","United States","USA",2021-07-11,2021-07-17,7,2021,"28",317812460,55119,1796,50429,4690,53323,0.565113148804801,1.47571306675641,0.0930020424755598
"United States","United States","USA",2021-07-18,2021-07-24,7,2021,"29",328300544,57241,1871,52222,5019,55370,0.569904629826017,1.52878211496354,0.0961089196124238
"United States","United States","USA",2021-07-25,2021-07-31,7,2021,"30",326508397,58412,2332,51751,6661,56080,0.714223591621749,2.04007004450792,0.128712488647562
"United States","United States","USA",2021-08-01,2021-08-07,7,2021,"31",322943110,60441,3569,51006,9435,56872,1.10514821015999,2.92156720730162,0.18497823785437
"United States","United States","USA",2021-08-08,2021-08-14,7,2021,"32",322943110,62277,4106,50820,11457,58171,1.27143136758669,3.54768367716531,0.225442739079103
"United States","United States","USA",2021-08-15,2021-08-21,7,2021,"33",312455026,60132,825,49259,10873,59307,0.264037999503967,3.47986081043228,0.220731236931322
