"country","region","region_code","start_date","end_date","days","year","week","population","total_deaths","covid_deaths","expected_deaths","excess_deaths","non_covid_deaths","covid_deaths_per_100k","excess_deaths_per_100k","excess_deaths_pct_change"
"United States","Alabama","AL",2019-12-29,2020-01-04,7,2020,"1",4903185,1082,0,1150,-68,1082,0,-1.38685364717016,-0.0591304347826087
"United States","Alabama","AL",2020-01-05,2020-01-11,7,2020,"2",4903185,1127,0,1168,-41,1127,0,-0.8361911696173,-0.0351027397260274
"United States","Alabama","AL",2020-01-12,2020-01-18,7,2020,"3",4903185,1039,0,1151,-112,1039,0,-2.28422953651555,-0.0973066898349262
"United States","Alabama","AL",2020-01-19,2020-01-25,7,2020,"4",4903185,1056,0,1140,-84,1056,0,-1.71317215238666,-0.0736842105263158
"United States","Alabama","AL",2020-01-26,2020-02-01,7,2020,"5",4903185,1026,0,1137,-111,1026,0,-2.26383462993952,-0.0976253298153035
"United States","Alabama","AL",2020-02-02,2020-02-08,7,2020,"6",4903185,1120,0,1150,-30,1120,0,-0.611847197280951,-0.0260869565217391
"United States","Alabama","AL",2020-02-09,2020-02-15,7,2020,"7",4903185,1095,0,1142,-47,1095,0,-0.95856060907349,-0.0411558669001751
"United States","Alabama","AL",2020-02-16,2020-02-22,7,2020,"8",4903185,1098,0,1130,-32,1098,0,-0.652637010433014,-0.0283185840707965
"United States","Alabama","AL",2020-02-23,2020-02-29,7,2020,"9",4903185,1164,0,1108,56,1164,0,1.14211476825778,0.0505415162454874
"United States","Alabama","AL",2020-03-01,2020-03-07,7,2020,"10",4903185,1057,0,1103,-46,1057,0,-0.938165702497458,-0.041704442429737
"United States","Alabama","AL",2020-03-08,2020-03-14,7,2020,"11",4903185,1091,0,1093,-2,1091,0,-0.0407898131520634,-0.00182982616651417
"United States","Alabama","AL",2020-03-15,2020-03-21,7,2020,"12",4903185,1059,0,1088,-29,1059,0,-0.591452290704919,-0.0266544117647058
"United States","Alabama","AL",2020-03-22,2020-03-28,7,2020,"13",4903185,1073,3,1078,-5,1070,0.0611847197280951,-0.101974532880159,-0.00463821892393323
"United States","Alabama","AL",2020-03-29,2020-04-04,7,2020,"14",4903185,1156,23,1061,95,1133,0.469082851248729,1.93751612472301,0.0895381715362866
"United States","Alabama","AL",2020-04-05,2020-04-11,7,2020,"15",4903185,1135,34,1050,85,1101,0.693426823585078,1.73356705896269,0.0809523809523809
"United States","Alabama","AL",2020-04-12,2020-04-18,7,2020,"16",4903185,1149,50,1049,100,1099,1.01974532880158,2.03949065760317,0.0953288846520495
"United States","Alabama","AL",2020-04-19,2020-04-25,7,2020,"17",4903185,1139,102,1039,100,1037,2.08028047075523,2.03949065760317,0.0962463907603466
"United States","Alabama","AL",2020-04-26,2020-05-02,7,2020,"18",4903185,1147,75,1031,116,1072,1.52961799320238,2.36580916281968,0.112512124151309
"United States","Alabama","AL",2020-05-03,2020-05-09,7,2020,"19",4903185,1171,101,1019,152,1070,2.0598855641792,3.10002579955682,0.149165848871443
"United States","Alabama","AL",2020-05-10,2020-05-16,7,2020,"20",4903185,1148,94,1015,133,1054,1.91712121814698,2.71252257461222,0.131034482758621
"United States","Alabama","AL",2020-05-17,2020-05-23,7,2020,"21",4903185,1153,69,1009,144,1084,1.40724855374619,2.93686654694856,0.142715559960357
"United States","Alabama","AL",2020-05-24,2020-05-30,7,2020,"22",4903185,1109,67,1022,87,1042,1.36645874059412,1.77435687211476,0.0851272015655578
"United States","Alabama","AL",2020-05-31,2020-06-06,7,2020,"23",4903185,1173,66,1000,173,1107,1.34606383401809,3.52831883765348,0.173
"United States","Alabama","AL",2020-06-07,2020-06-13,7,2020,"24",4903185,1138,84,989,149,1054,1.71317215238666,3.03884107982872,0.150657229524773
"United States","Alabama","AL",2020-06-14,2020-06-20,7,2020,"25",4903185,1090,70,978,112,1020,1.42764346032222,2.28422953651555,0.114519427402863
"United States","Alabama","AL",2020-06-21,2020-06-27,7,2020,"26",4903185,1151,81,975,176,1070,1.65198743265857,3.58950355738158,0.180512820512821
"United States","Alabama","AL",2020-06-28,2020-07-04,7,2020,"27",4903185,1201,88,983,218,1113,1.79475177869079,4.44608963357491,0.22177009155646
"United States","Alabama","AL",2020-07-05,2020-07-11,7,2020,"28",4903185,1265,107,979,286,1158,2.18225500363539,5.83294328074507,0.292134831460674
"United States","Alabama","AL",2020-07-12,2020-07-18,7,2020,"29",4903185,1289,172,966,323,1117,3.50792393107745,6.58755482405824,0.334368530020704
"United States","Alabama","AL",2020-07-19,2020-07-25,7,2020,"30",4903185,1333,170,963,370,1163,3.46713411792539,7.54611543313173,0.384215991692627
"United States","Alabama","AL",2020-07-26,2020-08-01,7,2020,"31",4903185,1364,147,957,407,1217,2.99805126667666,8.3007269764449,0.425287356321839
"United States","Alabama","AL",2020-08-02,2020-08-08,7,2020,"32",4903185,1379,165,953,426,1214,3.36515958504523,8.6882302013895,0.44700944386149
"United States","Alabama","AL",2020-08-09,2020-08-15,7,2020,"33",4903185,1305,128,951,354,1177,2.61054804173206,7.21979692791522,0.372239747634069
"United States","Alabama","AL",2020-08-16,2020-08-22,7,2020,"34",4903185,1303,115,953,350,1188,2.34541425624365,7.1382173016111,0.367261280167891
"United States","Alabama","AL",2020-08-23,2020-08-29,7,2020,"35",4903185,1216,141,949,267,1075,2.87568182722047,5.44544005580046,0.281348788198103
"United States","Alabama","AL",2020-08-30,2020-09-05,7,2020,"36",4903185,1216,123,956,260,1093,2.5085735088519,5.30267570976824,0.271966527196653
"United States","Alabama","AL",2020-09-06,2020-09-12,7,2020,"37",4903185,1232,75,963,269,1157,1.52961799320238,5.48622986895253,0.279335410176532
"United States","Alabama","AL",2020-09-13,2020-09-19,7,2020,"38",4903185,1200,87,972,228,1113,1.77435687211476,4.65003869933523,0.234567901234568
"United States","Alabama","AL",2020-09-20,2020-09-26,7,2020,"39",4903185,1183,64,974,209,1119,1.30527402086603,4.26253547439063,0.214579055441478
"United States","Alabama","AL",2020-09-27,2020-10-03,7,2020,"40",4903185,1103,57,982,121,1046,1.16250967483381,2.46778369569984,0.123217922606925
"United States","Alabama","AL",2020-10-04,2020-10-10,7,2020,"41",4903185,1204,106,980,224,1098,2.16186009705936,4.5684590730311,0.228571428571429
"United States","Alabama","AL",2020-10-11,2020-10-17,7,2020,"42",4903185,1190,124,973,217,1066,2.52896841542793,4.42569472699888,0.223021582733813
"United States","Alabama","AL",2020-10-18,2020-10-24,7,2020,"43",4903185,1142,78,971,171,1064,1.59080271293047,3.48752902450142,0.17610710607621
"United States","Alabama","AL",2020-10-25,2020-10-31,7,2020,"44",4903185,1169,98,985,184,1071,1.99870084445111,3.75266280998983,0.186802030456853
"United States","Alabama","AL",2020-11-01,2020-11-07,7,2020,"45",4903185,1277,115,991,286,1162,2.34541425624365,5.83294328074507,0.288597376387487
"United States","Alabama","AL",2020-11-08,2020-11-14,7,2020,"46",4903185,1269,165,1004,265,1104,3.36515958504523,5.4046502426484,0.26394422310757
"United States","Alabama","AL",2020-11-15,2020-11-21,7,2020,"47",4903185,1275,211,1030,245,1064,4.30332528754269,4.99675211112777,0.237864077669903
"United States","Alabama","AL",2020-11-22,2020-11-28,7,2020,"48",4903185,1326,115,1045,281,1211,2.34541425624365,5.73096874786491,0.268899521531101
"United States","Alabama","AL",2020-11-29,2020-12-05,7,2020,"49",4903185,1355,304,1057,298,1051,6.20005159911364,6.07768215965745,0.281929990539262
"United States","Alabama","AL",2020-12-06,2020-12-12,7,2020,"50",4903185,1598,205,1082,516,1393,4.1809558480865,10.5237717932324,0.476894639556377
"United States","Alabama","AL",2020-12-13,2020-12-19,7,2020,"51",4903185,1584,310,1098,486,1274,6.32242103856983,9.91192459595141,0.442622950819672
"United States","Alabama","AL",2020-12-20,2020-12-26,7,2020,"52",4903185,1626,294,1109,517,1332,5.99610253335332,10.5441666998084,0.466185752930568
"United States","Alabama","AL",2020-12-27,2021-01-02,7,2020,"53",4903185,1801,188,1124,677,1613,3.83424243629396,13.8073517519735,0.602313167259787
"United States","Alabama","AL",2021-01-03,2021-01-09,7,2021,"1",4903185,1803,428,1127,676,1375,8.72902001454157,13.7869568453974,0.599822537710736
"United States","Alabama","AL",2021-01-10,2021-01-16,7,2021,"2",4903185,1829,819,1127,702,1010,16.70342848577,14.3172244163743,0.622892635314996
"United States","Alabama","AL",2021-01-17,2021-01-23,7,2021,"3",4903185,1790,539,1132,658,1251,10.9928546444811,13.4198485270289,0.581272084805654
"United States","Alabama","AL",2021-01-24,2021-01-30,7,2021,"4",4903185,1642,909,1124,518,733,18.5389700776128,10.5645616063844,0.46085409252669
"United States","Alabama","AL",2021-01-31,2021-02-06,7,2021,"5",4903185,1510,956,1115,395,554,19.4975306866863,8.05598809753252,0.354260089686099
"United States","Alabama","AL",2021-02-07,2021-02-13,7,2021,"6",4903185,1425,722,1114,311,703,14.7251225478949,6.34281594514586,0.279174147217235
"United States","Alabama","AL",2021-02-14,2021-02-20,7,2021,"7",4903185,1335,347,1105,230,988,7.077032581883,4.69082851248729,0.20814479638009
"United States","Alabama","AL",2021-02-21,2021-02-27,7,2021,"8",4903185,1315,343,1084,231,972,6.99545295557887,4.71122341906332,0.21309963099631
"United States","Alabama","AL",2021-02-28,2021-03-06,7,2021,"9",4903185,1159,218,1083,76,941,4.44608963357491,1.55001289977841,0.0701754385964912
"United States","Alabama","AL",2021-03-07,2021-03-13,7,2021,"10",4903185,1184,181,1080,104,1003,3.69147809026174,2.1210702839073,0.0962962962962963
"United States","Alabama","AL",2021-03-14,2021-03-20,7,2021,"11",4903185,1055,108,1065,-10,947,2.20264991021142,-0.203949065760317,-0.00938967136150237
"United States","Alabama","AL",2021-03-21,2021-03-27,7,2021,"12",4903185,1186,89,1067,119,1097,1.81514668526682,2.42699388254777,0.111527647610122
"United States","Alabama","AL",2021-03-28,2021-04-03,7,2021,"13",4903185,1103,110,1044,59,993,2.24343972336349,1.20329948798587,0.0565134099616857
"United States","Alabama","AL",2021-04-04,2021-04-10,7,2021,"14",4903185,1199,72,1044,155,1127,1.46843327347428,3.16121051928491,0.148467432950192
"United States","Alabama","AL",2021-04-11,2021-04-17,7,2021,"15",4903185,1161,78,1037,124,1083,1.59080271293047,2.52896841542793,0.119575699132112
"United States","Alabama","AL",2021-04-18,2021-04-24,7,2021,"16",4903185,1104,61,1024,80,1043,1.24408930113793,1.63159252608254,0.078125
"United States","Alabama","AL",2021-04-25,2021-05-01,7,2021,"17",4903185,1195,62,1017,178,1133,1.26448420771397,3.63029337053364,0.175024582104228
"United States","Alabama","AL",2021-05-02,2021-05-08,7,2021,"18",4903185,1149,65,1016,133,1084,1.32566892744206,2.71252257461222,0.130905511811024
"United States","Alabama","AL",2021-05-09,2021-05-15,7,2021,"19",4903185,1088,60,1014,74,1028,1.2236943945619,1.50922308662635,0.0729783037475344
"United States","Alabama","AL",2021-05-16,2021-05-22,7,2021,"20",4903185,1085,74,1017,68,1011,1.50922308662635,1.38685364717016,0.0668633235004916
"United States","Alabama","AL",2021-05-23,2021-05-29,7,2021,"21",4903185,1073,34,1013,60,1039,0.693426823585078,1.2236943945619,0.0592300098716683
"United States","Alabama","AL",2021-05-30,2021-06-05,7,2021,"22",4903185,1050,52,1002,48,998,1.06053514195365,0.978955515649522,0.0479041916167664
"United States","Alabama","AL",2021-06-06,2021-06-12,7,2021,"23",4903185,1062,68,995,67,994,1.38685364717016,1.36645874059412,0.0673366834170854
"United States","Alabama","AL",2021-06-13,2021-06-19,7,2021,"24",4903185,1017,40,996,21,977,0.815796263041268,0.428293038096666,0.0210843373493976
"United States","Alabama","AL",2021-06-20,2021-06-26,7,2021,"25",4903185,781,30,996,-215,751,0.611847197280951,-4.38490491384682,-0.215863453815261
"United States","Alaska","AK",2019-12-29,2020-01-04,7,2020,"1",731545,89,0,87,2,89,0,0.273393981231503,0.0229885057471264
"United States","Alaska","AK",2020-01-05,2020-01-11,7,2020,"2",731545,105,0,84,21,105,0,2.87063680293078,0.25
"United States","Alaska","AK",2020-01-12,2020-01-18,7,2020,"3",731545,99,0,86,13,99,0,1.77706087800477,0.151162790697674
"United States","Alaska","AK",2020-01-19,2020-01-25,7,2020,"4",731545,97,0,83,14,97,0,1.91375786862052,0.168674698795181
"United States","Alaska","AK",2020-01-26,2020-02-01,7,2020,"5",731545,85,0,80,5,85,0,0.683484953078758,0.0625
"United States","Alaska","AK",2020-02-02,2020-02-08,7,2020,"6",731545,92,0,78,14,92,0,1.91375786862052,0.17948717948718
"United States","Alaska","AK",2020-02-09,2020-02-15,7,2020,"7",731545,89,0,76,13,89,0,1.77706087800477,0.171052631578947
"United States","Alaska","AK",2020-02-16,2020-02-22,7,2020,"8",731545,83,0,76,7,83,0,0.956878934310261,0.0921052631578947
"United States","Alaska","AK",2020-02-23,2020-02-29,7,2020,"9",731545,84,0,80,4,84,0,0.546787962463006,0.05
"United States","Alaska","AK",2020-03-01,2020-03-07,7,2020,"10",731545,79,0,80,-1,79,0,-0.136696990615752,-0.0125
"United States","Alaska","AK",2020-03-08,2020-03-14,7,2020,"11",731545,92,0,79,13,92,0,1.77706087800477,0.164556962025316
"United States","Alaska","AK",2020-03-15,2020-03-21,7,2020,"12",731545,69,0,82,-13,69,0,-1.77706087800477,-0.158536585365854
"United States","Alaska","AK",2020-03-22,2020-03-28,7,2020,"13",731545,86,2,81,5,84,0.273393981231503,0.683484953078758,0.0617283950617284
"United States","Alaska","AK",2020-03-29,2020-04-04,7,2020,"14",731545,98,3,85,13,95,0.410090971847255,1.77706087800477,0.152941176470588
"United States","Alaska","AK",2020-04-05,2020-04-11,7,2020,"15",731545,84,3,83,1,81,0.410090971847255,0.136696990615752,0.0120481927710843
"United States","Alaska","AK",2020-04-12,2020-04-18,7,2020,"16",731545,80,1,84,-4,79,0.136696990615752,-0.546787962463006,-0.0476190476190477
"United States","Alaska","AK",2020-04-19,2020-04-25,7,2020,"17",731545,61,0,81,-20,61,0,-2.73393981231503,-0.246913580246914
"United States","Alaska","AK",2020-04-26,2020-05-02,7,2020,"18",731545,87,0,79,8,87,0,1.09357592492601,0.10126582278481
"United States","Alaska","AK",2020-05-03,2020-05-09,7,2020,"19",731545,89,1,77,12,88,0.136696990615752,1.64036388738902,0.155844155844156
"United States","Alaska","AK",2020-05-10,2020-05-16,7,2020,"20",731545,84,0,76,8,84,0,1.09357592492601,0.105263157894737
"United States","Alaska","AK",2020-05-17,2020-05-23,7,2020,"21",731545,82,0,76,6,82,0,0.82018194369451,0.0789473684210527
"United States","Alaska","AK",2020-05-24,2020-05-30,7,2020,"22",731545,97,0,79,18,97,0,2.46054583108353,0.227848101265823
"United States","Alaska","AK",2020-05-31,2020-06-06,7,2020,"23",731545,79,0,82,-3,79,0,-0.410090971847255,-0.0365853658536586
"United States","Alaska","AK",2020-06-07,2020-06-13,7,2020,"24",731545,88,2,81,7,86,0.273393981231503,0.956878934310261,0.0864197530864197
"United States","Alaska","AK",2020-06-14,2020-06-20,7,2020,"25",731545,92,0,84,8,92,0,1.09357592492601,0.0952380952380953
"United States","Alaska","AK",2020-06-21,2020-06-27,7,2020,"26",731545,90,0,87,3,90,0,0.410090971847255,0.0344827586206897
"United States","Alaska","AK",2020-06-28,2020-07-04,7,2020,"27",731545,84,2,87,-3,82,0.273393981231503,-0.410090971847255,-0.0344827586206896
"United States","Alaska","AK",2020-07-05,2020-07-11,7,2020,"28",731545,101,0,85,16,101,0,2.18715184985203,0.188235294117647
"United States","Alaska","AK",2020-07-12,2020-07-18,7,2020,"29",731545,89,4,88,1,85,0.546787962463006,0.136696990615752,0.0113636363636365
"United States","Alaska","AK",2020-07-19,2020-07-25,7,2020,"30",731545,93,2,86,7,91,0.273393981231503,0.956878934310261,0.0813953488372092
"United States","Alaska","AK",2020-07-26,2020-08-01,7,2020,"31",731545,114,4,84,30,110,0.546787962463006,4.10090971847255,0.357142857142857
"United States","Alaska","AK",2020-08-02,2020-08-08,7,2020,"32",731545,101,2,85,16,99,0.273393981231503,2.18715184985203,0.188235294117647
"United States","Alaska","AK",2020-08-09,2020-08-15,7,2020,"33",731545,74,2,86,-12,72,0.273393981231503,-1.64036388738902,-0.13953488372093
"United States","Alaska","AK",2020-08-16,2020-08-22,7,2020,"34",731545,116,3,86,30,113,0.410090971847255,4.10090971847255,0.348837209302326
"United States","Alaska","AK",2020-08-23,2020-08-29,7,2020,"35",731545,93,6,88,5,87,0.82018194369451,0.683484953078758,0.0568181818181819
"United States","Alaska","AK",2020-08-30,2020-09-05,7,2020,"36",731545,105,5,89,16,100,0.683484953078758,2.18715184985203,0.179775280898876
"United States","Alaska","AK",2020-09-06,2020-09-12,7,2020,"37",731545,87,2,87,0,85,0.273393981231503,0,0
"United States","Alaska","AK",2020-09-13,2020-09-19,7,2020,"38",731545,104,1,88,16,103,0.136696990615752,2.18715184985203,0.181818181818182
"United States","Alaska","AK",2020-09-20,2020-09-26,7,2020,"39",731545,114,7,90,24,107,0.956878934310261,3.28072777477804,0.266666666666667
"United States","Alaska","AK",2020-09-27,2020-10-03,7,2020,"40",731545,78,6,91,-13,72,0.82018194369451,-1.77706087800477,-0.142857142857143
"United States","Alaska","AK",2020-10-04,2020-10-10,7,2020,"41",731545,117,2,93,24,115,0.273393981231503,3.28072777477804,0.258064516129032
"United States","Alaska","AK",2020-10-11,2020-10-17,7,2020,"42",731545,101,7,93,8,94,0.956878934310261,1.09357592492601,0.086021505376344
"United States","Alaska","AK",2020-10-18,2020-10-24,7,2020,"43",731545,102,1,90,12,101,0.136696990615752,1.64036388738902,0.133333333333333
"United States","Alaska","AK",2020-10-25,2020-10-31,7,2020,"44",731545,107,14,89,18,93,1.91375786862052,2.46054583108353,0.202247191011236
"United States","Alaska","AK",2020-11-01,2020-11-07,7,2020,"45",731545,114,1,89,25,113,0.136696990615752,3.41742476539379,0.280898876404494
"United States","Alaska","AK",2020-11-08,2020-11-14,7,2020,"46",731545,114,13,89,25,101,1.77706087800477,3.41742476539379,0.280898876404494
"United States","Alaska","AK",2020-11-15,2020-11-21,7,2020,"47",731545,122,0,90,32,122,0,4.37430369970405,0.355555555555556
"United States","Alaska","AK",2020-11-22,2020-11-28,7,2020,"48",731545,114,0,95,19,114,0,2.59724282169928,0.2
"United States","Alaska","AK",2020-11-29,2020-12-05,7,2020,"49",731545,118,0,98,20,118,0,2.73393981231503,0.204081632653061
"United States","Alaska","AK",2020-12-06,2020-12-12,7,2020,"50",731545,135,72,98,37,63,9.84218332433411,5.05778865278281,0.377551020408163
"United States","Alaska","AK",2020-12-13,2020-12-19,7,2020,"51",731545,99,7,100,-1,92,0.956878934310261,-0.136696990615752,-0.01
"United States","Alaska","AK",2020-12-20,2020-12-26,7,2020,"52",731545,115,16,100,15,99,2.18715184985203,2.05045485923627,0.15
"United States","Alaska","AK",2020-12-27,2021-01-02,7,2020,"53",731545,105,15,101,4,90,2.05045485923627,0.546787962463006,0.0396039603960396
"United States","Alaska","AK",2021-01-03,2021-01-09,7,2021,"1",731545,111,8,102,9,103,1.09357592492601,1.23027291554176,0.088235294117647
"United States","Alaska","AK",2021-01-10,2021-01-16,7,2021,"2",731545,131,5,103,28,126,0.683484953078758,3.82751573724104,0.271844660194175
"United States","Alaska","AK",2021-01-17,2021-01-23,7,2021,"3",731545,98,29,102,-4,69,3.9642127278568,-0.546787962463006,-0.0392156862745098
"United States","Alaska","AK",2021-01-24,2021-01-30,7,2021,"4",731545,91,3,101,-10,88,0.410090971847255,-1.36696990615752,-0.099009900990099
"United States","Alaska","AK",2021-01-31,2021-02-06,7,2021,"5",731545,88,16,97,-9,72,2.18715184985203,-1.23027291554176,-0.0927835051546392
"United States","Alaska","AK",2021-02-07,2021-02-13,7,2021,"6",731545,94,2,95,-1,92,0.273393981231503,-0.136696990615752,-0.0105263157894737
"United States","Alaska","AK",2021-02-14,2021-02-20,7,2021,"7",731545,87,8,95,-8,79,1.09357592492601,-1.09357592492601,-0.0842105263157895
"United States","Alaska","AK",2021-02-21,2021-02-27,7,2021,"8",731545,91,1,95,-4,90,0.136696990615752,-0.546787962463006,-0.0421052631578948
"United States","Alaska","AK",2021-02-28,2021-03-06,7,2021,"9",731545,98,12,93,5,86,1.64036388738902,0.683484953078758,0.053763440860215
"United States","Alaska","AK",2021-03-07,2021-03-13,7,2021,"10",731545,82,1,95,-13,81,0.136696990615752,-1.77706087800477,-0.136842105263158
"United States","Alaska","AK",2021-03-14,2021-03-20,7,2021,"11",731545,99,4,93,6,95,0.546787962463006,0.82018194369451,0.064516129032258
"United States","Alaska","AK",2021-03-21,2021-03-27,7,2021,"12",731545,88,3,92,-4,85,0.410090971847255,-0.546787962463006,-0.0434782608695652
"United States","Alaska","AK",2021-03-28,2021-04-03,7,2021,"13",731545,78,0,91,-13,78,0,-1.77706087800477,-0.142857142857143
"United States","Alaska","AK",2021-04-04,2021-04-10,7,2021,"14",731545,88,11,92,-4,77,1.50366689677327,-0.546787962463006,-0.0434782608695652
"United States","Alaska","AK",2021-04-11,2021-04-17,7,2021,"15",731545,78,20,93,-15,58,2.73393981231503,-2.05045485923627,-0.161290322580645
"United States","Alaska","AK",2021-04-18,2021-04-24,7,2021,"16",731545,63,0,93,-30,63,0,-4.10090971847255,-0.32258064516129
"United States","Alaska","AK",2021-04-25,2021-05-01,7,2021,"17",731545,72,12,93,-21,60,1.64036388738902,-2.87063680293078,-0.225806451612903
"United States","Arizona","AZ",2019-12-29,2020-01-04,7,2020,"1",7278717,1301,0,1304,-3,1301,0,-0.0412160549723255,-0.00230061349693256
"United States","Arizona","AZ",2020-01-05,2020-01-11,7,2020,"2",7278717,1391,0,1324,67,1391,0,0.920491894381936,0.0506042296072509
"United States","Arizona","AZ",2020-01-12,2020-01-18,7,2020,"3",7278717,1315,0,1326,-11,1315,0,-0.151125534898527,-0.00829562594268474
"United States","Arizona","AZ",2020-01-19,2020-01-25,7,2020,"4",7278717,1275,0,1323,-48,1275,0,-0.659456879557208,-0.036281179138322
"United States","Arizona","AZ",2020-01-26,2020-02-01,7,2020,"5",7278717,1265,0,1326,-61,1265,0,-0.838059784437285,-0.0460030165912518
"United States","Arizona","AZ",2020-02-02,2020-02-08,7,2020,"6",7278717,1264,0,1320,-56,1264,0,-0.769366359483409,-0.0424242424242425
"United States","Arizona","AZ",2020-02-09,2020-02-15,7,2020,"7",7278717,1314,0,1315,-1,1314,0,-0.0137386849907752,-0.000760456273764309
"United States","Arizona","AZ",2020-02-16,2020-02-22,7,2020,"8",7278717,1342,0,1301,41,1342,0,0.563286084621782,0.0315142198308993
"United States","Arizona","AZ",2020-02-23,2020-02-29,7,2020,"9",7278717,1353,0,1303,50,1353,0,0.686934249538758,0.0383729854182655
"United States","Arizona","AZ",2020-03-01,2020-03-07,7,2020,"10",7278717,1380,0,1314,66,1380,0,0.906753209391161,0.0502283105022832
"United States","Arizona","AZ",2020-03-08,2020-03-14,7,2020,"11",7278717,1349,0,1324,25,1349,0,0.343467124769379,0.0188821752265862
"United States","Arizona","AZ",2020-03-15,2020-03-21,7,2020,"12",7278717,1290,1,1316,-26,1289,0.0137386849907752,-0.357205809760154,-0.0197568389057751
"United States","Arizona","AZ",2020-03-22,2020-03-28,7,2020,"13",7278717,1324,14,1298,26,1310,0.192341589870852,0.357205809760154,0.0200308166409862
"United States","Arizona","AZ",2020-03-29,2020-04-04,7,2020,"14",7278717,1357,37,1288,69,1320,0.508331344658681,0.947969264363486,0.0535714285714286
"United States","Arizona","AZ",2020-04-05,2020-04-11,7,2020,"15",7278717,1403,56,1278,125,1347,0.769366359483409,1.7173356238469,0.0978090766823161
"United States","Arizona","AZ",2020-04-12,2020-04-18,7,2020,"16",7278717,1316,68,1268,48,1248,0.934230579372711,0.659456879557208,0.0378548895899053
"United States","Arizona","AZ",2020-04-19,2020-04-25,7,2020,"17",7278717,1384,96,1249,135,1288,1.31891375911442,1.85472247375465,0.10808646917534
"United States","Arizona","AZ",2020-04-26,2020-05-02,7,2020,"18",7278717,1404,74,1224,180,1330,1.01666268931736,2.47296329833953,0.147058823529412
"United States","Arizona","AZ",2020-05-03,2020-05-09,7,2020,"19",7278717,1427,183,1214,213,1244,2.51417935331185,2.92633990303511,0.175453047775947
"United States","Arizona","AZ",2020-05-10,2020-05-16,7,2020,"20",7278717,1306,147,1196,110,1159,2.01958669364395,1.51125534898527,0.0919732441471572
"United States","Arizona","AZ",2020-05-17,2020-05-23,7,2020,"21",7278717,1289,119,1187,102,1170,1.63490351390224,1.40134586905907,0.0859309182813817
"United States","Arizona","AZ",2020-05-24,2020-05-30,7,2020,"22",7278717,1310,101,1180,130,1209,1.38760718406829,1.78602904880077,0.110169491525424
"United States","Arizona","AZ",2020-05-31,2020-06-06,7,2020,"23",7278717,1399,139,1171,228,1260,1.90967721371775,3.13242017789674,0.194705380017079
"United States","Arizona","AZ",2020-06-07,2020-06-13,7,2020,"24",7278717,1463,148,1179,284,1315,2.03332537863472,3.90178653738015,0.240882103477523
"United States","Arizona","AZ",2020-06-14,2020-06-20,7,2020,"25",7278717,1550,154,1197,353,1396,2.11575748857937,4.84975580174363,0.294903926482874
"United States","Arizona","AZ",2020-06-21,2020-06-27,7,2020,"26",7278717,1617,242,1189,428,1375,3.32476176776759,5.88015717605177,0.359966358284272
"United States","Arizona","AZ",2020-06-28,2020-07-04,7,2020,"27",7278717,1774,226,1176,598,1548,3.10494280791519,8.21573362448355,0.508503401360544
"United States","Arizona","AZ",2020-07-05,2020-07-11,7,2020,"28",7278717,1953,346,1173,780,1607,4.7535850068082,10.7161742928046,0.664961636828644
"United States","Arizona","AZ",2020-07-12,2020-07-18,7,2020,"29",7278717,1995,579,1172,823,1416,7.95469860965882,11.306937747408,0.70221843003413
"United States","Arizona","AZ",2020-07-19,2020-07-25,7,2020,"30",7278717,1863,556,1162,701,1307,7.63870885487099,9.63081817853339,0.603270223752151
"United States","Arizona","AZ",2020-07-26,2020-08-01,7,2020,"31",7278717,1792,461,1148,644,1331,6.33353378074735,8.8477131340592,0.560975609756098
"United States","Arizona","AZ",2020-08-02,2020-08-08,7,2020,"32",7278717,1586,390,1136,450,1196,5.35808714640231,6.18240824584882,0.39612676056338
"United States","Arizona","AZ",2020-08-09,2020-08-15,7,2020,"33",7278717,1526,355,1121,405,1171,4.87723317172518,5.56416742126394,0.36128456735058
"United States","Arizona","AZ",2020-08-16,2020-08-22,7,2020,"34",7278717,1505,264,1115,390,1241,3.62701283756464,5.35808714640231,0.349775784753363
"United States","Arizona","AZ",2020-08-23,2020-08-29,7,2020,"35",7278717,1467,251,1115,352,1216,3.44840993268456,4.83601711675286,0.315695067264574
"United States","Arizona","AZ",2020-08-30,2020-09-05,7,2020,"36",7278717,1296,200,1118,178,1096,2.74773699815503,2.44548592835798,0.159212880143113
"United States","Arizona","AZ",2020-09-06,2020-09-12,7,2020,"37",7278717,1282,108,1125,157,1174,1.48377797900372,2.1569735435517,0.139555555555556
"United States","Arizona","AZ",2020-09-13,2020-09-19,7,2020,"38",7278717,1259,152,1117,142,1107,2.08828011859782,1.95089326869007,0.127126230975828
"United States","Arizona","AZ",2020-09-20,2020-09-26,7,2020,"39",7278717,1285,155,1116,169,1130,2.12949617357015,2.321837763441,0.151433691756272
"United States","Arizona","AZ",2020-09-27,2020-10-03,7,2020,"40",7278717,1202,83,1115,87,1119,1.14031085423434,1.19526559419744,0.0780269058295964
"United States","Arizona","AZ",2020-10-04,2020-10-10,7,2020,"41",7278717,1241,54,1121,120,1187,0.741888989501859,1.64864219889302,0.107047279214987
"United States","Arizona","AZ",2020-10-11,2020-10-17,7,2020,"42",7278717,1236,65,1117,119,1171,0.893014524400385,1.63490351390224,0.106535362578335
"United States","Arizona","AZ",2020-10-18,2020-10-24,7,2020,"43",7278717,1282,45,1140,142,1237,0.618240824584882,1.95089326869007,0.124561403508772
"United States","Arizona","AZ",2020-10-25,2020-10-31,7,2020,"44",7278717,1312,109,1146,166,1203,1.49751666399449,2.28062170846868,0.144851657940663
"United States","Arizona","AZ",2020-11-01,2020-11-07,7,2020,"45",7278717,1399,169,1155,244,1230,2.321837763441,3.35223913774914,0.211255411255411
"United States","Arizona","AZ",2020-11-08,2020-11-14,7,2020,"46",7278717,1252,152,1167,85,1100,2.08828011859782,1.16778822421589,0.0728363324764354
"United States","Arizona","AZ",2020-11-15,2020-11-21,7,2020,"47",7278717,1525,157,1193,332,1368,2.1569735435517,4.56124341693735,0.278290025146689
"United States","Arizona","AZ",2020-11-22,2020-11-28,7,2020,"48",7278717,1531,168,1201,330,1363,2.30809907845023,4.5337660469558,0.274771024146545
"United States","Arizona","AZ",2020-11-29,2020-12-05,7,2020,"49",7278717,1696,301,1226,470,1395,4.13534418222332,6.45718194566432,0.383360522022838
"United States","Arizona","AZ",2020-12-06,2020-12-12,7,2020,"50",7278717,2004,397,1234,770,1607,5.45425794133774,10.5787874428969,0.623987034035656
"United States","Arizona","AZ",2020-12-13,2020-12-19,7,2020,"51",7278717,2098,615,1270,828,1483,8.44929126932672,11.3756311723618,0.651968503937008
"United States","Arizona","AZ",2020-12-20,2020-12-26,7,2020,"52",7278717,2205,34,1292,913,2171,0.467115289686355,12.5434193965777,0.706656346749226
"United States","Arizona","AZ",2020-12-27,2021-01-02,7,2020,"53",7278717,2301,1090,1334,967,1211,14.9751666399449,13.2853083860796,0.724887556221889
"United States","Arizona","AZ",2021-01-03,2021-01-09,7,2021,"1",7278717,2423,975,1347,1076,1448,13.3952178660058,14.7828250500741,0.798812175204157
"United States","Arizona","AZ",2021-01-10,2021-01-16,7,2021,"2",7278717,2465,1212,1358,1107,1253,16.6512862088195,15.2087242847881,0.815169366715758
"United States","Arizona","AZ",2021-01-17,2021-01-23,7,2021,"3",7278717,2407,922,1343,1064,1485,12.6670675614947,14.6179608301848,0.792256142963514
"United States","Arizona","AZ",2021-01-24,2021-01-30,7,2021,"4",7278717,2081,927,1328,753,1154,12.7357609864486,10.3452297980537,0.567018072289157
"United States","Arizona","AZ",2021-01-31,2021-02-06,7,2021,"5",7278717,1994,910,1316,678,1084,12.5022033416054,9.31482842374556,0.515197568389058
"United States","Arizona","AZ",2021-02-07,2021-02-13,7,2021,"6",7278717,1738,939,1282,456,799,12.9006252063379,6.26484035579347,0.355694227769111
"United States","Arizona","AZ",2021-02-14,2021-02-20,7,2021,"7",7278717,1558,533,1278,280,1025,7.32271910008316,3.84683179741705,0.219092331768388
"United States","Arizona","AZ",2021-02-21,2021-02-27,7,2021,"8",7278717,1523,501,1284,239,1022,6.88308118037836,3.28354571279526,0.18613707165109
"United States","Arizona","AZ",2021-02-28,2021-03-06,7,2021,"9",7278717,1501,289,1273,228,1212,3.97047996233402,3.13242017789674,0.17910447761194
"United States","Arizona","AZ",2021-03-07,2021-03-13,7,2021,"10",7278717,1417,284,1269,148,1133,3.90178653738015,2.03332537863472,0.116627265563436
"United States","Arizona","AZ",2021-03-14,2021-03-20,7,2021,"11",7278717,1397,139,1265,132,1258,1.90967721371775,1.81350641878232,0.104347826086957
"United States","Arizona","AZ",2021-03-21,2021-03-27,7,2021,"12",7278717,1295,226,1272,23,1069,3.10494280791519,0.315989754787829,0.0180817610062893
"United States","Arizona","AZ",2021-03-28,2021-04-03,7,2021,"13",7278717,1352,87,1255,97,1265,1.19526559419744,1.33265244410519,0.0772908366533864
"United States","Arizona","AZ",2021-04-04,2021-04-10,7,2021,"14",7278717,1279,81,1247,32,1198,1.11283348425279,0.439637919704805,0.0256615878107458
"United States","Arizona","AZ",2021-04-11,2021-04-17,7,2021,"15",7278717,1326,65,1236,90,1261,0.893014524400385,1.23648164916976,0.0728155339805825
"United States","Arizona","AZ",2021-04-18,2021-04-24,7,2021,"16",7278717,1257,117,1229,28,1140,1.60742614392069,0.384683179741704,0.0227827502034175
"United States","Arizona","AZ",2021-04-25,2021-05-01,7,2021,"17",7278717,1284,70,1207,77,1214,0.961707949354261,1.05787874428969,0.0637945318972659
"United States","Arizona","AZ",2021-05-02,2021-05-08,7,2021,"18",7278717,1430,69,1188,242,1361,0.947969264363486,3.32476176776759,0.203703703703704
"United States","Arizona","AZ",2021-05-09,2021-05-15,7,2021,"19",7278717,1335,59,1175,160,1276,0.810582414455735,2.19818959852403,0.136170212765957
"United States","Arizona","AZ",2021-05-16,2021-05-22,7,2021,"20",7278717,1265,81,1159,106,1184,1.11283348425279,1.45630060902217,0.0914581535806729
"United States","Arizona","AZ",2021-05-23,2021-05-29,7,2021,"21",7278717,1266,81,1155,111,1185,1.11283348425279,1.52499403397604,0.096103896103896
"United States","Arizona","AZ",2021-05-30,2021-06-05,7,2021,"22",7278717,1349,72,1161,188,1277,0.989185319335812,2.58287277826573,0.161929371231697
"United States","Arizona","AZ",2021-06-06,2021-06-12,7,2021,"23",7278717,1309,40,1167,142,1269,0.549547399631006,1.95089326869007,0.121679520137104
"United States","Arizona","AZ",2021-06-13,2021-06-19,7,2021,"24",7278717,1371,82,1166,205,1289,1.12657216924356,2.81643042310891,0.175814751286449
"United States","Arizona","AZ",2021-06-20,2021-06-26,7,2021,"25",7278717,1200,81,1174,26,1119,1.11283348425279,0.357205809760154,0.0221465076660987
"United States","Arkansas","AR",2019-12-29,2020-01-04,7,2020,"1",3017825,672,0,733,-61,672,0,-2.02132330403519,-0.0832196452933152
"United States","Arkansas","AR",2020-01-05,2020-01-11,7,2020,"2",3017825,686,0,723,-37,686,0,-1.22604856146397,-0.0511756569847857
"United States","Arkansas","AR",2020-01-12,2020-01-18,7,2020,"3",3017825,658,0,684,-26,658,0,-0.861547637785491,-0.0380116959064327
"United States","Arkansas","AR",2020-01-19,2020-01-25,7,2020,"4",3017825,616,0,672,-56,616,0,-1.85564106599952,-0.0833333333333334
"United States","Arkansas","AR",2020-01-26,2020-02-01,7,2020,"5",3017825,681,0,674,7,681,0,0.23195513324994,0.0103857566765579
"United States","Arkansas","AR",2020-02-02,2020-02-08,7,2020,"6",3017825,673,0,661,12,673,0,0.397637371285611,0.0181543116490166
"United States","Arkansas","AR",2020-02-09,2020-02-15,7,2020,"7",3017825,688,0,668,20,688,0,0.662728952142685,0.0299401197604789
"United States","Arkansas","AR",2020-02-16,2020-02-22,7,2020,"8",3017825,697,0,665,32,697,0,1.0603663234283,0.0481203007518798
"United States","Arkansas","AR",2020-02-23,2020-02-29,7,2020,"9",3017825,656,0,651,5,656,0,0.165682238035671,0.00768049155145922
"United States","Arkansas","AR",2020-03-01,2020-03-07,7,2020,"10",3017825,697,0,648,49,697,0,1.62368593274958,0.0756172839506173
"United States","Arkansas","AR",2020-03-08,2020-03-14,7,2020,"11",3017825,628,0,638,-10,628,0,-0.331364476071343,-0.0156739811912225
"United States","Arkansas","AR",2020-03-15,2020-03-21,7,2020,"12",3017825,640,0,639,1,640,0,0.0331364476071343,0.00156494522691708
"United States","Arkansas","AR",2020-03-22,2020-03-28,7,2020,"13",3017825,641,5,630,11,636,0.165682238035671,0.364500923678477,0.0174603174603174
"United States","Arkansas","AR",2020-03-29,2020-04-04,7,2020,"14",3017825,606,8,624,-18,598,0.265091580857074,-0.596456056928417,-0.0288461538461539
"United States","Arkansas","AR",2020-04-05,2020-04-11,7,2020,"15",3017825,636,12,622,14,624,0.397637371285611,0.46391026649988,0.022508038585209
"United States","Arkansas","AR",2020-04-12,2020-04-18,7,2020,"16",3017825,637,12,620,17,625,0.397637371285611,0.563319609321283,0.0274193548387096
"United States","Arkansas","AR",2020-04-19,2020-04-25,7,2020,"17",3017825,615,10,618,-3,605,0.331364476071343,-0.0994093428214028,-0.00485436893203883
"United States","Arkansas","AR",2020-04-26,2020-05-02,7,2020,"18",3017825,630,25,610,20,605,0.828411190178357,0.662728952142685,0.0327868852459017
"United States","Arkansas","AR",2020-05-03,2020-05-09,7,2020,"19",3017825,661,16,608,53,645,0.530183161714148,1.75623172317812,0.087171052631579
"United States","Arkansas","AR",2020-05-10,2020-05-16,7,2020,"20",3017825,583,10,610,-27,573,0.331364476071343,-0.894684085392626,-0.0442622950819672
"United States","Arkansas","AR",2020-05-17,2020-05-23,7,2020,"21",3017825,642,17,603,39,625,0.563319609321283,1.29232145667824,0.0646766169154229
"United States","Arkansas","AR",2020-05-24,2020-05-30,7,2020,"22",3017825,610,18,602,8,592,0.596456056928417,0.265091580857074,0.0132890365448506
"United States","Arkansas","AR",2020-05-31,2020-06-06,7,2020,"23",3017825,649,20,598,51,629,0.662728952142685,1.68995882796385,0.0852842809364549
"United States","Arkansas","AR",2020-06-07,2020-06-13,7,2020,"24",3017825,652,24,588,64,628,0.795274742571223,2.12073264685659,0.108843537414966
"United States","Arkansas","AR",2020-06-14,2020-06-20,7,2020,"25",3017825,708,47,588,120,661,1.55741303753531,3.97637371285611,0.204081632653061
"United States","Arkansas","AR",2020-06-21,2020-06-27,7,2020,"26",3017825,663,35,593,70,628,1.1597756662497,2.3195513324994,0.118043844856661
"United States","Arkansas","AR",2020-06-28,2020-07-04,7,2020,"27",3017825,687,27,596,91,660,0.894684085392626,3.01541673224922,0.152684563758389
"United States","Arkansas","AR",2020-07-05,2020-07-11,7,2020,"28",3017825,661,33,590,71,628,1.09350277103543,2.35268778010653,0.120338983050847
"United States","Arkansas","AR",2020-07-12,2020-07-18,7,2020,"29",3017825,695,38,578,117,657,1.2591850090711,3.87696437003471,0.20242214532872
"United States","Arkansas","AR",2020-07-19,2020-07-25,7,2020,"30",3017825,714,42,571,143,672,1.39173079949964,4.7385120078202,0.250437828371278
"United States","Arkansas","AR",2020-07-26,2020-08-01,7,2020,"31",3017825,750,59,566,184,691,1.95505040882092,6.09710635971271,0.325088339222615
"United States","Arkansas","AR",2020-08-02,2020-08-08,7,2020,"32",3017825,736,77,559,177,659,2.55150646574934,5.86515122646277,0.316636851520572
"United States","Arkansas","AR",2020-08-09,2020-08-15,7,2020,"33",3017825,766,65,563,203,701,2.15386909446373,6.72669886424826,0.36056838365897
"United States","Arkansas","AR",2020-08-16,2020-08-22,7,2020,"34",3017825,750,74,562,188,676,2.45209712292794,6.22965215014124,0.334519572953737
"United States","Arkansas","AR",2020-08-23,2020-08-29,7,2020,"35",3017825,739,98,572,167,641,3.24737186549916,5.53378675039142,0.291958041958042
"United States","Arkansas","AR",2020-08-30,2020-09-05,7,2020,"36",3017825,713,110,579,134,603,3.64500923678477,4.44028397935599,0.231433506044905
"United States","Arkansas","AR",2020-09-06,2020-09-12,7,2020,"37",3017825,722,71,581,141,651,2.35268778010653,4.67223911260593,0.242685025817556
"United States","Arkansas","AR",2020-09-13,2020-09-19,7,2020,"38",3017825,736,228,582,154,508,7.55511005442661,5.10301293149868,0.264604810996564
"United States","Arkansas","AR",2020-09-20,2020-09-26,7,2020,"39",3017825,746,104,587,159,642,3.44619055114196,5.26869516953435,0.270868824531516
"United States","Arkansas","AR",2020-09-27,2020-10-03,7,2020,"40",3017825,784,122,582,202,662,4.04264660807038,6.69356241664112,0.347079037800687
"United States","Arkansas","AR",2020-10-04,2020-10-10,7,2020,"41",3017825,785,145,575,210,640,4.80478490303447,6.9586539974982,0.365217391304348
"United States","Arkansas","AR",2020-10-11,2020-10-17,7,2020,"42",3017825,778,132,594,184,646,4.37401108414173,6.09710635971271,0.30976430976431
"United States","Arkansas","AR",2020-10-18,2020-10-24,7,2020,"43",3017825,794,113,600,194,681,3.74441857960617,6.42847083578405,0.323333333333333
"United States","Arkansas","AR",2020-10-25,2020-10-31,7,2020,"44",3017825,790,127,612,178,663,4.20832884610605,5.8982876740699,0.290849673202614
"United States","Arkansas","AR",2020-11-01,2020-11-07,7,2020,"45",3017825,845,142,625,220,703,4.70537556021307,7.29001847356954,0.352
"United States","Arkansas","AR",2020-11-08,2020-11-14,7,2020,"46",3017825,893,89,629,264,804,2.94914383703495,8.74802216828345,0.419713831478537
"United States","Arkansas","AR",2020-11-15,2020-11-21,7,2020,"47",3017825,876,174,627,249,702,5.76574188364136,8.25097545417644,0.397129186602871
"United States","Arkansas","AR",2020-11-22,2020-11-28,7,2020,"48",3017825,833,107,642,191,726,3.54559989396337,6.32906149296265,0.297507788161994
"United States","Arkansas","AR",2020-11-29,2020-12-05,7,2020,"49",3017825,944,184,659,285,760,6.09710635971271,9.44388756803327,0.43247344461305
"United States","Arkansas","AR",2020-12-06,2020-12-12,7,2020,"50",3017825,912,290,666,246,622,9.60956980606894,8.15156611135503,0.369369369369369
"United States","Arkansas","AR",2020-12-13,2020-12-19,7,2020,"51",3017825,936,281,685,251,655,9.31134177760473,8.3172483493907,0.366423357664234
"United States","Arkansas","AR",2020-12-20,2020-12-26,7,2020,"52",3017825,922,250,698,224,672,8.28411190178357,7.42256426399808,0.320916905444126
"United States","Arkansas","AR",2020-12-27,2021-01-02,7,2020,"53",3017825,968,288,700,268,680,9.54329691085467,8.88056795871199,0.382857142857143
"United States","Arkansas","AR",2021-01-03,2021-01-09,7,2021,"1",3017825,962,281,701,261,681,9.31134177760473,8.64861282546205,0.372325249643367
"United States","Arkansas","AR",2021-01-10,2021-01-16,7,2021,"2",3017825,970,283,697,273,687,9.377614672819,9.04625019674766,0.39167862266858
"United States","Arkansas","AR",2021-01-17,2021-01-23,7,2021,"3",3017825,991,270,672,319,721,8.94684085392626,10.5705267866758,0.474702380952381
"United States","Arkansas","AR",2021-01-24,2021-01-30,7,2021,"4",3017825,881,275,672,209,606,9.11252309196193,6.92551754989106,0.311011904761905
"United States","Arkansas","AR",2021-01-31,2021-02-06,7,2021,"5",3017825,871,223,673,198,648,7.38942781639094,6.56101662621259,0.294205052005944
"United States","Arkansas","AR",2021-02-07,2021-02-13,7,2021,"6",3017825,808,191,669,139,617,6.32906149296265,4.60596621739166,0.207772795216741
"United States","Arkansas","AR",2021-02-14,2021-02-20,7,2021,"7",3017825,779,96,663,116,683,3.18109897028489,3.84382792242758,0.174962292609351
"United States","Arkansas","AR",2021-02-21,2021-02-27,7,2021,"8",3017825,795,72,662,133,723,2.38582422771367,4.40714753174886,0.200906344410876
"United States","Arkansas","AR",2021-02-28,2021-03-06,7,2021,"9",3017825,748,19,655,93,729,0.629592504535551,3.08168962746349,0.141984732824427
"United States","Arkansas","AR",2021-03-07,2021-03-13,7,2021,"10",3017825,723,87,641,82,636,2.88287094182068,2.71718870378501,0.12792511700468
"United States","Arkansas","AR",2021-03-14,2021-03-20,7,2021,"11",3017825,648,67,633,15,581,2.220141989678,0.497046714107014,0.0236966824644549
"United States","Arkansas","AR",2021-03-21,2021-03-27,7,2021,"12",3017825,705,49,627,78,656,1.62368593274958,2.58464291335647,0.124401913875598
"United States","Arkansas","AR",2021-03-28,2021-04-03,7,2021,"13",3017825,603,-1,616,-13,604,-0.0331364476071343,-0.430773818892746,-0.0211038961038961
"United States","Arkansas","AR",2021-04-04,2021-04-10,7,2021,"14",3017825,694,20,609,85,674,0.662728952142685,2.81659804660641,0.139573070607553
"United States","Arkansas","AR",2021-04-11,2021-04-17,7,2021,"15",3017825,613,32,602,11,581,1.0603663234283,0.364500923678477,0.0182724252491695
"United States","Arkansas","AR",2021-04-18,2021-04-24,7,2021,"16",3017825,663,24,597,66,639,0.795274742571223,2.18700554207086,0.110552763819096
"United States","Arkansas","AR",2021-04-25,2021-05-01,7,2021,"17",3017825,652,24,600,52,628,0.795274742571223,1.72309527557098,0.0866666666666667
"United States","Arkansas","AR",2021-05-02,2021-05-08,7,2021,"18",3017825,703,19,599,104,684,0.629592504535551,3.44619055114196,0.173622704507512
"United States","Arkansas","AR",2021-05-09,2021-05-15,7,2021,"19",3017825,697,33,598,99,664,1.09350277103543,3.28050831310629,0.165551839464883
"United States","Arkansas","AR",2021-05-16,2021-05-22,7,2021,"20",3017825,685,23,599,86,662,0.762138294964088,2.84973449421355,0.143572621035059
"United States","Arkansas","AR",2021-05-23,2021-05-29,7,2021,"21",3017825,658,14,600,58,644,0.46391026649988,1.92191396121379,0.0966666666666667
"United States","Arkansas","AR",2021-05-30,2021-06-05,7,2021,"22",3017825,681,16,595,86,665,0.530183161714148,2.84973449421355,0.14453781512605
"United States","Arkansas","AR",2021-06-06,2021-06-12,7,2021,"23",3017825,670,14,592,78,656,0.46391026649988,2.58464291335647,0.131756756756757
"United States","Arkansas","AR",2021-06-13,2021-06-19,7,2021,"24",3017825,684,14,592,92,670,0.46391026649988,3.04855317985635,0.155405405405405
"United States","Arkansas","AR",2021-06-20,2021-06-26,7,2021,"25",3017825,590,19,591,-1,571,0.629592504535551,-0.0331364476071343,-0.00169204737732653
"United States","California","CA",2019-12-29,2020-01-04,7,2020,"1",39512223,5888,0,6258,-370,5888,0,-0.936419092390727,-0.0591243208692873
"United States","California","CA",2020-01-05,2020-01-11,7,2020,"2",39512223,5873,0,6257,-384,5873,0,-0.971851166156862,-0.0613712641841138
"United States","California","CA",2020-01-12,2020-01-18,7,2020,"3",39512223,5830,0,6136,-306,5830,0,-0.77444389803125,-0.0498696219035202
"United States","California","CA",2020-01-19,2020-01-25,7,2020,"4",39512223,5832,0,6046,-214,5832,0,-0.541604556139501,-0.0353953026794575
"United States","California","CA",2020-01-26,2020-02-01,7,2020,"5",39512223,5686,0,5979,-293,5686,0,-0.741542686676981,-0.0490048503094163
"United States","California","CA",2020-02-02,2020-02-08,7,2020,"6",39512223,5913,1,5879,34,5912,0.00253086241186683,0.0860493220034722,0.00578329647899301
"United States","California","CA",2020-02-09,2020-02-15,7,2020,"7",39512223,5588,0,5819,-231,5588,0,-0.584629217141238,-0.0396975425330813
"United States","California","CA",2020-02-16,2020-02-22,7,2020,"8",39512223,5797,1,5766,31,5796,0.00253086241186683,0.0784567347678717,0.0053763440860215
"United States","California","CA",2020-02-23,2020-02-29,7,2020,"9",39512223,5680,0,5735,-55,5680,0,-0.139197432652676,-0.00959023539668702
"United States","California","CA",2020-03-01,2020-03-07,7,2020,"10",39512223,5736,2,5763,-27,5734,0.00506172482373366,-0.0683332851204044,-0.00468505986465384
"United States","California","CA",2020-03-08,2020-03-14,7,2020,"11",39512223,5465,3,5688,-223,5462,0.00759258723560049,-0.564382317846303,-0.0392053445850914
"United States","California","CA",2020-03-15,2020-03-21,7,2020,"12",39512223,5681,23,5598,83,5658,0.0582098354729371,0.210061580184947,0.0148267238299393
"United States","California","CA",2020-03-22,2020-03-28,7,2020,"13",39512223,5689,94,5467,222,5595,0.237901066715482,0.561851455434436,0.0406072800438997
"United States","California","CA",2020-03-29,2020-04-04,7,2020,"14",39512223,5986,199,5370,616,5787,0.503641619961499,1.55901124570997,0.114711359404097
"United States","California","CA",2020-04-05,2020-04-11,7,2020,"15",39512223,6047,309,5309,738,5738,0.78203648526685,1.86777645995772,0.139009229610096
"United States","California","CA",2020-04-12,2020-04-18,7,2020,"16",39512223,6131,515,5276,855,5616,1.30339414211142,2.16388736214614,0.162054586808188
"United States","California","CA",2020-04-19,2020-04-25,7,2020,"17",39512223,5938,543,5222,716,5395,1.37425828964369,1.81209748689665,0.137112217541172
"United States","California","CA",2020-04-26,2020-05-02,7,2020,"18",39512223,5744,495,5132,612,5249,1.25277689387408,1.5488877960625,0.11925175370226
"United States","California","CA",2020-05-03,2020-05-09,7,2020,"19",39512223,5671,504,5078,593,5167,1.27555465558088,1.50080141023703,0.116778259157148
"United States","California","CA",2020-05-10,2020-05-16,7,2020,"20",39512223,5695,519,5057,638,5176,1.31351759175888,1.61469021877104,0.126161755981807
"United States","California","CA",2020-05-17,2020-05-23,7,2020,"21",39512223,5530,527,5042,488,5003,1.33376449105382,1.23506085699101,0.0967869892899642
"United States","California","CA",2020-05-24,2020-05-30,7,2020,"22",39512223,5593,406,4974,619,5187,1.02753013921793,1.56660383294557,0.124447125050261
"United States","California","CA",2020-05-31,2020-06-06,7,2020,"23",39512223,5518,463,4974,544,5055,1.17178929669434,1.37678915205556,0.109368717330117
"United States","California","CA",2020-06-07,2020-06-13,7,2020,"24",39512223,5570,451,4968,602,5119,1.14141894775194,1.52357917194383,0.121175523349436
"United States","California","CA",2020-06-14,2020-06-20,7,2020,"25",39512223,5489,431,4987,502,5058,1.0908016995146,1.27049293075715,0.10066172047323
"United States","California","CA",2020-06-21,2020-06-27,7,2020,"26",39512223,5701,412,4966,735,5289,1.04271531368913,1.86018387272212,0.148006443817962
"United States","California","CA",2020-06-28,2020-07-04,7,2020,"27",39512223,5901,432,4927,974,5469,1.09333256192647,2.46505998915829,0.197686218794398
"United States","California","CA",2020-07-05,2020-07-11,7,2020,"28",39512223,6042,696,4877,1165,5346,1.76148023865931,2.94845470982486,0.23887635841706
"United States","California","CA",2020-07-12,2020-07-18,7,2020,"29",39512223,6230,676,4814,1416,5554,1.71086299042198,3.58370117520343,0.294142085583714
"United States","California","CA",2020-07-19,2020-07-25,7,2020,"30",39512223,6250,726,4796,1454,5524,1.83740611101532,3.67987394685437,0.303169307756464
"United States","California","CA",2020-07-26,2020-08-01,7,2020,"31",39512223,6339,933,4725,1614,5406,2.36129463027175,4.08481193275306,0.341587301587302
"United States","California","CA",2020-08-02,2020-08-08,7,2020,"32",39512223,6309,924,4693,1616,5385,2.33851686856495,4.0898736575768,0.344342637971447
"United States","California","CA",2020-08-09,2020-08-15,7,2020,"33",39512223,6291,937,4649,1642,5354,2.37141807991922,4.15567608028533,0.353194235319424
"United States","California","CA",2020-08-16,2020-08-22,7,2020,"34",39512223,6477,894,4664,1813,5583,2.26259099620894,4.58845355271456,0.388722126929674
"United States","California","CA",2020-08-23,2020-08-29,7,2020,"35",39512223,5878,789,4662,1216,5089,1.99685044296293,3.07752869283006,0.260832260832261
"United States","California","CA",2020-08-30,2020-09-05,7,2020,"36",39512223,5784,802,4683,1101,4982,2.0297516543172,2.78647951546538,0.235105701473415
"United States","California","CA",2020-09-06,2020-09-12,7,2020,"37",39512223,5874,626,4716,1158,5248,1.58431986982864,2.93073867294179,0.245547073791349
"United States","California","CA",2020-09-13,2020-09-19,7,2020,"38",39512223,5753,654,4759,994,5099,1.65518401736091,2.51567723739563,0.208867409119563
"United States","California","CA",2020-09-20,2020-09-26,7,2020,"39",39512223,5562,547,4759,803,5015,1.38438173929116,2.03228251672906,0.168732927085522
"United States","California","CA",2020-09-27,2020-10-03,7,2020,"40",39512223,5670,608,4778,892,5062,1.53876434641503,2.25752927138521,0.186688991209711
"United States","California","CA",2020-10-04,2020-10-10,7,2020,"41",39512223,5568,447,4819,749,5121,1.13129549810447,1.89561594648826,0.155426437020129
"United States","California","CA",2020-10-11,2020-10-17,7,2020,"42",39512223,5621,375,4858,763,5246,0.949073404450061,1.93104802025439,0.157060518731988
"United States","California","CA",2020-10-18,2020-10-24,7,2020,"43",39512223,5351,381,4866,485,4970,0.964258578921262,1.22746826975541,0.0996711878339498
"United States","California","CA",2020-10-25,2020-10-31,7,2020,"44",39512223,5529,314,4903,626,5215,0.794690797326184,1.58431986982864,0.127676932490312
"United States","California","CA",2020-11-01,2020-11-07,7,2020,"45",39512223,5872,305,4921,951,5567,0.771913035619383,2.40685015368535,0.19325340377972
"United States","California","CA",2020-11-08,2020-11-14,7,2020,"46",39512223,6004,288,4941,1063,5716,0.728888374617647,2.69030674381444,0.215138635903663
"United States","California","CA",2020-11-15,2020-11-21,7,2020,"47",39512223,6350,345,4991,1359,6005,0.873147532094056,3.43944201772702,0.272290122219996
"United States","California","CA",2020-11-22,2020-11-28,7,2020,"48",39512223,6391,536,5082,1309,5855,1.35654225276062,3.31289889713368,0.257575757575758
"United States","California","CA",2020-11-29,2020-12-05,7,2020,"49",39512223,7163,746,5169,1994,6417,1.88802335925265,5.04653964926246,0.385761269104276
"United States","California","CA",2020-12-06,2020-12-12,7,2020,"50",39512223,8147,1092,5284,2863,7055,2.76370175375858,7.24585908517473,0.541824375473126
"United States","California","CA",2020-12-13,2020-12-19,7,2020,"51",39512223,9229,1612,5410,3819,7617,4.07975020792933,9.66536355091942,0.705914972273567
"United States","California","CA",2020-12-20,2020-12-26,7,2020,"52",39512223,10562,1400,5567,4995,9162,3.54320737661356,12.6416577472748,0.897251661577151
"United States","California","CA",2020-12-27,2021-01-02,7,2020,"53",39512223,11267,2374,5704,5563,8893,6.00826736577185,14.0791875972152,0.975280504908836
"United States","California","CA",2021-01-03,2021-01-09,7,2021,"1",39512223,11885,2876,5885,6000,9009,7.278760296529,15.185174471201,1.01954120645709
"United States","California","CA",2021-01-10,2021-01-16,7,2021,"2",39512223,11595,3727,5907,5688,7868,9.43252420902767,14.3955453986985,0.962925342813611
"United States","California","CA",2021-01-17,2021-01-23,7,2021,"3",39512223,10429,3400,5881,4548,7029,8.60493220034722,11.5103622491703,0.773337867709573
"United States","California","CA",2021-01-24,2021-01-30,7,2021,"4",39512223,9610,3856,5831,3779,5754,9.75900546015849,9.56412905444475,0.648087806551192
"United States","California","CA",2021-01-31,2021-02-06,7,2021,"5",39512223,8790,3431,5816,2974,5359,8.68338893511509,7.52678481289195,0.511348005502063
"United States","California","CA",2021-02-07,2021-02-13,7,2021,"6",39512223,7877,2788,5721,2156,5089,7.05604440428472,5.45653935998488,0.376857192798462
"United States","California","CA",2021-02-14,2021-02-20,7,2021,"7",39512223,7024,2390,5713,1311,4634,6.04876116436172,3.31796062195741,0.229476632242255
"United States","California","CA",2021-02-21,2021-02-27,7,2021,"8",39512223,6728,2996,5715,1013,3732,7.58246378595302,2.5637636232211,0.177252843394576
"United States","California","CA",2021-02-28,2021-03-06,7,2021,"9",39512223,6455,1901,5709,746,4554,4.81116944495884,1.88802335925265,0.130670870555264
"United States","California","CA",2021-03-07,2021-03-13,7,2021,"10",39512223,6207,1513,5665,542,4694,3.82919482915451,1.37172742723182,0.0956751985878199
"United States","California","CA",2021-03-14,2021-03-20,7,2021,"11",39512223,5981,883,5537,444,5098,2.23475150967841,1.12370291086887,0.0801878273433267
"United States","California","CA",2021-03-21,2021-03-27,7,2021,"12",39512223,5787,1628,5444,343,4159,4.1202440065192,0.868085807270322,0.0630051432770022
"United States","California","CA",2021-03-28,2021-04-03,7,2021,"13",39512223,5750,683,5359,391,5067,1.72857902730504,0.98956720303993,0.0729613733905579
"United States","California","CA",2021-04-04,2021-04-10,7,2021,"14",39512223,5414,684,5257,157,4730,1.73110988971691,0.397345398663092,0.0298649419821191
"United States","California","CA",2021-04-11,2021-04-17,7,2021,"15",39512223,5333,577,5211,122,4756,1.46030761164716,0.308765214247753,0.0234120130493187
"United States","California","CA",2021-04-18,2021-04-24,7,2021,"16",39512223,5353,445,5108,245,4908,1.12623377328074,0.620061290907373,0.0479639780736101
"United States","California","CA",2021-04-25,2021-05-01,7,2021,"17",39512223,5375,490,5060,315,4885,1.24012258181475,0.797221659738051,0.0622529644268774
"United States","California","CA",2021-05-02,2021-05-08,7,2021,"18",39512223,5344,542,5061,283,4802,1.37172742723182,0.716234062558313,0.0559178028057696
"United States","California","CA",2021-05-09,2021-05-15,7,2021,"19",39512223,5254,277,5044,210,4977,0.701048888087112,0.531481106492034,0.041633624107851
"United States","California","CA",2021-05-16,2021-05-22,7,2021,"20",39512223,5227,278,5045,182,4949,0.703579750498978,0.460616958959763,0.0360753221010901
"United States","California","CA",2021-05-23,2021-05-29,7,2021,"21",39512223,5260,59,5013,247,5201,0.149320882300143,0.625123015731107,0.0492718930779972
"United States","California","CA",2021-05-30,2021-06-05,7,2021,"22",39512223,5055,247,4991,64,4808,0.625123015731107,0.161975194359477,0.0128230815467842
"United States","California","CA",2021-06-06,2021-06-12,7,2021,"23",39512223,4894,258,5033,-139,4636,0.652962502261642,-0.351789875249489,-0.0276177230280151
"United States","California","CA",2021-06-13,2021-06-19,7,2021,"24",39512223,4784,130,5033,-249,4654,0.329012113542688,-0.630184740554841,-0.0494734750645738
"United States","California","CA",2021-06-20,2021-06-26,7,2021,"25",39512223,3726,323,5018,-1292,3403,0.817468559032986,-3.26987423613194,-0.257473096851335
"United States","Colorado","CO",2019-12-29,2020-01-04,7,2020,"1",5758736,854,0,840,14,854,0,0.243108904454033,0.0166666666666666
"United States","Colorado","CO",2020-01-05,2020-01-11,7,2020,"2",5758736,872,0,843,29,872,0,0.503582730654783,0.0344009489916963
"United States","Colorado","CO",2020-01-12,2020-01-18,7,2020,"3",5758736,848,0,846,2,848,0,0.0347298434934333,0.00236406619385332
"United States","Colorado","CO",2020-01-19,2020-01-25,7,2020,"4",5758736,853,0,838,15,853,0,0.26047382620075,0.0178997613365155
"United States","Colorado","CO",2020-01-26,2020-02-01,7,2020,"5",5758736,793,0,825,-32,793,0,-0.555677495894932,-0.0387878787878788
"United States","Colorado","CO",2020-02-02,2020-02-08,7,2020,"6",5758736,847,0,823,24,847,0,0.416758121921199,0.0291616038882139
"United States","Colorado","CO",2020-02-09,2020-02-15,7,2020,"7",5758736,807,0,817,-10,807,0,-0.173649217467166,-0.0122399020807834
"United States","Colorado","CO",2020-02-16,2020-02-22,7,2020,"8",5758736,881,0,817,64,881,0,1.11135499178986,0.0783353733170136
"United States","Colorado","CO",2020-02-23,2020-02-29,7,2020,"9",5758736,842,0,817,25,842,0,0.434123043667916,0.0305997552019583
"United States","Colorado","CO",2020-03-01,2020-03-07,7,2020,"10",5758736,821,0,819,2,821,0,0.0347298434934333,0.00244200244200243
"United States","Colorado","CO",2020-03-08,2020-03-14,7,2020,"11",5758736,822,1,814,8,821,0.0173649217467166,0.138919373973733,0.00982800982800991
"United States","Colorado","CO",2020-03-15,2020-03-21,7,2020,"12",5758736,891,5,813,78,886,0.0868246087335832,1.3544638962439,0.0959409594095941
"United States","Colorado","CO",2020-03-22,2020-03-28,7,2020,"13",5758736,860,38,809,51,822,0.659867026375232,0.885611009082549,0.0630407911001236
"United States","Colorado","CO",2020-03-29,2020-04-04,7,2020,"14",5758736,967,82,804,163,885,1.42392358323076,2.83048224471481,0.20273631840796
"United States","Colorado","CO",2020-04-05,2020-04-11,7,2020,"15",5758736,1096,148,797,299,948,2.57000841851406,5.19211160226827,0.375156838143036
"United States","Colorado","CO",2020-04-12,2020-04-18,7,2020,"16",5758736,1106,137,791,315,969,2.37899427930018,5.46995035021574,0.398230088495575
"United States","Colorado","CO",2020-04-19,2020-04-25,7,2020,"17",5758736,1067,259,789,278,808,4.49751473239961,4.82744824558723,0.35234474017744
"United States","Colorado","CO",2020-04-26,2020-05-02,7,2020,"18",5758736,999,162,774,225,837,2.8131173229681,3.90710739301124,0.290697674418605
"United States","Colorado","CO",2020-05-03,2020-05-09,7,2020,"19",5758736,906,135,762,144,771,2.34426443580675,2.5005487315272,0.188976377952756
"United States","Colorado","CO",2020-05-10,2020-05-16,7,2020,"20",5758736,887,225,750,137,662,3.90710739301124,2.37899427930018,0.182666666666667
"United States","Colorado","CO",2020-05-17,2020-05-23,7,2020,"21",5758736,847,133,737,110,714,2.30953459231331,1.91014139213883,0.149253731343284
"United States","Colorado","CO",2020-05-24,2020-05-30,7,2020,"22",5758736,834,117,729,105,717,2.03169584436585,1.82331678340525,0.144032921810699
"United States","Colorado","CO",2020-05-31,2020-06-06,7,2020,"23",5758736,820,82,728,92,738,1.42392358323076,1.59757280069793,0.126373626373626
"United States","Colorado","CO",2020-06-07,2020-06-13,7,2020,"24",5758736,816,73,724,92,743,1.26763928751031,1.59757280069793,0.12707182320442
"United States","Colorado","CO",2020-06-14,2020-06-20,7,2020,"25",5758736,863,49,718,145,814,0.850881165589115,2.51791365327391,0.201949860724234
"United States","Colorado","CO",2020-06-21,2020-06-27,7,2020,"26",5758736,877,28,722,155,849,0.486217808908066,2.69156287074108,0.214681440443213
"United States","Colorado","CO",2020-06-28,2020-07-04,7,2020,"27",5758736,788,27,718,70,761,0.468852887161349,1.21554452227016,0.0974930362116992
"United States","Colorado","CO",2020-07-05,2020-07-11,7,2020,"28",5758736,815,24,714,101,791,0.416758121921199,1.75385709641838,0.141456582633053
"United States","Colorado","CO",2020-07-12,2020-07-18,7,2020,"29",5758736,808,27,720,88,781,0.468852887161349,1.52811311371106,0.122222222222222
"United States","Colorado","CO",2020-07-19,2020-07-25,7,2020,"30",5758736,833,42,722,111,791,0.729326713362099,1.92750631388555,0.153739612188366
"United States","Colorado","CO",2020-07-26,2020-08-01,7,2020,"31",5758736,813,50,713,100,763,0.868246087335832,1.73649217467166,0.140252454417952
"United States","Colorado","CO",2020-08-02,2020-08-08,7,2020,"32",5758736,841,13,716,125,828,0.225743982707316,2.17061521833958,0.174581005586592
"United States","Colorado","CO",2020-08-09,2020-08-15,7,2020,"33",5758736,836,39,720,116,797,0.677231948121949,2.01433092261913,0.161111111111111
"United States","Colorado","CO",2020-08-16,2020-08-22,7,2020,"34",5758736,863,22,723,140,841,0.382028278427766,2.43108904454033,0.193637621023513
"United States","Colorado","CO",2020-08-23,2020-08-29,7,2020,"35",5758736,817,26,726,91,791,0.451487965414633,1.58020787895121,0.12534435261708
"United States","Colorado","CO",2020-08-30,2020-09-05,7,2020,"36",5758736,743,22,731,12,721,0.382028278427766,0.2083790609606,0.0164158686730507
"United States","Colorado","CO",2020-09-06,2020-09-12,7,2020,"37",5758736,850,22,731,119,828,0.382028278427766,2.06642568785928,0.162790697674419
"United States","Colorado","CO",2020-09-13,2020-09-19,7,2020,"38",5758736,804,25,737,67,779,0.434123043667916,1.16344975703002,0.0909090909090908
"United States","Colorado","CO",2020-09-20,2020-09-26,7,2020,"39",5758736,838,27,747,91,811,0.468852887161349,1.58020787895121,0.121820615796519
"United States","Colorado","CO",2020-09-27,2020-10-03,7,2020,"40",5758736,782,17,752,30,765,0.295203669694183,0.520947652401499,0.0398936170212767
"United States","Colorado","CO",2020-10-04,2020-10-10,7,2020,"41",5758736,801,55,750,51,746,0.955070696069415,0.885611009082549,0.0680000000000001
"United States","Colorado","CO",2020-10-11,2020-10-17,7,2020,"42",5758736,867,64,759,108,803,1.11135499178986,1.8754115486454,0.142292490118577
"United States","Colorado","CO",2020-10-18,2020-10-24,7,2020,"43",5758736,869,42,754,115,827,0.729326713362099,1.99696600087241,0.152519893899204
"United States","Colorado","CO",2020-10-25,2020-10-31,7,2020,"44",5758736,907,58,758,149,849,1.00716546130957,2.58737334026078,0.196569920844327
"United States","Colorado","CO",2020-11-01,2020-11-07,7,2020,"45",5758736,1007,111,756,251,896,1.92750631388555,4.35859535842588,0.332010582010582
"United States","Colorado","CO",2020-11-08,2020-11-14,7,2020,"46",5758736,1040,137,763,277,903,2.37899427930018,4.81008332384051,0.363040629095675
"United States","Colorado","CO",2020-11-15,2020-11-21,7,2020,"47",5758736,1132,263,758,374,869,4.56697441938648,6.49448073327202,0.493403693931398
"United States","Colorado","CO",2020-11-22,2020-11-28,7,2020,"48",5758736,1216,196,773,443,1020,3.40352466235646,7.69266033379547,0.573091849935317
"United States","Colorado","CO",2020-11-29,2020-12-05,7,2020,"49",5758736,1256,373,776,480,883,6.47711581152531,8.33516243842399,0.618556701030928
"United States","Colorado","CO",2020-12-06,2020-12-12,7,2020,"50",5758736,1258,515,779,479,743,8.94293469955907,8.31779751667727,0.614890885750963
"United States","Colorado","CO",2020-12-13,2020-12-19,7,2020,"51",5758736,1201,468,796,405,733,8.12678337746339,7.03279330742024,0.508793969849246
"United States","Colorado","CO",2020-12-20,2020-12-26,7,2020,"52",5758736,1100,253,818,282,847,4.39332520191931,4.89690793257409,0.344743276283619
"United States","Colorado","CO",2020-12-27,2021-01-02,7,2020,"53",5758736,1098,320,835,263,778,5.55677495894933,4.56697441938648,0.31497005988024
"United States","Colorado","CO",2021-01-03,2021-01-09,7,2021,"1",5758736,1082,278,847,235,804,4.82744824558723,4.08075661047841,0.277449822904368
"United States","Colorado","CO",2021-01-10,2021-01-16,7,2021,"2",5758736,1012,167,846,166,845,2.89994193170168,2.88257700995496,0.196217494089834
"United States","Colorado","CO",2021-01-17,2021-01-23,7,2021,"3",5758736,990,123,848,142,867,2.13588537484615,2.46581888803376,0.167452830188679
"United States","Colorado","CO",2021-01-24,2021-01-30,7,2021,"4",5758736,941,136,846,95,805,2.36162935755346,1.64966756593808,0.112293144208038
"United States","Colorado","CO",2021-01-31,2021-02-06,7,2021,"5",5758736,954,106,841,113,848,1.84068170515196,1.96223615737898,0.13436385255648
"United States","Colorado","CO",2021-02-07,2021-02-13,7,2021,"6",5758736,856,97,847,9,759,1.68439740943151,0.15628429572045,0.0106257378984651
"United States","Colorado","CO",2021-02-14,2021-02-20,7,2021,"7",5758736,899,75,843,56,824,1.30236913100375,0.972435617816132,0.066429418742586
"United States","Colorado","CO",2021-02-21,2021-02-27,7,2021,"8",5758736,880,62,841,39,818,1.07662514829643,0.677231948121949,0.0463733650416172
"United States","Colorado","CO",2021-02-28,2021-03-06,7,2021,"9",5758736,869,40,837,32,829,0.694596869868666,0.555677495894932,0.038231780167264
"United States","Colorado","CO",2021-03-07,2021-03-13,7,2021,"10",5758736,847,53,830,17,794,0.920340852575982,0.295203669694183,0.0204819277108435
"United States","Colorado","CO",2021-03-14,2021-03-20,7,2021,"11",5758736,905,27,824,81,878,0.468852887161349,1.40655866148405,0.0983009708737863
"United States","Colorado","CO",2021-03-21,2021-03-27,7,2021,"12",5758736,890,27,823,67,863,0.468852887161349,1.16344975703002,0.0814094775212637
"United States","Colorado","CO",2021-03-28,2021-04-03,7,2021,"13",5758736,833,30,818,15,803,0.520947652401499,0.26047382620075,0.0183374083129584
"United States","Colorado","CO",2021-04-04,2021-04-10,7,2021,"14",5758736,785,23,812,-27,762,0.399393200174483,-0.468852887161349,-0.0332512315270936
"United States","Colorado","CO",2021-04-11,2021-04-17,7,2021,"15",5758736,872,33,800,72,839,0.573042417641649,1.2502743657636,0.0900000000000001
"United States","Colorado","CO",2021-04-18,2021-04-24,7,2021,"16",5758736,836,61,795,41,775,1.05926022654972,0.711961791615382,0.0515723270440251
"United States","Colorado","CO",2021-04-25,2021-05-01,7,2021,"17",5758736,848,53,793,55,795,0.920340852575982,0.955070696069415,0.0693568726355611
"United States","Colorado","CO",2021-05-02,2021-05-08,7,2021,"18",5758736,853,53,787,66,800,0.920340852575982,1.1460848352833,0.0838627700127066
"United States","Colorado","CO",2021-05-09,2021-05-15,7,2021,"19",5758736,878,87,788,90,791,1.51074819196435,1.5628429572045,0.114213197969543
"United States","Colorado","CO",2021-05-16,2021-05-22,7,2021,"20",5758736,848,61,781,67,787,1.05926022654972,1.16344975703002,0.0857874519846351
"United States","Colorado","CO",2021-05-23,2021-05-29,7,2021,"21",5758736,824,73,777,47,751,1.26763928751031,0.816151322095682,0.0604890604890604
"United States","Colorado","CO",2021-05-30,2021-06-05,7,2021,"22",5758736,827,37,767,60,790,0.642502104628516,1.041895304803,0.0782268578878749
"United States","Colorado","CO",2021-06-06,2021-06-12,7,2021,"23",5758736,872,75,759,113,797,1.30236913100375,1.96223615737898,0.148880105401844
"United States","Colorado","CO",2021-06-13,2021-06-19,7,2021,"24",5758736,806,44,752,54,762,0.764056556855532,0.937705774322699,0.071808510638298
"United States","Colorado","CO",2021-06-20,2021-06-26,7,2021,"25",5758736,693,38,744,-51,655,0.659867026375232,-0.885611009082549,-0.0685483870967742
"United States","Connecticut","CT",2019-12-29,2020-01-04,7,2020,"1",3565287,633,0,678,-45,633,0,-1.26217047884224,-0.0663716814159292
"United States","Connecticut","CT",2020-01-05,2020-01-11,7,2020,"2",3565287,631,0,680,-49,631,0,-1.37436341029488,-0.0720588235294117
"United States","Connecticut","CT",2020-01-12,2020-01-18,7,2020,"3",3565287,639,0,683,-44,639,0,-1.23412224597908,-0.0644216691068814
"United States","Connecticut","CT",2020-01-19,2020-01-25,7,2020,"4",3565287,653,0,689,-36,653,0,-1.00973638307379,-0.0522496371552975
"United States","Connecticut","CT",2020-01-26,2020-02-01,7,2020,"5",3565287,686,0,686,0,686,0,0,0
"United States","Connecticut","CT",2020-02-02,2020-02-08,7,2020,"6",3565287,652,0,678,-26,652,0,-0.729254054442181,-0.0383480825958702
"United States","Connecticut","CT",2020-02-09,2020-02-15,7,2020,"7",3565287,635,0,663,-28,635,0,-0.785350520168502,-0.0422322775263951
"United States","Connecticut","CT",2020-02-16,2020-02-22,7,2020,"8",3565287,653,0,668,-15,653,0,-0.420723492947412,-0.0224550898203593
"United States","Connecticut","CT",2020-02-23,2020-02-29,7,2020,"9",3565287,638,0,652,-14,638,0,-0.392675260084251,-0.0214723926380368
"United States","Connecticut","CT",2020-03-01,2020-03-07,7,2020,"10",3565287,625,0,647,-22,625,0,-0.617061122989538,-0.0340030911901081
"United States","Connecticut","CT",2020-03-08,2020-03-14,7,2020,"11",3565287,632,0,644,-12,632,0,-0.33657879435793,-0.0186335403726708
"United States","Connecticut","CT",2020-03-15,2020-03-21,7,2020,"12",3565287,665,5,641,24,660,0.140241164315804,0.673157588715859,0.0374414976599065
"United States","Connecticut","CT",2020-03-22,2020-03-28,7,2020,"13",3565287,751,28,650,101,723,0.785350520168502,2.83287151917924,0.155384615384615
"United States","Connecticut","CT",2020-03-29,2020-04-04,7,2020,"14",3565287,891,132,650,241,759,3.70236673793723,6.75962412002175,0.370769230769231
"United States","Connecticut","CT",2020-04-05,2020-04-11,7,2020,"15",3565287,1260,329,654,606,931,9.22786861197991,16.9972291150754,0.926605504587156
"United States","Connecticut","CT",2020-04-12,2020-04-18,7,2020,"16",3565287,1389,592,647,742,797,16.6045538549912,20.8117887844653,1.1468315301391
"United States","Connecticut","CT",2020-04-19,2020-04-25,7,2020,"17",3565287,1338,775,630,708,563,21.7373804689496,19.8581488671179,1.12380952380952
"United States","Connecticut","CT",2020-04-26,2020-05-02,7,2020,"18",3565287,1165,575,616,549,590,16.1277338963175,15.3984798418753,0.891233766233766
"United States","Connecticut","CT",2020-05-03,2020-05-09,7,2020,"19",3565287,1052,496,606,446,556,13.9119235001278,12.5095118569697,0.735973597359736
"United States","Connecticut","CT",2020-05-10,2020-05-16,7,2020,"20",3565287,954,406,590,364,548,11.3875825424433,10.2095567621905,0.616949152542373
"United States","Connecticut","CT",2020-05-17,2020-05-23,7,2020,"21",3565287,823,336,584,239,487,9.42420624202203,6.70352765429543,0.409246575342466
"United States","Connecticut","CT",2020-05-24,2020-05-30,7,2020,"22",3565287,759,238,581,178,521,6.67547942143227,4.99258544964262,0.306368330464716
"United States","Connecticut","CT",2020-05-31,2020-06-06,7,2020,"23",3565287,669,143,584,85,526,4.01089729943199,2.38409979336867,0.14554794520548
"United States","Connecticut","CT",2020-06-07,2020-06-13,7,2020,"24",3565287,636,131,584,52,505,3.67431850507407,1.45850810888436,0.0890410958904109
"United States","Connecticut","CT",2020-06-14,2020-06-20,7,2020,"25",3565287,581,65,584,-3,516,1.82313513610545,-0.0841446985894824,-0.00513698630136983
"United States","Connecticut","CT",2020-06-21,2020-06-27,7,2020,"26",3565287,598,60,578,20,538,1.68289397178965,0.560964657263216,0.0346020761245676
"United States","Connecticut","CT",2020-06-28,2020-07-04,7,2020,"27",3565287,553,24,580,-27,529,0.673157588715859,-0.757302287305342,-0.0465517241379311
"United States","Connecticut","CT",2020-07-05,2020-07-11,7,2020,"28",3565287,611,13,576,35,598,0.36462702722109,0.981688150210628,0.0607638888888888
"United States","Connecticut","CT",2020-07-12,2020-07-18,7,2020,"29",3565287,569,48,568,1,521,1.34631517743172,0.0280482328631608,0.00176056338028174
"United States","Connecticut","CT",2020-07-19,2020-07-25,7,2020,"30",3565287,586,17,560,26,569,0.476819958673734,0.729254054442181,0.0464285714285715
"United States","Connecticut","CT",2020-07-26,2020-08-01,7,2020,"31",3565287,555,19,551,4,536,0.532916424400055,0.112192931452643,0.00725952813067154
"United States","Connecticut","CT",2020-08-02,2020-08-08,7,2020,"32",3565287,593,9,551,42,584,0.252434095768447,1.17802578025275,0.0762250453720508
"United States","Connecticut","CT",2020-08-09,2020-08-15,7,2020,"33",3565287,574,12,550,24,562,0.33657879435793,0.673157588715859,0.0436363636363637
"United States","Connecticut","CT",2020-08-16,2020-08-22,7,2020,"34",3565287,571,7,548,23,564,0.196337630042126,0.645109355852699,0.0419708029197081
"United States","Connecticut","CT",2020-08-23,2020-08-29,7,2020,"35",3565287,532,5,544,-12,527,0.140241164315804,-0.33657879435793,-0.0220588235294118
"United States","Connecticut","CT",2020-08-30,2020-09-05,7,2020,"36",3565287,574,3,552,22,571,0.0841446985894824,0.617061122989538,0.0398550724637681
"United States","Connecticut","CT",2020-09-06,2020-09-12,7,2020,"37",3565287,571,12,554,17,559,0.33657879435793,0.476819958673734,0.0306859205776173
"United States","Connecticut","CT",2020-09-13,2020-09-19,7,2020,"38",3565287,579,12,556,23,567,0.33657879435793,0.645109355852699,0.0413669064748201
"United States","Connecticut","CT",2020-09-20,2020-09-26,7,2020,"39",3565287,644,9,570,74,635,0.252434095768447,2.0755692318739,0.129824561403509
"United States","Connecticut","CT",2020-09-27,2020-10-03,7,2020,"40",3565287,623,12,576,47,611,0.33657879435793,1.31826694456856,0.0815972222222223
"United States","Connecticut","CT",2020-10-04,2020-10-10,7,2020,"41",3565287,637,17,579,58,620,0.476819958673734,1.62679750606333,0.100172711571675
"United States","Connecticut","CT",2020-10-11,2020-10-17,7,2020,"42",3565287,619,12,580,39,607,0.33657879435793,1.09388108166327,0.0672413793103448
"United States","Connecticut","CT",2020-10-18,2020-10-24,7,2020,"43",3565287,683,35,588,95,648,0.981688150210628,2.66458212200028,0.16156462585034
"United States","Connecticut","CT",2020-10-25,2020-10-31,7,2020,"44",3565287,639,38,592,47,601,1.06583284880011,1.31826694456856,0.0793918918918919
"United States","Connecticut","CT",2020-11-01,2020-11-07,7,2020,"45",3565287,727,55,596,131,672,1.54265280747384,3.67431850507407,0.219798657718121
"United States","Connecticut","CT",2020-11-08,2020-11-14,7,2020,"46",3565287,685,67,602,83,618,1.87923160183177,2.32800332764235,0.137873754152824
"United States","Connecticut","CT",2020-11-15,2020-11-21,7,2020,"47",3565287,759,91,611,148,668,2.55238919054763,4.1511384637478,0.242225859247136
"United States","Connecticut","CT",2020-11-22,2020-11-28,7,2020,"48",3565287,757,133,622,135,624,3.73041497080039,3.78651143652671,0.217041800643087
"United States","Connecticut","CT",2020-11-29,2020-12-05,7,2020,"49",3565287,844,185,632,212,659,5.18892307968475,5.94622536699009,0.335443037974684
"United States","Connecticut","CT",2020-12-06,2020-12-12,7,2020,"50",3565287,845,217,636,209,628,6.08646653130589,5.86208066840061,0.328616352201258
"United States","Connecticut","CT",2020-12-13,2020-12-19,7,2020,"51",3565287,871,218,640,231,653,6.11451476416905,6.47914179139015,0.3609375
"United States","Connecticut","CT",2020-12-20,2020-12-26,7,2020,"52",3565287,920,210,647,273,710,5.89012890126377,7.6571675716429,0.421947449768161
"United States","Connecticut","CT",2020-12-27,2021-01-02,7,2020,"53",3565287,912,308,644,268,604,8.63885572185353,7.5169264073271,0.416149068322981
"United States","Connecticut","CT",2021-01-03,2021-01-09,7,2021,"1",3565287,849,225,658,191,624,6.31085239421118,5.35721247686371,0.290273556231003
"United States","Connecticut","CT",2021-01-10,2021-01-16,7,2021,"2",3565287,860,269,665,195,591,7.54497464019026,5.46940540831636,0.293233082706767
"United States","Connecticut","CT",2021-01-17,2021-01-23,7,2021,"3",3565287,854,226,676,178,628,6.33890062707434,4.99258544964262,0.263313609467456
"United States","Connecticut","CT",2021-01-24,2021-01-30,7,2021,"4",3565287,820,227,677,143,593,6.3669488599375,4.01089729943199,0.21122599704579
"United States","Connecticut","CT",2021-01-31,2021-02-06,7,2021,"5",3565287,775,168,681,94,607,4.71210312101102,2.63653388913712,0.138032305433186
"United States","Connecticut","CT",2021-02-07,2021-02-13,7,2021,"6",3565287,728,167,671,57,561,4.68405488814785,1.59874927320017,0.0849478390461997
"United States","Connecticut","CT",2021-02-14,2021-02-20,7,2021,"7",3565287,692,142,666,26,550,3.98284906656883,0.729254054442181,0.0390390390390389
"United States","Connecticut","CT",2021-02-21,2021-02-27,7,2021,"8",3565287,696,104,660,36,592,2.91701621776872,1.00973638307379,0.0545454545454545
"United States","Connecticut","CT",2021-02-28,2021-03-06,7,2021,"9",3565287,669,77,653,16,592,2.15971393046338,0.448771725810573,0.0245022970903521
"United States","Connecticut","CT",2021-03-07,2021-03-13,7,2021,"10",3565287,707,61,647,60,646,1.71094220465281,1.68289397178965,0.0927357032457496
"United States","Connecticut","CT",2021-03-14,2021-03-20,7,2021,"11",3565287,744,68,645,99,676,1.90727983469493,2.77677505345292,0.153488372093023
"United States","Connecticut","CT",2021-03-21,2021-03-27,7,2021,"12",3565287,782,36,649,133,746,1.00973638307379,3.73041497080039,0.204930662557781
"United States","Connecticut","CT",2021-03-28,2021-04-03,7,2021,"13",3565287,722,37,647,75,685,1.03778461593695,2.10361746473706,0.115919629057187
"United States","Connecticut","CT",2021-04-04,2021-04-10,7,2021,"14",3565287,676,38,637,39,638,1.06583284880011,1.09388108166327,0.0612244897959184
"United States","Connecticut","CT",2021-04-11,2021-04-17,7,2021,"15",3565287,714,51,640,74,663,1.4304598760212,2.0755692318739,0.115625
"United States","Connecticut","CT",2021-04-18,2021-04-24,7,2021,"16",3565287,712,52,626,86,660,1.45850810888436,2.41214802623183,0.137380191693291
"United States","Connecticut","CT",2021-04-25,2021-05-01,7,2021,"17",3565287,731,50,610,121,681,1.40241164315804,3.39383617644246,0.198360655737705
"United States","Connecticut","CT",2021-05-02,2021-05-08,7,2021,"18",3565287,661,40,595,66,621,1.12192931452643,1.85118336896861,0.110924369747899
"United States","Connecticut","CT",2021-05-09,2021-05-15,7,2021,"19",3565287,585,36,587,-2,549,1.00973638307379,-0.0560964657263216,-0.00340715502555367
"United States","Connecticut","CT",2021-05-16,2021-05-22,7,2021,"20",3565287,654,39,579,75,615,1.09388108166327,2.10361746473706,0.129533678756477
"United States","Connecticut","CT",2021-05-23,2021-05-29,7,2021,"21",3565287,736,26,577,159,710,0.729254054442181,4.45966902524257,0.275563258232236
"United States","Connecticut","CT",2021-05-30,2021-06-05,7,2021,"22",3565287,378,8,572,-194,370,0.224385862905286,-5.4413571754532,-0.339160839160839
"United States","Delaware","DE",2019-12-29,2020-01-04,7,2020,"1",973764,199,0,216,-17,199,0,-1.74580288447714,-0.0787037037037037
"United States","Delaware","DE",2020-01-05,2020-01-11,7,2020,"2",973764,194,0,215,-21,194,0,-2.15658003376588,-0.0976744186046512
"United States","Delaware","DE",2020-01-12,2020-01-18,7,2020,"3",973764,190,0,218,-28,190,0,-2.87544004502118,-0.128440366972477
"United States","Delaware","DE",2020-01-19,2020-01-25,7,2020,"4",973764,190,0,213,-23,190,0,-2.36196860841025,-0.107981220657277
"United States","Delaware","DE",2020-01-26,2020-02-01,7,2020,"5",973764,183,0,214,-31,183,0,-3.18352290698773,-0.144859813084112
"United States","Delaware","DE",2020-02-02,2020-02-08,7,2020,"6",973764,191,0,210,-19,191,0,-1.95119145912151,-0.0904761904761905
"United States","Delaware","DE",2020-02-09,2020-02-15,7,2020,"7",973764,202,0,205,-3,202,0,-0.308082861966554,-0.0146341463414634
"United States","Delaware","DE",2020-02-16,2020-02-22,7,2020,"8",973764,194,0,204,-10,194,0,-1.02694287322185,-0.0490196078431373
"United States","Delaware","DE",2020-02-23,2020-02-29,7,2020,"9",973764,164,0,202,-38,164,0,-3.90238291824302,-0.188118811881188
"United States","Delaware","DE",2020-03-01,2020-03-07,7,2020,"10",973764,200,0,203,-3,200,0,-0.308082861966554,-0.0147783251231527
"United States","Delaware","DE",2020-03-08,2020-03-14,7,2020,"11",973764,189,0,204,-15,189,0,-1.54041430983277,-0.0735294117647058
"United States","Delaware","DE",2020-03-15,2020-03-21,7,2020,"12",973764,221,0,206,15,221,0,1.54041430983277,0.0728155339805825
"United States","Delaware","DE",2020-03-22,2020-03-28,7,2020,"13",973764,188,5,204,-16,183,0.513471436610924,-1.64310859715496,-0.0784313725490197
"United States","Delaware","DE",2020-03-29,2020-04-04,7,2020,"14",973764,214,9,207,7,205,0.924248585899664,0.718860011255294,0.0338164251207729
"United States","Delaware","DE",2020-04-05,2020-04-11,7,2020,"15",973764,219,19,206,13,200,1.95119145912151,1.3350257351884,0.0631067961165048
"United States","Delaware","DE",2020-04-12,2020-04-18,7,2020,"16",973764,229,34,196,33,195,3.49160576895428,3.3889114816321,0.168367346938775
"United States","Delaware","DE",2020-04-19,2020-04-25,7,2020,"17",973764,285,45,189,96,240,4.62124292949832,9.85865158292974,0.507936507936508
"United States","Delaware","DE",2020-04-26,2020-05-02,7,2020,"18",973764,251,56,186,65,195,5.75088009004235,6.67512867594202,0.349462365591398
"United States","Delaware","DE",2020-05-03,2020-05-09,7,2020,"19",973764,271,34,181,90,237,3.49160576895428,9.24248585899664,0.497237569060774
"United States","Delaware","DE",2020-05-10,2020-05-16,7,2020,"20",973764,276,84,176,100,192,8.62632013506353,10.2694287322185,0.568181818181818
"United States","Delaware","DE",2020-05-17,2020-05-23,7,2020,"21",973764,222,38,178,44,184,3.90238291824302,4.51854864217613,0.247191011235955
"United States","Delaware","DE",2020-05-24,2020-05-30,7,2020,"22",973764,226,37,179,47,189,3.79968863092084,4.82663150414269,0.262569832402235
"United States","Delaware","DE",2020-05-31,2020-06-06,7,2020,"23",973764,182,29,176,6,153,2.97813433234336,0.616165723933109,0.0340909090909092
"United States","Delaware","DE",2020-06-07,2020-06-13,7,2020,"24",973764,200,29,173,27,171,2.97813433234336,2.77274575769899,0.15606936416185
"United States","Delaware","DE",2020-06-14,2020-06-20,7,2020,"25",973764,162,15,178,-16,147,1.54041430983277,-1.64310859715496,-0.0898876404494382
"United States","Delaware","DE",2020-06-21,2020-06-27,7,2020,"26",973764,201,73,176,25,128,7.49668297451949,2.56735718305462,0.142045454545455
"United States","Delaware","DE",2020-06-28,2020-07-04,7,2020,"27",973764,201,5,178,23,196,0.513471436610924,2.36196860841025,0.129213483146067
"United States","Delaware","DE",2020-07-05,2020-07-11,7,2020,"28",973764,194,3,179,15,191,0.308082861966554,1.54041430983277,0.0837988826815643
"United States","Delaware","DE",2020-07-12,2020-07-18,7,2020,"29",973764,191,8,176,15,183,0.821554298577479,1.54041430983277,0.0852272727272727
"United States","Delaware","DE",2020-07-19,2020-07-25,7,2020,"30",973764,201,56,173,28,145,5.75088009004235,2.87544004502118,0.161849710982659
"United States","Delaware","DE",2020-07-26,2020-08-01,7,2020,"31",973764,195,6,176,19,189,0.616165723933109,1.95119145912151,0.107954545454545
"United States","Delaware","DE",2020-08-02,2020-08-08,7,2020,"32",973764,197,5,173,24,192,0.513471436610924,2.46466289573244,0.138728323699422
"United States","Delaware","DE",2020-08-09,2020-08-15,7,2020,"33",973764,189,3,175,14,186,0.308082861966554,1.43772002251059,0.0800000000000001
"United States","Delaware","DE",2020-08-16,2020-08-22,7,2020,"34",973764,194,7,174,20,187,0.718860011255294,2.0538857464437,0.114942528735632
"United States","Delaware","DE",2020-08-23,2020-08-29,7,2020,"35",973764,190,4,174,16,186,0.410777149288739,1.64310859715496,0.0919540229885059
"United States","Delaware","DE",2020-08-30,2020-09-05,7,2020,"36",973764,208,4,173,35,204,0.410777149288739,3.59430005627647,0.202312138728324
"United States","Delaware","DE",2020-09-06,2020-09-12,7,2020,"37",973764,198,5,172,26,193,0.513471436610924,2.67005147037681,0.151162790697674
"United States","Delaware","DE",2020-09-13,2020-09-19,7,2020,"38",973764,161,8,171,-10,153,0.821554298577479,-1.02694287322185,-0.0584795321637427
"United States","Delaware","DE",2020-09-20,2020-09-26,7,2020,"39",973764,202,12,175,27,190,1.23233144786622,2.77274575769899,0.154285714285714
"United States","Delaware","DE",2020-09-27,2020-10-03,7,2020,"40",973764,202,12,177,25,190,1.23233144786622,2.56735718305462,0.141242937853107
"United States","Delaware","DE",2020-10-04,2020-10-10,7,2020,"41",973764,203,8,179,24,195,0.821554298577479,2.46466289573244,0.134078212290503
"United States","Delaware","DE",2020-10-11,2020-10-17,7,2020,"42",973764,203,12,176,27,191,1.23233144786622,2.77274575769899,0.153409090909091
"United States","Delaware","DE",2020-10-18,2020-10-24,7,2020,"43",973764,215,16,177,38,199,1.64310859715496,3.90238291824302,0.214689265536723
"United States","Delaware","DE",2020-10-25,2020-10-31,7,2020,"44",973764,195,28,176,19,167,2.87544004502118,1.95119145912151,0.107954545454545
"United States","Delaware","DE",2020-11-01,2020-11-07,7,2020,"45",973764,199,7,182,17,192,0.718860011255294,1.74580288447714,0.0934065934065933
"United States","Delaware","DE",2020-11-08,2020-11-14,7,2020,"46",973764,172,20,184,-12,152,2.0538857464437,-1.23233144786622,-0.0652173913043478
"United States","Delaware","DE",2020-11-15,2020-11-21,7,2020,"47",973764,232,12,186,46,220,1.23233144786622,4.7239372168205,0.247311827956989
"United States","Delaware","DE",2020-11-22,2020-11-28,7,2020,"48",973764,199,21,187,12,178,2.15658003376588,1.23233144786622,0.0641711229946524
"United States","Delaware","DE",2020-11-29,2020-12-05,7,2020,"49",973764,231,24,185,46,207,2.46466289573244,4.7239372168205,0.248648648648649
"United States","Delaware","DE",2020-12-06,2020-12-12,7,2020,"50",973764,277,22,191,86,255,2.25927432108807,8.8317087097079,0.450261780104712
"United States","Delaware","DE",2020-12-13,2020-12-19,7,2020,"51",973764,281,43,191,90,238,4.41585435485395,9.24248585899664,0.471204188481675
"United States","Delaware","DE",2020-12-20,2020-12-26,7,2020,"52",973764,289,36,197,92,253,3.69699434359865,9.447874433641,0.467005076142132
"United States","Delaware","DE",2020-12-27,2021-01-02,7,2020,"53",973764,285,36,199,86,249,3.69699434359865,8.8317087097079,0.432160804020101
"United States","Delaware","DE",2021-01-03,2021-01-09,7,2021,"1",973764,276,39,201,75,237,4.00507720556521,7.70207154916386,0.373134328358209
"United States","Delaware","DE",2021-01-10,2021-01-16,7,2021,"2",973764,295,47,200,95,248,4.82663150414269,9.75595729560756,0.475
"United States","Delaware","DE",2021-01-17,2021-01-23,7,2021,"3",973764,290,20,200,90,270,2.0538857464437,9.24248585899664,0.45
"United States","Delaware","DE",2021-01-24,2021-01-30,7,2021,"4",973764,273,45,197,76,228,4.62124292949832,7.80476583648605,0.385786802030457
"United States","Delaware","DE",2021-01-31,2021-02-06,7,2021,"5",973764,268,121,197,71,147,12.4260087659844,7.29129439987512,0.360406091370558
"United States","Delaware","DE",2021-02-07,2021-02-13,7,2021,"6",973764,240,80,194,46,160,8.21554298577479,4.7239372168205,0.237113402061856
"United States","Delaware","DE",2021-02-14,2021-02-20,7,2021,"7",973764,211,84,194,17,127,8.62632013506353,1.74580288447714,0.0876288659793814
"United States","Delaware","DE",2021-02-21,2021-02-27,7,2021,"8",973764,218,56,196,22,162,5.75088009004235,2.25927432108807,0.112244897959184
"United States","Delaware","DE",2021-02-28,2021-03-06,7,2021,"9",973764,223,42,194,29,181,4.31316006753176,2.97813433234336,0.149484536082474
"United States","Delaware","DE",2021-03-07,2021-03-13,7,2021,"10",973764,173,32,192,-19,141,3.28621719430991,-1.95119145912151,-0.0989583333333334
"United States","Delaware","DE",2021-03-14,2021-03-20,7,2021,"11",973764,215,26,192,23,189,2.67005147037681,2.36196860841025,0.119791666666667
"United States","Delaware","DE",2021-03-21,2021-03-27,7,2021,"12",973764,206,22,188,18,184,2.25927432108807,1.84849717179933,0.0957446808510638
"United States","Delaware","DE",2021-03-28,2021-04-03,7,2021,"13",973764,157,22,190,-33,135,2.25927432108807,-3.3889114816321,-0.173684210526316
"United States","Delaware","DE",2021-04-04,2021-04-10,7,2021,"14",973764,183,7,193,-10,176,0.718860011255294,-1.02694287322185,-0.0518134715025906
"United States","Delaware","DE",2021-04-11,2021-04-17,7,2021,"15",973764,203,29,187,16,174,2.97813433234336,1.64310859715496,0.0855614973262031
"United States","Delaware","DE",2021-04-18,2021-04-24,7,2021,"16",973764,186,13,177,9,173,1.3350257351884,0.924248585899664,0.0508474576271187
"United States","Delaware","DE",2021-04-25,2021-05-01,7,2021,"17",973764,190,11,180,10,179,1.12963716054403,1.02694287322185,0.0555555555555556
"United States","Delaware","DE",2021-05-02,2021-05-08,7,2021,"18",973764,184,10,176,8,174,1.02694287322185,0.821554298577479,0.0454545454545454
"United States","Delaware","DE",2021-05-09,2021-05-15,7,2021,"19",973764,197,15,175,22,182,1.54041430983277,2.25927432108807,0.125714285714286
"United States","Delaware","DE",2021-05-16,2021-05-22,7,2021,"20",973764,191,8,173,18,183,0.821554298577479,1.84849717179933,0.104046242774567
"United States","Delaware","DE",2021-05-23,2021-05-29,7,2021,"21",973764,180,2,176,4,178,0.20538857464437,0.410777149288739,0.0227272727272727
"United States","Delaware","DE",2021-05-30,2021-06-05,7,2021,"22",973764,140,16,174,-34,124,1.64310859715496,-3.49160576895428,-0.195402298850575
"United States","Delaware","DE",2021-06-13,2021-06-19,7,2021,"24",973764,131,0,170,-39,131,0,-4.00507720556521,-0.229411764705882
"United States","Delaware","DE",2021-06-20,2021-06-26,7,2021,"25",973764,173,14,175,-2,159,1.43772002251059,-0.20538857464437,-0.0114285714285715
"United States","District of Columbia","DC",2019-12-29,2020-01-04,7,2020,"1",705749,132,0,136,-4,132,0,-0.56677373967232,-0.0294117647058824
"United States","District of Columbia","DC",2020-01-05,2020-01-11,7,2020,"2",705749,128,0,133,-5,128,0,-0.7084671745904,-0.0375939849624061
"United States","District of Columbia","DC",2020-01-12,2020-01-18,7,2020,"3",705749,140,0,134,6,140,0,0.85016060950848,0.044776119402985
"United States","District of Columbia","DC",2020-01-19,2020-01-25,7,2020,"4",705749,131,0,132,-1,131,0,-0.14169343491808,-0.00757575757575757
"United States","District of Columbia","DC",2020-01-26,2020-02-01,7,2020,"5",705749,143,0,132,11,143,0,1.55862778409888,0.0833333333333333
"United States","District of Columbia","DC",2020-02-02,2020-02-08,7,2020,"6",705749,131,0,130,1,131,0,0.14169343491808,0.00769230769230766
"United States","District of Columbia","DC",2020-02-09,2020-02-15,7,2020,"7",705749,122,0,130,-8,122,0,-1.13354747934464,-0.0615384615384615
"United States","District of Columbia","DC",2020-02-16,2020-02-22,7,2020,"8",705749,104,0,128,-24,104,0,-3.40064243803392,-0.1875
"United States","District of Columbia","DC",2020-02-23,2020-02-29,7,2020,"9",705749,135,0,125,10,135,0,1.4169343491808,0.0800000000000001
"United States","District of Columbia","DC",2020-03-01,2020-03-07,7,2020,"10",705749,118,0,123,-5,118,0,-0.7084671745904,-0.040650406504065
"United States","District of Columbia","DC",2020-03-08,2020-03-14,7,2020,"11",705749,114,0,124,-10,114,0,-1.4169343491808,-0.0806451612903226
"United States","District of Columbia","DC",2020-03-15,2020-03-21,7,2020,"12",705749,129,1,124,5,128,0.14169343491808,0.7084671745904,0.0403225806451613
"United States","District of Columbia","DC",2020-03-22,2020-03-28,7,2020,"13",705749,130,4,123,7,126,0.56677373967232,0.99185404442656,0.056910569105691
"United States","District of Columbia","DC",2020-03-29,2020-04-04,7,2020,"14",705749,156,16,121,35,140,2.26709495868928,4.9592702221328,0.289256198347107
"United States","District of Columbia","DC",2020-04-05,2020-04-11,7,2020,"15",705749,194,1,125,69,193,0.14169343491808,9.77684700934752,0.552
"United States","District of Columbia","DC",2020-04-12,2020-04-18,7,2020,"16",705749,202,69,124,78,133,9.77684700934752,11.0520879236102,0.629032258064516
"United States","District of Columbia","DC",2020-04-19,2020-04-25,7,2020,"17",705749,242,74,120,122,168,10.4853141839379,17.2865990600058,1.01666666666667
"United States","District of Columbia","DC",2020-04-26,2020-05-02,7,2020,"18",705749,215,75,118,97,140,10.627007618856,13.7442631870538,0.822033898305085
"United States","District of Columbia","DC",2020-05-03,2020-05-09,7,2020,"19",705749,214,71,120,94,143,10.0602338791837,13.3191828822995,0.783333333333333
"United States","District of Columbia","DC",2020-05-10,2020-05-16,7,2020,"20",705749,185,64,115,70,121,9.06837983475712,9.9185404442656,0.608695652173913
"United States","District of Columbia","DC",2020-05-17,2020-05-23,7,2020,"21",705749,181,52,112,69,129,7.36805861574016,9.77684700934752,0.616071428571429
"United States","District of Columbia","DC",2020-05-24,2020-05-30,7,2020,"22",705749,169,35,113,56,134,4.9592702221328,7.93483235541248,0.495575221238938
"United States","District of Columbia","DC",2020-05-31,2020-06-06,7,2020,"23",705749,149,21,111,38,128,2.97556213327968,5.38435052688704,0.342342342342342
"United States","District of Columbia","DC",2020-06-07,2020-06-13,7,2020,"24",705749,147,28,110,37,119,3.96741617770624,5.24265709196896,0.336363636363636
"United States","District of Columbia","DC",2020-06-14,2020-06-20,7,2020,"25",705749,132,20,110,22,112,2.8338686983616,3.11725556819776,0.2
"United States","District of Columbia","DC",2020-06-21,2020-06-27,7,2020,"26",705749,130,17,109,21,113,2.40878839360736,2.97556213327968,0.192660550458716
"United States","District of Columbia","DC",2020-06-28,2020-07-04,7,2020,"27",705749,122,9,109,13,113,1.27524091426272,1.84201465393504,0.119266055045872
"United States","District of Columbia","DC",2020-07-05,2020-07-11,7,2020,"28",705749,138,11,109,29,127,1.55862778409888,4.10910961262432,0.26605504587156
"United States","District of Columbia","DC",2020-07-12,2020-07-18,7,2020,"29",705749,121,10,109,12,111,1.4169343491808,1.70032121901696,0.110091743119266
"United States","District of Columbia","DC",2020-07-19,2020-07-25,7,2020,"30",705749,123,3,105,18,120,0.42508030475424,2.55048182852544,0.171428571428571
"United States","District of Columbia","DC",2020-07-26,2020-08-01,7,2020,"31",705749,130,4,106,24,126,0.56677373967232,3.40064243803392,0.226415094339623
"United States","District of Columbia","DC",2020-08-02,2020-08-08,7,2020,"32",705749,118,5,104,14,113,0.7084671745904,1.98370808885312,0.134615384615385
"United States","District of Columbia","DC",2020-08-09,2020-08-15,7,2020,"33",705749,117,7,103,14,110,0.99185404442656,1.98370808885312,0.135922330097087
"United States","District of Columbia","DC",2020-08-16,2020-08-22,7,2020,"34",705749,113,7,102,11,106,0.99185404442656,1.55862778409888,0.107843137254902
"United States","District of Columbia","DC",2020-08-23,2020-08-29,7,2020,"35",705749,140,1,103,37,139,0.14169343491808,5.24265709196896,0.359223300970874
"United States","District of Columbia","DC",2020-08-30,2020-09-05,7,2020,"36",705749,143,6,101,42,137,0.85016060950848,5.95112426655936,0.415841584158416
"United States","District of Columbia","DC",2020-09-06,2020-09-12,7,2020,"37",705749,125,5,103,22,120,0.7084671745904,3.11725556819776,0.213592233009709
"United States","District of Columbia","DC",2020-09-13,2020-09-19,7,2020,"38",705749,109,0,106,3,109,0,0.42508030475424,0.0283018867924529
"United States","District of Columbia","DC",2020-09-20,2020-09-26,7,2020,"39",705749,112,8,108,4,104,1.13354747934464,0.56677373967232,0.037037037037037
"United States","District of Columbia","DC",2020-09-27,2020-10-03,7,2020,"40",705749,138,5,108,30,133,0.7084671745904,4.2508030475424,0.277777777777778
"United States","District of Columbia","DC",2020-10-04,2020-10-10,7,2020,"41",705749,146,7,109,37,139,0.99185404442656,5.24265709196896,0.339449541284404
"United States","District of Columbia","DC",2020-10-11,2020-10-17,7,2020,"42",705749,118,5,107,11,113,0.7084671745904,1.55862778409888,0.102803738317757
"United States","District of Columbia","DC",2020-10-18,2020-10-24,7,2020,"43",705749,105,1,105,0,104,0.14169343491808,0,0
"United States","District of Columbia","DC",2020-10-25,2020-10-31,7,2020,"44",705749,128,4,105,23,124,0.56677373967232,3.25894900311584,0.219047619047619
"United States","District of Columbia","DC",2020-11-01,2020-11-07,7,2020,"45",705749,137,8,104,33,129,1.13354747934464,4.67588335229664,0.317307692307692
"United States","District of Columbia","DC",2020-11-08,2020-11-14,7,2020,"46",705749,130,4,102,28,126,0.56677373967232,3.96741617770624,0.274509803921569
"United States","District of Columbia","DC",2020-11-15,2020-11-21,7,2020,"47",705749,135,12,103,32,123,1.70032121901696,4.53418991737856,0.310679611650486
"United States","District of Columbia","DC",2020-11-22,2020-11-28,7,2020,"48",705749,120,8,106,14,112,1.13354747934464,1.98370808885312,0.132075471698113
"United States","District of Columbia","DC",2020-11-29,2020-12-05,7,2020,"49",705749,153,17,107,46,136,2.40878839360736,6.51789800623168,0.429906542056075
"United States","District of Columbia","DC",2020-12-06,2020-12-12,7,2020,"50",705749,175,18,109,66,157,2.55048182852544,9.35176670459328,0.605504587155963
"United States","District of Columbia","DC",2020-12-13,2020-12-19,7,2020,"51",705749,144,17,111,33,127,2.40878839360736,4.67588335229664,0.297297297297297
"United States","District of Columbia","DC",2020-12-20,2020-12-26,7,2020,"52",705749,165,32,114,51,133,4.53418991737856,7.22636518082208,0.447368421052632
"United States","District of Columbia","DC",2020-12-27,2021-01-02,7,2020,"53",705749,178,30,115,63,148,4.2508030475424,8.92668639983904,0.547826086956522
"United States","District of Columbia","DC",2021-01-03,2021-01-09,7,2021,"1",705749,173,21,110,63,152,2.97556213327968,8.92668639983904,0.572727272727273
"United States","District of Columbia","DC",2021-01-10,2021-01-16,7,2021,"2",705749,173,34,112,61,139,4.81757678721472,8.64329953000288,0.544642857142857
"United States","District of Columbia","DC",2021-01-17,2021-01-23,7,2021,"3",705749,163,23,113,50,140,3.25894900311584,7.084671745904,0.442477876106195
"United States","District of Columbia","DC",2021-01-24,2021-01-30,7,2021,"4",705749,183,39,109,74,144,5.52604396180512,10.4853141839379,0.678899082568807
"United States","District of Columbia","DC",2021-01-31,2021-02-06,7,2021,"5",705749,167,38,112,55,129,5.38435052688704,7.7931389204944,0.491071428571429
"United States","District of Columbia","DC",2021-02-07,2021-02-13,7,2021,"6",705749,156,32,109,47,124,4.53418991737856,6.65959144114976,0.431192660550459
"United States","District of Columbia","DC",2021-02-14,2021-02-20,7,2021,"7",705749,170,15,108,62,155,2.1254015237712,8.78499296492096,0.574074074074074
"United States","District of Columbia","DC",2021-02-21,2021-02-27,7,2021,"8",705749,147,11,108,39,136,1.55862778409888,5.52604396180512,0.361111111111111
"United States","District of Columbia","DC",2021-02-28,2021-03-06,7,2021,"9",705749,137,25,105,32,112,3.542335872952,4.53418991737856,0.304761904761905
"United States","District of Columbia","DC",2021-03-07,2021-03-13,7,2021,"10",705749,128,10,105,23,118,1.4169343491808,3.25894900311584,0.219047619047619
"United States","District of Columbia","DC",2021-03-14,2021-03-20,7,2021,"11",705749,148,9,108,40,139,1.27524091426272,5.6677373967232,0.37037037037037
"United States","District of Columbia","DC",2021-03-21,2021-03-27,7,2021,"12",705749,138,7,106,32,131,0.99185404442656,4.53418991737856,0.30188679245283
"United States","District of Columbia","DC",2021-03-28,2021-04-03,7,2021,"13",705749,129,14,106,23,115,1.98370808885312,3.25894900311584,0.216981132075472
"United States","District of Columbia","DC",2021-04-04,2021-04-10,7,2021,"14",705749,161,11,109,52,150,1.55862778409888,7.36805861574016,0.477064220183486
"United States","District of Columbia","DC",2021-04-11,2021-04-17,7,2021,"15",705749,125,14,111,14,111,1.98370808885312,1.98370808885312,0.126126126126126
"United States","District of Columbia","DC",2021-04-18,2021-04-24,7,2021,"16",705749,130,4,110,20,126,0.56677373967232,2.8338686983616,0.181818181818182
"United States","District of Columbia","DC",2021-04-25,2021-05-01,7,2021,"17",705749,124,7,108,16,117,0.99185404442656,2.26709495868928,0.148148148148148
"United States","District of Columbia","DC",2021-05-02,2021-05-08,7,2021,"18",705749,124,4,108,16,120,0.56677373967232,2.26709495868928,0.148148148148148
"United States","District of Columbia","DC",2021-05-09,2021-05-15,7,2021,"19",705749,128,8,107,21,120,1.13354747934464,2.97556213327968,0.196261682242991
"United States","District of Columbia","DC",2021-05-16,2021-05-22,7,2021,"20",705749,129,7,107,22,122,0.99185404442656,3.11725556819776,0.205607476635514
"United States","District of Columbia","DC",2021-05-23,2021-05-29,7,2021,"21",705749,120,7,105,15,113,0.99185404442656,2.1254015237712,0.142857142857143
"United States","District of Columbia","DC",2021-05-30,2021-06-05,7,2021,"22",705749,125,4,107,18,121,0.56677373967232,2.55048182852544,0.168224299065421
"United States","District of Columbia","DC",2021-06-06,2021-06-12,7,2021,"23",705749,136,1,106,30,135,0.14169343491808,4.2508030475424,0.283018867924528
"United States","District of Columbia","DC",2021-06-13,2021-06-19,7,2021,"24",705749,112,4,108,4,108,0.56677373967232,0.56677373967232,0.037037037037037
"United States","District of Columbia","DC",2021-06-20,2021-06-26,7,2021,"25",705749,74,0,108,-34,74,0,-4.81757678721472,-0.314814814814815
"United States","Florida","FL",2019-12-29,2020-01-04,7,2020,"1",21477737,4341,0,4435,-94,4341,0,-0.437662496751869,-0.02119503945885
"United States","Florida","FL",2020-01-05,2020-01-11,7,2020,"2",21477737,4410,0,4502,-92,4410,0,-0.428350528735872,-0.0204353620613061
"United States","Florida","FL",2020-01-12,2020-01-18,7,2020,"3",21477737,4385,0,4686,-301,4385,0,-1.40145118640758,-0.0642338881775502
"United States","Florida","FL",2020-01-19,2020-01-25,7,2020,"4",21477737,4387,0,4687,-300,4387,0,-1.39679520239958,-0.0640068273949221
"United States","Florida","FL",2020-01-26,2020-02-01,7,2020,"5",21477737,4419,0,4658,-239,4419,0,-1.11278017791167,-0.0513095749248604
"United States","Florida","FL",2020-02-02,2020-02-08,7,2020,"6",21477737,4385,0,4607,-222,4385,0,-1.03362844977569,-0.0481875406989364
"United States","Florida","FL",2020-02-09,2020-02-15,7,2020,"7",21477737,4358,0,4560,-202,4358,0,-0.940508769615719,-0.0442982456140351
"United States","Florida","FL",2020-02-16,2020-02-22,7,2020,"8",21477737,4416,0,4512,-96,4416,0,-0.446974464767866,-0.0212765957446809
"United States","Florida","FL",2020-02-23,2020-02-29,7,2020,"9",21477737,4399,0,4499,-100,4399,0,-0.465598400799861,-0.0222271615914648
"United States","Florida","FL",2020-03-01,2020-03-07,7,2020,"10",21477737,4520,2,4480,40,4518,0.00931196801599722,0.186239360319944,0.0089285714285714
"United States","Florida","FL",2020-03-08,2020-03-14,7,2020,"11",21477737,4435,1,4464,-29,4434,0.00465598400799861,-0.13502353623196,-0.00649641577060933
"United States","Florida","FL",2020-03-15,2020-03-21,7,2020,"12",21477737,4362,7,4437,-75,4355,0.0325918880559903,-0.349198800599896,-0.0169033130493577
"United States","Florida","FL",2020-03-22,2020-03-28,7,2020,"13",21477737,4461,46,4432,29,4415,0.214175264367936,0.13502353623196,0.00654332129963908
"United States","Florida","FL",2020-03-29,2020-04-04,7,2020,"14",21477737,4497,139,4356,141,4358,0.647181777111806,0.656493745127804,0.0323691460055096
"United States","Florida","FL",2020-04-05,2020-04-11,7,2020,"15",21477737,4544,251,4306,238,4293,1.16865198600765,1.10812419390367,0.0552717138875987
"United States","Florida","FL",2020-04-12,2020-04-18,7,2020,"16",21477737,4416,304,4223,193,4112,1.41541913843158,0.898604913543731,0.045702107506512
"United States","Florida","FL",2020-04-19,2020-04-25,7,2020,"17",21477737,4555,304,4182,373,4251,1.41541913843158,1.73668203498348,0.0891917742706838
"United States","Florida","FL",2020-04-26,2020-05-02,7,2020,"18",21477737,4352,310,4132,220,4042,1.44335504247957,1.02431648175969,0.0532429816069699
"United States","Florida","FL",2020-05-03,2020-05-09,7,2020,"19",21477737,4407,349,4065,342,4058,1.62493841879151,1.59234653073552,0.0841328413284133
"United States","Florida","FL",2020-05-10,2020-05-16,7,2020,"20",21477737,4279,250,4029,250,4029,1.16399600199965,1.16399600199965,0.0620501365103003
"United States","Florida","FL",2020-05-17,2020-05-23,7,2020,"21",21477737,4360,269,4000,360,4091,1.25245969815163,1.6761542428795,0.0900000000000001
"United States","Florida","FL",2020-05-24,2020-05-30,7,2020,"22",21477737,4211,214,3983,228,3997,0.996380577711702,1.06156435382368,0.0572432839568164
"United States","Florida","FL",2020-05-31,2020-06-06,7,2020,"23",21477737,4265,242,3970,295,4023,1.12674812993566,1.37351528235959,0.0743073047858942
"United States","Florida","FL",2020-06-07,2020-06-13,7,2020,"24",21477737,4256,237,3949,307,4019,1.10346820989567,1.42938709045557,0.0777412003038744
"United States","Florida","FL",2020-06-14,2020-06-20,7,2020,"25",21477737,4408,219,3953,455,4189,1.0196604977517,2.11847272363937,0.115102453832532
"United States","Florida","FL",2020-06-21,2020-06-27,7,2020,"26",21477737,4504,246,3917,587,4258,1.14537206596766,2.73306261269518,0.149859586418177
"United States","Florida","FL",2020-06-28,2020-07-04,7,2020,"27",21477737,4725,312,3915,810,4413,1.45266701049557,3.77134704647887,0.206896551724138
"United States","Florida","FL",2020-07-05,2020-07-11,7,2020,"28",21477737,5084,495,3905,1179,4589,2.30471208395931,5.48940514543036,0.301920614596671
"United States","Florida","FL",2020-07-12,2020-07-18,7,2020,"29",21477737,5509,698,3891,1618,4811,3.24987683758303,7.53338212494175,0.415831405808275
"United States","Florida","FL",2020-07-19,2020-07-25,7,2020,"30",21477737,5704,882,3845,1859,4822,4.10657789505477,8.65547427086941,0.483485045513654
"United States","Florida","FL",2020-07-26,2020-08-01,7,2020,"31",21477737,5791,1245,3828,1963,4546,5.79670008995827,9.13969660770127,0.512800417972832
"United States","Florida","FL",2020-08-02,2020-08-08,7,2020,"32",21477737,5585,1087,3812,1773,4498,5.06105461669449,8.25505964618153,0.46511017838405
"United States","Florida","FL",2020-08-09,2020-08-15,7,2020,"33",21477737,5510,1236,3801,1709,4274,5.75479623388628,7.95707666966962,0.449618521441726
"United States","Florida","FL",2020-08-16,2020-08-22,7,2020,"34",21477737,5203,929,3791,1412,4274,4.32540914343071,6.57424941929404,0.372461092060143
"United States","Florida","FL",2020-08-23,2020-08-29,7,2020,"35",21477737,5015,831,3806,1209,4184,3.86912271064684,5.62908466567032,0.317656332107199
"United States","Florida","FL",2020-08-30,2020-09-05,7,2020,"36",21477737,4758,706,3808,950,4052,3.28712470964702,4.42318480759868,0.249474789915966
"United States","Florida","FL",2020-09-06,2020-09-12,7,2020,"37",21477737,4513,789,3822,691,3724,3.6735713823109,3.21728494952704,0.180795395081109
"United States","Florida","FL",2020-09-13,2020-09-19,7,2020,"38",21477737,4667,687,3838,829,3980,3.19866101349504,3.85981074263085,0.215997915581032
"United States","Florida","FL",2020-09-20,2020-09-26,7,2020,"39",21477737,4444,735,3860,584,3709,3.42214824587898,2.71909466067119,0.151295336787565
"United States","Florida","FL",2020-09-27,2020-10-03,7,2020,"40",21477737,4346,606,3844,502,3740,2.82152630884716,2.3373039720153,0.130593132154006
"United States","Florida","FL",2020-10-04,2020-10-10,7,2020,"41",21477737,4525,736,3862,663,3789,3.42680422988698,3.08691739730308,0.171672708441222
"United States","Florida","FL",2020-10-11,2020-10-17,7,2020,"42",21477737,4389,553,3848,541,3836,2.57475915642323,2.51888734832725,0.140592515592516
"United States","Florida","FL",2020-10-18,2020-10-24,7,2020,"43",21477737,4335,500,3867,468,3835,2.3279920039993,2.17900051574335,0.121024049650892
"United States","Florida","FL",2020-10-25,2020-10-31,7,2020,"44",21477737,4265,344,3885,380,3921,1.60165849875152,1.76927392303947,0.0978120978120978
"United States","Florida","FL",2020-11-01,2020-11-07,7,2020,"45",21477737,4305,339,3918,387,3966,1.57837857871153,1.80186581109546,0.0987748851454824
"United States","Florida","FL",2020-11-08,2020-11-14,7,2020,"46",21477737,4487,388,3946,541,4099,1.80652179510346,2.51888734832725,0.137100861632032
"United States","Florida","FL",2020-11-15,2020-11-21,7,2020,"47",21477737,4561,442,4014,547,4119,2.05794493153538,2.54682325237524,0.136273044344793
"United States","Florida","FL",2020-11-22,2020-11-28,7,2020,"48",21477737,4634,507,4043,591,4127,2.36058389205529,2.75168654872718,0.146178580262182
"United States","Florida","FL",2020-11-29,2020-12-05,7,2020,"49",21477737,4911,632,4074,837,4279,2.94258189305512,3.89705861469483,0.205449189985272
"United States","Florida","FL",2020-12-06,2020-12-12,7,2020,"50",21477737,5085,716,4122,963,4369,3.333684549727,4.48371259970266,0.233624454148472
"United States","Florida","FL",2020-12-13,2020-12-19,7,2020,"51",21477737,4945,688,4169,776,4257,3.20331699750304,3.61304359020692,0.186135763972176
"United States","Florida","FL",2020-12-20,2020-12-26,7,2020,"52",21477737,5137,661,4192,945,4476,3.07760542928708,4.39990488755868,0.225429389312977
"United States","Florida","FL",2020-12-27,2021-01-02,7,2020,"53",21477737,5708,753,4275,1433,4955,3.50595595802295,6.67202508346201,0.335204678362573
"United States","Florida","FL",2021-01-03,2021-01-09,7,2021,"1",21477737,5497,917,4309,1188,4580,4.26953733533472,5.53130900150235,0.275702019029937
"United States","Florida","FL",2021-01-10,2021-01-16,7,2021,"2",21477737,5944,1200,4324,1620,4744,5.58718080959833,7.54269409295774,0.374653098982424
"United States","Florida","FL",2021-01-17,2021-01-23,7,2021,"3",21477737,5684,1160,4427,1257,4524,5.40094144927839,5.85257189805425,0.28393946238988
"United States","Florida","FL",2021-01-24,2021-01-30,7,2021,"4",21477737,5506,1196,4488,1018,4310,5.56855687356634,4.73979172014258,0.226827094474153
"United States","Florida","FL",2021-01-31,2021-02-06,7,2021,"5",21477737,5589,1243,4439,1150,4346,5.78738812194227,5.3543816091984,0.259067357512953
"United States","Florida","FL",2021-02-07,2021-02-13,7,2021,"6",21477737,5479,1085,4453,1026,4394,5.05174264867849,4.77703959220657,0.230406467549966
"United States","Florida","FL",2021-02-14,2021-02-20,7,2021,"7",21477737,5137,1126,4356,781,4011,5.24263799300643,3.63632351024691,0.179292929292929
"United States","Florida","FL",2021-02-21,2021-02-27,7,2021,"8",21477737,4909,926,4312,597,3983,4.31144119140671,2.77962245277517,0.138450834879406
"United States","Florida","FL",2021-02-28,2021-03-06,7,2021,"9",21477737,4838,886,4289,549,3952,4.12520183108677,2.55613522039124,0.128001865236652
"United States","Florida","FL",2021-03-07,2021-03-13,7,2021,"10",21477737,4653,628,4298,355,4025,2.92395795702313,1.65287432283951,0.0825965565379245
"United States","Florida","FL",2021-03-14,2021-03-20,7,2021,"11",21477737,4598,477,4299,299,4121,2.22090437181534,1.39213921839158,0.0695510583856711
"United States","Florida","FL",2021-03-21,2021-03-27,7,2021,"12",21477737,4748,444,4281,467,4304,2.06725689955138,2.17434453173535,0.109086661994861
"United States","Florida","FL",2021-03-28,2021-04-03,7,2021,"13",21477737,4490,497,4250,240,3993,2.31402405197531,1.11743616191967,0.0564705882352941
"United States","Florida","FL",2021-04-04,2021-04-10,7,2021,"14",21477737,4716,342,4199,517,4374,1.59234653073552,2.40714373213528,0.123124553465111
"United States","Florida","FL",2021-04-11,2021-04-17,7,2021,"15",21477737,4664,390,4140,524,4274,1.81583376311946,2.43973562019127,0.126570048309179
"United States","Florida","FL",2021-04-18,2021-04-24,7,2021,"16",21477737,4748,408,4119,629,4340,1.89964147526343,2.92861394103112,0.152706967710609
"United States","Florida","FL",2021-04-25,2021-05-01,7,2021,"17",21477737,4497,427,4070,427,4070,1.98810517141541,1.98810517141541,0.104914004914005
"United States","Florida","FL",2021-05-02,2021-05-08,7,2021,"18",21477737,4617,461,3996,621,4156,2.14640862768736,2.89136606896714,0.155405405405405
"United States","Florida","FL",2021-05-09,2021-05-15,7,2021,"19",21477737,4539,356,3950,589,4183,1.6575303068475,2.74237458071118,0.149113924050633
"United States","Florida","FL",2021-05-16,2021-05-22,7,2021,"20",21477737,4599,407,3944,655,4192,1.89498549125543,3.04966952523909,0.166075050709939
"United States","Florida","FL",2021-05-23,2021-05-29,7,2021,"21",21477737,4514,311,3933,581,4203,1.44801102648757,2.70512670864719,0.147724383422324
"United States","Florida","FL",2021-05-30,2021-06-05,7,2021,"22",21477737,4385,199,3895,490,4186,0.926540817591723,2.28143216391932,0.125802310654686
"United States","Florida","FL",2021-06-06,2021-06-12,7,2021,"23",21477737,4361,292,3885,476,4069,1.35954733033559,2.21624838780734,0.122522522522523
"United States","Florida","FL",2021-06-13,2021-06-19,7,2021,"24",21477737,4163,290,3886,277,3873,1.3502353623196,1.28970757021561,0.0712815234173958
"United States","Florida","FL",2021-06-20,2021-06-26,7,2021,"25",21477737,3531,217,3897,-366,3314,1.0103485297357,-1.70409014692749,-0.0939183987682833
"United States","Georgia","GA",2019-12-29,2020-01-04,7,2020,"1",10617423,1803,0,1879,-76,1803,0,-0.715804578945381,-0.0404470463012241
"United States","Georgia","GA",2020-01-05,2020-01-11,7,2020,"2",10617423,1806,0,1900,-94,1806,0,-0.885337242379813,-0.0494736842105263
"United States","Georgia","GA",2020-01-12,2020-01-18,7,2020,"3",10617423,1746,0,1915,-169,1746,0,-1.59172334002328,-0.0882506527415143
"United States","Georgia","GA",2020-01-19,2020-01-25,7,2020,"4",10617423,1829,0,1898,-69,1829,0,-0.64987520983199,-0.0363540569020021
"United States","Georgia","GA",2020-01-26,2020-02-01,7,2020,"5",10617423,1797,0,1879,-82,1797,0,-0.772315466756858,-0.0436402341671102
"United States","Georgia","GA",2020-02-02,2020-02-08,7,2020,"6",10617423,1781,0,1837,-56,1781,0,-0.527434952907123,-0.0304844855743059
"United States","Georgia","GA",2020-02-09,2020-02-15,7,2020,"7",10617423,1762,0,1799,-37,1762,0,-0.348483808170777,-0.0205669816564759
"United States","Georgia","GA",2020-02-16,2020-02-22,7,2020,"8",10617423,1749,0,1744,5,1749,0,0.0470924065095645,0.00286697247706424
"United States","Georgia","GA",2020-02-23,2020-02-29,7,2020,"9",10617423,1860,0,1751,109,1860,0,1.02661446190851,0.0622501427755568
"United States","Georgia","GA",2020-03-01,2020-03-07,7,2020,"10",10617423,1755,0,1762,-7,1755,0,-0.0659293691133903,-0.00397275822928489
"United States","Georgia","GA",2020-03-08,2020-03-14,7,2020,"11",10617423,1784,1,1760,24,1783,0.0094184813019129,0.22604355124591,0.0136363636363637
"United States","Georgia","GA",2020-03-15,2020-03-21,7,2020,"12",10617423,1775,19,1759,16,1756,0.178951144736345,0.150695700830606,0.00909607731665729
"United States","Georgia","GA",2020-03-22,2020-03-28,7,2020,"13",10617423,1881,58,1745,136,1823,0.546271915510948,1.28091345706015,0.0779369627507163
"United States","Georgia","GA",2020-03-29,2020-04-04,7,2020,"14",10617423,2033,129,1729,304,1904,1.21498408794676,2.86321831578152,0.175824175824176
"United States","Georgia","GA",2020-04-05,2020-04-11,7,2020,"15",10617423,2041,223,1724,317,1818,2.10032133032658,2.98565857270639,0.183874709976798
"United States","Georgia","GA",2020-04-12,2020-04-18,7,2020,"16",10617423,2032,243,1701,331,1789,2.28869095636484,3.11751731093317,0.194591416813639
"United States","Georgia","GA",2020-04-19,2020-04-25,7,2020,"17",10617423,2040,229,1681,359,1811,2.15683221813805,3.38123478738673,0.213563355145747
"United States","Georgia","GA",2020-04-26,2020-05-02,7,2020,"18",10617423,1975,263,1653,322,1712,2.47706058240309,3.03275097921595,0.194797338173019
"United States","Georgia","GA",2020-05-03,2020-05-09,7,2020,"19",10617423,1987,225,1647,340,1762,2.1191582929304,3.20228364265039,0.206435944140862
"United States","Georgia","GA",2020-05-10,2020-05-16,7,2020,"20",10617423,1961,194,1633,328,1767,1.8271853725711,3.08926186702743,0.200857317819963
"United States","Georgia","GA",2020-05-17,2020-05-23,7,2020,"21",10617423,1910,234,1614,296,1676,2.20392462464762,2.78787046536622,0.183395291201983
"United States","Georgia","GA",2020-05-24,2020-05-30,7,2020,"22",10617423,1784,180,1598,186,1604,1.69532663434432,1.7518375221558,0.11639549436796
"United States","Georgia","GA",2020-05-31,2020-06-06,7,2020,"23",10617423,1782,173,1598,184,1609,1.62939726523093,1.73300055955197,0.11514392991239
"United States","Georgia","GA",2020-06-07,2020-06-13,7,2020,"24",10617423,1746,269,1600,146,1477,2.53357147021457,1.37509827007928,0.0912500000000001
"United States","Georgia","GA",2020-06-14,2020-06-20,7,2020,"25",10617423,1780,192,1592,188,1588,1.80834840996728,1.77067448475963,0.118090452261306
"United States","Georgia","GA",2020-06-21,2020-06-27,7,2020,"26",10617423,1823,145,1588,235,1678,1.36567978877737,2.21334310594953,0.147984886649874
"United States","Georgia","GA",2020-06-28,2020-07-04,7,2020,"27",10617423,1879,83,1580,299,1796,0.781733948058771,2.81612590927196,0.189240506329114
"United States","Georgia","GA",2020-07-05,2020-07-11,7,2020,"28",10617423,1983,137,1582,401,1846,1.29033193836207,3.77681100206707,0.253476611883692
"United States","Georgia","GA",2020-07-12,2020-07-18,7,2020,"29",10617423,2176,171,1577,599,2005,1.61056030262711,5.64167029984583,0.379835129993659
"United States","Georgia","GA",2020-07-19,2020-07-25,7,2020,"30",10617423,2177,327,1584,593,1850,3.07984338572552,5.58515941203435,0.374368686868687
"United States","Georgia","GA",2020-07-26,2020-08-01,7,2020,"31",10617423,2192,330,1584,608,1862,3.10809882963126,5.72643663156305,0.383838383838384
"United States","Georgia","GA",2020-08-02,2020-08-08,7,2020,"32",10617423,2192,361,1593,599,1831,3.40007174999056,5.64167029984583,0.376020087884495
"United States","Georgia","GA",2020-08-09,2020-08-15,7,2020,"33",10617423,2244,483,1587,657,1761,4.54912646882393,6.18794221535678,0.413988657844991
"United States","Georgia","GA",2020-08-16,2020-08-22,7,2020,"34",10617423,2247,423,1576,671,1824,3.98401759070916,6.31980095358356,0.425761421319797
"United States","Georgia","GA",2020-08-23,2020-08-29,7,2020,"35",10617423,2132,484,1575,557,1648,4.55854495012585,5.24609408516549,0.353650793650794
"United States","Georgia","GA",2020-08-30,2020-09-05,7,2020,"36",10617423,2043,401,1583,460,1642,3.77681100206707,4.33250139887994,0.290587492103601
"United States","Georgia","GA",2020-09-06,2020-09-12,7,2020,"37",10617423,2073,310,1571,502,1763,2.919729203593,4.72807761356028,0.319541693189052
"United States","Georgia","GA",2020-09-13,2020-09-19,7,2020,"38",10617423,1928,312,1576,352,1616,2.93856616619683,3.31530541827334,0.223350253807107
"United States","Georgia","GA",2020-09-20,2020-09-26,7,2020,"39",10617423,1997,315,1582,415,1682,2.96682161010256,3.90866974029385,0.262326169405815
"United States","Georgia","GA",2020-09-27,2020-10-03,7,2020,"40",10617423,1926,220,1586,340,1706,2.07206588642084,3.20228364265039,0.21437578814628
"United States","Georgia","GA",2020-10-04,2020-10-10,7,2020,"41",10617423,1886,259,1586,300,1627,2.43938665719544,2.82554439057387,0.189155107187894
"United States","Georgia","GA",2020-10-11,2020-10-17,7,2020,"42",10617423,1923,214,1602,321,1709,2.01555499860936,3.02333249791404,0.200374531835206
"United States","Georgia","GA",2020-10-18,2020-10-24,7,2020,"43",10617423,1960,201,1603,357,1759,1.89311474168449,3.36239782478291,0.222707423580786
"United States","Georgia","GA",2020-10-25,2020-10-31,7,2020,"44",10617423,1944,163,1626,318,1781,1.5352124522118,2.9950770540083,0.195571955719557
"United States","Georgia","GA",2020-11-01,2020-11-07,7,2020,"45",10617423,2017,219,1645,372,1798,2.06264740511893,3.5036750443116,0.226139817629179
"United States","Georgia","GA",2020-11-08,2020-11-14,7,2020,"46",10617423,2050,257,1658,392,1793,2.42054969459162,3.69204467034986,0.23642943305187
"United States","Georgia","GA",2020-11-15,2020-11-21,7,2020,"47",10617423,1977,166,1678,299,1811,1.56346789611754,2.81612590927196,0.17818831942789
"United States","Georgia","GA",2020-11-22,2020-11-28,7,2020,"48",10617423,2068,158,1707,361,1910,1.48812004570224,3.40007174999056,0.211482132396016
"United States","Georgia","GA",2020-11-29,2020-12-05,7,2020,"49",10617423,2171,196,1730,441,1975,1.84602233517493,4.15355025414359,0.254913294797688
"United States","Georgia","GA",2020-12-06,2020-12-12,7,2020,"50",10617423,2239,236,1750,489,2003,2.22276158725145,4.60563735663541,0.279428571428571
"United States","Georgia","GA",2020-12-13,2020-12-19,7,2020,"51",10617423,2418,231,1771,647,2187,2.17566918074188,6.09375740233765,0.365330321852061
"United States","Georgia","GA",2020-12-20,2020-12-26,7,2020,"52",10617423,2377,274,1797,580,2103,2.58066387672414,5.46271915510948,0.322760155815248
"United States","Georgia","GA",2020-12-27,2021-01-02,7,2020,"53",10617423,2720,183,1821,899,2537,1.72358207825006,8.4672146904197,0.493684788577704
"United States","Georgia","GA",2021-01-03,2021-01-09,7,2021,"1",10617423,2854,389,1832,1022,2465,3.66378922644412,9.62568789055499,0.557860262008734
"United States","Georgia","GA",2021-01-10,2021-01-16,7,2021,"2",10617423,3100,749,1845,1255,2351,7.05444249513276,11.8201940339007,0.680216802168022
"United States","Georgia","GA",2021-01-17,2021-01-23,7,2021,"3",10617423,2959,769,1853,1106,2190,7.24281212117102,10.4168403199157,0.596869940636805
"United States","Georgia","GA",2021-01-24,2021-01-30,7,2021,"4",10617423,2773,770,1835,938,2003,7.25223060247294,8.8345354611943,0.511171662125341
"United States","Georgia","GA",2021-01-31,2021-02-06,7,2021,"5",10617423,2718,756,1815,903,1962,7.12037186424615,8.50488861562735,0.497520661157025
"United States","Georgia","GA",2021-02-07,2021-02-13,7,2021,"6",10617423,2383,638,1781,602,1745,6.00899107062043,5.66992574375157,0.338012352610893
"United States","Georgia","GA",2021-02-14,2021-02-20,7,2021,"7",10617423,2277,668,1743,534,1609,6.29154550967782,5.02946901522149,0.306368330464716
"United States","Georgia","GA",2021-02-21,2021-02-27,7,2021,"8",10617423,2104,438,1725,379,1666,4.12529481023785,3.56960441342499,0.219710144927536
"United States","Georgia","GA",2021-02-28,2021-03-06,7,2021,"9",10617423,1938,536,1726,212,1402,5.04830597782532,1.99671803600554,0.122827346465817
"United States","Georgia","GA",2021-03-07,2021-03-13,7,2021,"10",10617423,1990,285,1715,275,1705,2.68426717104518,2.59008235802605,0.160349854227405
"United States","Georgia","GA",2021-03-14,2021-03-20,7,2021,"11",10617423,1912,275,1732,180,1637,2.59008235802605,1.69532663434432,0.103926096997691
"United States","Georgia","GA",2021-03-21,2021-03-27,7,2021,"12",10617423,1877,336,1727,150,1541,3.16460971744274,1.41277219528694,0.0868558193398958
"United States","Georgia","GA",2021-03-28,2021-04-03,7,2021,"13",10617423,1740,2710,1719,21,-970,25.524084328184,0.197788107340171,0.0122164048865621
"United States","Georgia","GA",2021-04-04,2021-04-10,7,2021,"14",10617423,1923,278,1720,203,1645,2.61833780193179,1.91195170428832,0.118023255813954
"United States","Georgia","GA",2021-04-11,2021-04-17,7,2021,"15",10617423,1849,269,1709,140,1580,2.53357147021457,1.31858738226781,0.0819192510239906
"United States","Georgia","GA",2021-04-18,2021-04-24,7,2021,"16",10617423,1876,216,1710,166,1660,2.03439196121319,1.56346789611754,0.0970760233918129
"United States","Georgia","GA",2021-04-25,2021-05-01,7,2021,"17",10617423,1801,239,1691,110,1562,2.25101703115718,1.03603294321042,0.065050266114725
"United States","Georgia","GA",2021-05-02,2021-05-08,7,2021,"18",10617423,1791,156,1683,108,1635,1.46928308309841,1.01719598060659,0.0641711229946524
"United States","Georgia","GA",2021-05-09,2021-05-15,7,2021,"19",10617423,1760,137,1662,98,1623,1.29033193836207,0.923011167587464,0.0589651022864019
"United States","Georgia","GA",2021-05-16,2021-05-22,7,2021,"20",10617423,1803,156,1644,159,1647,1.46928308309841,1.49753852700415,0.0967153284671534
"United States","Georgia","GA",2021-05-23,2021-05-29,7,2021,"21",10617423,1815,176,1635,180,1639,1.65765270913667,1.69532663434432,0.110091743119266
"United States","Georgia","GA",2021-05-30,2021-06-05,7,2021,"22",10617423,1701,149,1628,73,1552,1.40335371398502,0.687549135039642,0.0448402948402948
"United States","Georgia","GA",2021-06-06,2021-06-12,7,2021,"23",10617423,1562,172,1625,-63,1390,1.61997878392902,-0.593364322020513,-0.0387692307692308
"United States","Georgia","GA",2021-06-13,2021-06-19,7,2021,"24",10617423,1414,161,1614,-200,1253,1.51637548960798,-1.88369626038258,-0.123915737298637
"United States","Georgia","GA",2021-06-20,2021-06-26,7,2021,"25",10617423,1026,74,1596,-570,952,0.696967616341555,-5.36853434209035,-0.357142857142857
"United States","Hawaii","HI",2019-12-29,2020-01-04,7,2020,"1",1415872,242,0,266,-24,242,0,-1.69506848076662,-0.0902255639097744
"United States","Hawaii","HI",2020-01-05,2020-01-11,7,2020,"2",1415872,242,0,262,-20,242,0,-1.41255706730552,-0.0763358778625954
"United States","Hawaii","HI",2020-01-12,2020-01-18,7,2020,"3",1415872,215,0,261,-46,215,0,-3.24888125480269,-0.176245210727969
"United States","Hawaii","HI",2020-01-19,2020-01-25,7,2020,"4",1415872,242,0,253,-11,242,0,-0.776906387018036,-0.0434782608695652
"United States","Hawaii","HI",2020-01-26,2020-02-01,7,2020,"5",1415872,242,0,248,-6,242,0,-0.423767120191656,-0.0241935483870968
"United States","Hawaii","HI",2020-02-02,2020-02-08,7,2020,"6",1415872,236,0,248,-12,236,0,-0.847534240383311,-0.0483870967741935
"United States","Hawaii","HI",2020-02-09,2020-02-15,7,2020,"7",1415872,281,0,247,34,281,0,2.40134701441938,0.137651821862348
"United States","Hawaii","HI",2020-02-16,2020-02-22,7,2020,"8",1415872,250,0,248,2,250,0,0.141255706730552,0.00806451612903225
"United States","Hawaii","HI",2020-02-23,2020-02-29,7,2020,"9",1415872,238,0,248,-10,238,0,-0.706278533652759,-0.0403225806451613
"United States","Hawaii","HI",2020-03-01,2020-03-07,7,2020,"10",1415872,239,0,246,-7,239,0,-0.494394973556932,-0.0284552845528455
"United States","Hawaii","HI",2020-03-08,2020-03-14,7,2020,"11",1415872,243,0,248,-5,243,0,-0.35313926682638,-0.0201612903225806
"United States","Hawaii","HI",2020-03-15,2020-03-21,7,2020,"12",1415872,212,0,249,-37,212,0,-2.61323057451521,-0.14859437751004
"United States","Hawaii","HI",2020-03-22,2020-03-28,7,2020,"13",1415872,235,0,248,-13,235,0,-0.918162093748587,-0.0524193548387096
"United States","Hawaii","HI",2020-03-29,2020-04-04,7,2020,"14",1415872,235,3,237,-2,232,0.211883560095828,-0.141255706730552,-0.00843881856540085
"United States","Hawaii","HI",2020-04-05,2020-04-11,7,2020,"15",1415872,221,5,233,-12,216,0.35313926682638,-0.847534240383311,-0.0515021459227468
"United States","Hawaii","HI",2020-04-12,2020-04-18,7,2020,"16",1415872,211,1,231,-20,210,0.070627853365276,-1.41255706730552,-0.0865800865800865
"United States","Hawaii","HI",2020-04-19,2020-04-25,7,2020,"17",1415872,200,0,229,-29,200,0,-2.048207747593,-0.126637554585153
"United States","Hawaii","HI",2020-04-26,2020-05-02,7,2020,"18",1415872,223,7,225,-2,216,0.494394973556932,-0.141255706730552,-0.00888888888888884
"United States","Hawaii","HI",2020-05-03,2020-05-09,7,2020,"19",1415872,210,1,227,-17,209,0.070627853365276,-1.20067350720969,-0.0748898678414097
"United States","Hawaii","HI",2020-05-10,2020-05-16,7,2020,"20",1415872,230,0,224,6,230,0,0.423767120191656,0.0267857142857142
"United States","Hawaii","HI",2020-05-17,2020-05-23,7,2020,"21",1415872,210,0,221,-11,210,0,-0.776906387018036,-0.0497737556561086
"United States","Hawaii","HI",2020-05-24,2020-05-30,7,2020,"22",1415872,200,0,224,-24,200,0,-1.69506848076662,-0.107142857142857
"United States","Hawaii","HI",2020-05-31,2020-06-06,7,2020,"23",1415872,217,0,227,-10,217,0,-0.706278533652759,-0.0440528634361234
"United States","Hawaii","HI",2020-06-07,2020-06-13,7,2020,"24",1415872,203,0,225,-22,203,0,-1.55381277403607,-0.0977777777777777
"United States","Hawaii","HI",2020-06-14,2020-06-20,7,2020,"25",1415872,246,0,226,20,246,0,1.41255706730552,0.0884955752212389
"United States","Hawaii","HI",2020-06-21,2020-06-27,7,2020,"26",1415872,236,1,225,11,235,0.070627853365276,0.776906387018036,0.048888888888889
"United States","Hawaii","HI",2020-06-28,2020-07-04,7,2020,"27",1415872,207,1,221,-14,206,0.070627853365276,-0.988789947113863,-0.0633484162895928
"United States","Hawaii","HI",2020-07-05,2020-07-11,7,2020,"28",1415872,239,0,217,22,239,0,1.55381277403607,0.101382488479263
"United States","Hawaii","HI",2020-07-12,2020-07-18,7,2020,"29",1415872,227,5,214,13,222,0.35313926682638,0.918162093748587,0.0607476635514019
"United States","Hawaii","HI",2020-07-19,2020-07-25,7,2020,"30",1415872,219,2,210,9,217,0.141255706730552,0.635650680287484,0.0428571428571429
"United States","Hawaii","HI",2020-07-26,2020-08-01,7,2020,"31",1415872,217,0,210,7,217,0,0.494394973556932,0.0333333333333334
"United States","Hawaii","HI",2020-08-02,2020-08-08,7,2020,"32",1415872,231,5,209,22,226,0.35313926682638,1.55381277403607,0.105263157894737
"United States","Hawaii","HI",2020-08-09,2020-08-15,7,2020,"33",1415872,223,9,210,13,214,0.635650680287484,0.918162093748587,0.0619047619047619
"United States","Hawaii","HI",2020-08-16,2020-08-22,7,2020,"34",1415872,242,7,212,30,235,0.494394973556932,2.11883560095828,0.141509433962264
"United States","Hawaii","HI",2020-08-23,2020-08-29,7,2020,"35",1415872,255,15,216,39,240,1.05941780047914,2.75448628124576,0.180555555555556
"United States","Hawaii","HI",2020-08-30,2020-09-05,7,2020,"36",1415872,235,22,218,17,213,1.55381277403607,1.20067350720969,0.0779816513761469
"United States","Hawaii","HI",2020-09-06,2020-09-12,7,2020,"37",1415872,274,13,219,55,261,0.918162093748587,3.88453193509018,0.251141552511416
"United States","Hawaii","HI",2020-09-13,2020-09-19,7,2020,"38",1415872,242,23,217,25,219,1.62444062740135,1.7656963341319,0.115207373271889
"United States","Hawaii","HI",2020-09-20,2020-09-26,7,2020,"39",1415872,242,11,216,26,231,0.776906387018036,1.83632418749717,0.12037037037037
"United States","Hawaii","HI",2020-09-27,2020-10-03,7,2020,"40",1415872,214,22,215,-1,192,1.55381277403607,-0.070627853365276,-0.00465116279069766
"United States","Hawaii","HI",2020-10-04,2020-10-10,7,2020,"41",1415872,231,15,213,18,216,1.05941780047914,1.27130136057497,0.0845070422535212
"United States","Hawaii","HI",2020-10-11,2020-10-17,7,2020,"42",1415872,237,18,211,26,219,1.27130136057497,1.83632418749717,0.123222748815166
"United States","Hawaii","HI",2020-10-18,2020-10-24,7,2020,"43",1415872,237,26,214,23,211,1.83632418749717,1.62444062740135,0.107476635514019
"United States","Hawaii","HI",2020-10-25,2020-10-31,7,2020,"44",1415872,238,7,218,20,231,0.494394973556932,1.41255706730552,0.0917431192660549
"United States","Hawaii","HI",2020-11-01,2020-11-07,7,2020,"45",1415872,236,1,219,17,235,0.070627853365276,1.20067350720969,0.0776255707762556
"United States","Hawaii","HI",2020-11-08,2020-11-14,7,2020,"46",1415872,249,2,218,31,247,0.141255706730552,2.18946345432355,0.142201834862385
"United States","Hawaii","HI",2020-11-15,2020-11-21,7,2020,"47",1415872,224,9,229,-5,215,0.635650680287484,-0.35313926682638,-0.0218340611353712
"United States","Hawaii","HI",2020-11-22,2020-11-28,7,2020,"48",1415872,216,9,230,-14,207,0.635650680287484,-0.988789947113863,-0.0608695652173913
"United States","Hawaii","HI",2020-11-29,2020-12-05,7,2020,"49",1415872,237,21,231,6,216,1.4831849206708,0.423767120191656,0.025974025974026
"United States","Hawaii","HI",2020-12-06,2020-12-12,7,2020,"50",1415872,212,8,238,-26,204,0.565022826922208,-1.83632418749717,-0.109243697478992
"United States","Hawaii","HI",2020-12-13,2020-12-19,7,2020,"51",1415872,249,0,245,4,249,0,0.282511413461104,0.0163265306122449
"United States","Hawaii","HI",2020-12-20,2020-12-26,7,2020,"52",1415872,198,0,243,-45,198,0,-3.17825340143742,-0.185185185185185
"United States","Hawaii","HI",2020-12-27,2021-01-02,7,2020,"53",1415872,225,0,250,-25,225,0,-1.7656963341319,-0.1
"United States","Hawaii","HI",2021-01-03,2021-01-09,7,2021,"1",1415872,215,38,253,-38,177,2.68385842788049,-2.68385842788049,-0.150197628458498
"United States","Hawaii","HI",2021-01-10,2021-01-16,7,2021,"2",1415872,249,13,249,0,236,0.918162093748587,0,0
"United States","Hawaii","HI",2021-01-17,2021-01-23,7,2021,"3",1415872,208,8,248,-40,200,0.565022826922208,-2.82511413461104,-0.161290322580645
"United States","Hawaii","HI",2021-01-24,2021-01-30,7,2021,"4",1415872,228,73,247,-19,155,5.15583329566515,-1.34192921394024,-0.0769230769230769
"United States","Hawaii","HI",2021-01-31,2021-02-06,7,2021,"5",1415872,240,15,245,-5,225,1.05941780047914,-0.35313926682638,-0.0204081632653061
"United States","Hawaii","HI",2021-02-07,2021-02-13,7,2021,"6",1415872,268,9,245,23,259,0.635650680287484,1.62444062740135,0.0938775510204082
"United States","Hawaii","HI",2021-02-14,2021-02-20,7,2021,"7",1415872,254,5,246,8,249,0.35313926682638,0.565022826922208,0.032520325203252
"United States","Hawaii","HI",2021-02-21,2021-02-27,7,2021,"8",1415872,265,9,249,16,256,0.635650680287484,1.13004565384442,0.0642570281124497
"United States","Hawaii","HI",2021-02-28,2021-03-06,7,2021,"9",1415872,231,5,253,-22,226,0.35313926682638,-1.55381277403607,-0.0869565217391305
"United States","Hawaii","HI",2021-03-07,2021-03-13,7,2021,"10",1415872,256,5,249,7,251,0.35313926682638,0.494394973556932,0.0281124497991967
"United States","Hawaii","HI",2021-03-14,2021-03-20,7,2021,"11",1415872,236,4,251,-15,232,0.282511413461104,-1.05941780047914,-0.0597609561752988
"United States","Hawaii","HI",2021-03-21,2021-03-27,7,2021,"12",1415872,245,9,247,-2,236,0.635650680287484,-0.141255706730552,-0.0080971659919028
"United States","Hawaii","HI",2021-03-28,2021-04-03,7,2021,"13",1415872,251,5,242,9,246,0.35313926682638,0.635650680287484,0.0371900826446281
"United States","Hawaii","HI",2021-04-04,2021-04-10,7,2021,"14",1415872,252,4,232,20,248,0.282511413461104,1.41255706730552,0.0862068965517242
"United States","Hawaii","HI",2021-04-11,2021-04-17,7,2021,"15",1415872,221,3,232,-11,218,0.211883560095828,-0.776906387018036,-0.0474137931034483
"United States","Hawaii","HI",2021-04-18,2021-04-24,7,2021,"16",1415872,255,4,227,28,251,0.282511413461104,1.97757989422773,0.123348017621145
"United States","Hawaii","HI",2021-04-25,2021-05-01,7,2021,"17",1415872,236,5,227,9,231,0.35313926682638,0.635650680287484,0.0396475770925111
"United States","Hawaii","HI",2021-05-02,2021-05-08,7,2021,"18",1415872,238,4,228,10,234,0.282511413461104,0.706278533652759,0.0438596491228069
"United States","Hawaii","HI",2021-05-09,2021-05-15,7,2021,"19",1415872,235,3,229,6,232,0.211883560095828,0.423767120191656,0.0262008733624455
"United States","Hawaii","HI",2021-05-16,2021-05-22,7,2021,"20",1415872,256,4,228,28,252,0.282511413461104,1.97757989422773,0.12280701754386
"United States","Hawaii","HI",2021-05-23,2021-05-29,7,2021,"21",1415872,213,5,225,-12,208,0.35313926682638,-0.847534240383311,-0.0533333333333333
"United States","Hawaii","HI",2021-05-30,2021-06-05,7,2021,"22",1415872,205,3,225,-20,202,0.211883560095828,-1.41255706730552,-0.0888888888888889
"United States","Hawaii","HI",2021-06-06,2021-06-12,7,2021,"23",1415872,217,3,226,-9,214,0.211883560095828,-0.635650680287484,-0.0398230088495575
"United States","Hawaii","HI",2021-06-13,2021-06-19,7,2021,"24",1415872,213,5,226,-13,208,0.35313926682638,-0.918162093748587,-0.0575221238938053
"United States","Hawaii","HI",2021-06-20,2021-06-26,7,2021,"25",1415872,173,4,228,-55,169,0.282511413461104,-3.88453193509018,-0.241228070175439
"United States","Idaho","ID",2019-12-29,2020-01-04,7,2020,"1",1787065,278,0,313,-35,278,0,-1.9585185765487,-0.111821086261981
"United States","Idaho","ID",2020-01-05,2020-01-11,7,2020,"2",1787065,292,0,310,-18,292,0,-1.00723812508219,-0.0580645161290323
"United States","Idaho","ID",2020-01-12,2020-01-18,7,2020,"3",1787065,293,0,313,-20,293,0,-1.11915347231354,-0.0638977635782748
"United States","Idaho","ID",2020-01-19,2020-01-25,7,2020,"4",1787065,275,0,310,-35,275,0,-1.9585185765487,-0.112903225806452
"United States","Idaho","ID",2020-01-26,2020-02-01,7,2020,"5",1787065,249,0,304,-55,249,0,-3.07767204886224,-0.180921052631579
"United States","Idaho","ID",2020-02-02,2020-02-08,7,2020,"6",1787065,292,0,301,-9,292,0,-0.503619062541094,-0.0299003322259136
"United States","Idaho","ID",2020-02-09,2020-02-15,7,2020,"7",1787065,279,0,302,-23,279,0,-1.28702649316057,-0.0761589403973509
"United States","Idaho","ID",2020-02-16,2020-02-22,7,2020,"8",1787065,318,0,301,17,318,0,0.951280451466511,0.0564784053156147
"United States","Idaho","ID",2020-02-23,2020-02-29,7,2020,"9",1787065,290,0,296,-6,290,0,-0.335746041694063,-0.0202702702702703
"United States","Idaho","ID",2020-03-01,2020-03-07,7,2020,"10",1787065,278,0,297,-19,278,0,-1.06319579869787,-0.063973063973064
"United States","Idaho","ID",2020-03-08,2020-03-14,7,2020,"11",1787065,282,0,300,-18,282,0,-1.00723812508219,-0.0600000000000001
"United States","Idaho","ID",2020-03-15,2020-03-21,7,2020,"12",1787065,308,0,298,10,308,0,0.559576736156771,0.0335570469798658
"United States","Idaho","ID",2020-03-22,2020-03-28,7,2020,"13",1787065,332,5,298,34,327,0.279788368078385,1.90256090293302,0.114093959731544
"United States","Idaho","ID",2020-03-29,2020-04-04,7,2020,"14",1787065,271,5,299,-28,266,0.279788368078385,-1.56681486123896,-0.0936454849498328
"United States","Idaho","ID",2020-04-05,2020-04-11,7,2020,"15",1787065,306,17,295,11,289,0.951280451466511,0.615534409772448,0.0372881355932204
"United States","Idaho","ID",2020-04-12,2020-04-18,7,2020,"16",1787065,283,17,292,-9,266,0.951280451466511,-0.503619062541094,-0.0308219178082192
"United States","Idaho","ID",2020-04-19,2020-04-25,7,2020,"17",1787065,262,12,290,-28,250,0.671492083388125,-1.56681486123896,-0.096551724137931
"United States","Idaho","ID",2020-04-26,2020-05-02,7,2020,"18",1787065,252,7,283,-31,245,0.39170371530974,-1.73468788208599,-0.109540636042403
"United States","Idaho","ID",2020-05-03,2020-05-09,7,2020,"19",1787065,304,4,281,23,300,0.223830694462708,1.28702649316057,0.0818505338078293
"United States","Idaho","ID",2020-05-10,2020-05-16,7,2020,"20",1787065,269,6,284,-15,263,0.335746041694063,-0.839365104235157,-0.0528169014084507
"United States","Idaho","ID",2020-05-17,2020-05-23,7,2020,"21",1787065,262,5,283,-21,257,0.279788368078385,-1.17511114592922,-0.0742049469964664
"United States","Idaho","ID",2020-05-24,2020-05-30,7,2020,"22",1787065,279,4,282,-3,275,0.223830694462708,-0.167873020847031,-0.0106382978723404
"United States","Idaho","ID",2020-05-31,2020-06-06,7,2020,"23",1787065,294,1,285,9,293,0.0559576736156771,0.503619062541094,0.0315789473684212
"United States","Idaho","ID",2020-06-07,2020-06-13,7,2020,"24",1787065,286,3,282,4,283,0.167873020847031,0.223830694462708,0.0141843971631206
"United States","Idaho","ID",2020-06-14,2020-06-20,7,2020,"25",1787065,282,3,284,-2,279,0.167873020847031,-0.111915347231354,-0.00704225352112675
"United States","Idaho","ID",2020-06-21,2020-06-27,7,2020,"26",1787065,296,2,283,13,294,0.111915347231354,0.727449757003802,0.0459363957597174
"United States","Idaho","ID",2020-06-28,2020-07-04,7,2020,"27",1787065,281,1,281,0,280,0.0559576736156771,0,0
"United States","Idaho","ID",2020-07-05,2020-07-11,7,2020,"28",1787065,287,10,277,10,277,0.559576736156771,0.559576736156771,0.036101083032491
"United States","Idaho","ID",2020-07-12,2020-07-18,7,2020,"29",1787065,312,17,274,38,295,0.951280451466511,2.12639159739573,0.138686131386861
"United States","Idaho","ID",2020-07-19,2020-07-25,7,2020,"30",1787065,328,27,274,54,301,1.51085718762328,3.02171437524656,0.197080291970803
"United States","Idaho","ID",2020-07-26,2020-08-01,7,2020,"31",1787065,327,50,269,58,277,2.79788368078386,3.24554506970927,0.215613382899628
"United States","Idaho","ID",2020-08-02,2020-08-08,7,2020,"32",1787065,312,39,267,45,273,2.18234927101141,2.51809531270547,0.168539325842697
"United States","Idaho","ID",2020-08-09,2020-08-15,7,2020,"33",1787065,319,34,261,58,285,1.90256090293302,3.24554506970927,0.222222222222222
"United States","Idaho","ID",2020-08-16,2020-08-22,7,2020,"34",1787065,360,37,265,95,323,2.07043392378005,5.31597899348932,0.358490566037736
"United States","Idaho","ID",2020-08-23,2020-08-29,7,2020,"35",1787065,327,52,262,65,275,2.90979902801521,3.63724878501901,0.248091603053435
"United States","Idaho","ID",2020-08-30,2020-09-05,7,2020,"36",1787065,352,26,265,87,326,1.4548995140076,4.86831760456391,0.328301886792453
"United States","Idaho","ID",2020-09-06,2020-09-12,7,2020,"37",1787065,321,31,270,51,290,1.73468788208599,2.85384135439953,0.188888888888889
"United States","Idaho","ID",2020-09-13,2020-09-19,7,2020,"38",1787065,320,26,273,47,294,1.4548995140076,2.63001065993682,0.172161172161172
"United States","Idaho","ID",2020-09-20,2020-09-26,7,2020,"39",1787065,292,19,270,22,273,1.06319579869787,1.2310688195449,0.0814814814814815
"United States","Idaho","ID",2020-09-27,2020-10-03,7,2020,"40",1787065,328,20,273,55,308,1.11915347231354,3.07767204886224,0.201465201465201
"United States","Idaho","ID",2020-10-04,2020-10-10,7,2020,"41",1787065,300,27,272,28,273,1.51085718762328,1.56681486123896,0.102941176470588
"United States","Idaho","ID",2020-10-11,2020-10-17,7,2020,"42",1787065,326,22,268,58,304,1.2310688195449,3.24554506970927,0.216417910447761
"United States","Idaho","ID",2020-10-18,2020-10-24,7,2020,"43",1787065,341,42,271,70,299,2.35022229185844,3.9170371530974,0.25830258302583
"United States","Idaho","ID",2020-10-25,2020-10-31,7,2020,"44",1787065,351,57,274,77,294,3.18958739609359,4.30874086840714,0.281021897810219
"United States","Idaho","ID",2020-11-01,2020-11-07,7,2020,"45",1787065,365,54,270,95,311,3.02171437524656,5.31597899348932,0.351851851851852
"United States","Idaho","ID",2020-11-08,2020-11-14,7,2020,"46",1787065,410,68,265,145,342,3.80512180586604,8.11386267427318,0.547169811320755
"United States","Idaho","ID",2020-11-15,2020-11-21,7,2020,"47",1787065,391,95,265,126,296,5.31597899348932,7.05066687557532,0.475471698113207
"United States","Idaho","ID",2020-11-22,2020-11-28,7,2020,"48",1787065,424,68,267,157,356,3.80512180586604,8.78535475766131,0.588014981273408
"United States","Idaho","ID",2020-11-29,2020-12-05,7,2020,"49",1787065,397,119,271,126,278,6.65896316026557,7.05066687557532,0.464944649446494
"United States","Idaho","ID",2020-12-06,2020-12-12,7,2020,"50",1787065,373,137,279,94,236,7.66620128534776,5.26002131987365,0.336917562724014
"United States","Idaho","ID",2020-12-13,2020-12-19,7,2020,"51",1787065,394,106,283,111,288,5.93151340326177,6.21130177134016,0.392226148409894
"United States","Idaho","ID",2020-12-20,2020-12-26,7,2020,"52",1787065,390,38,294,96,352,2.12639159739573,5.371936667105,0.326530612244898
"United States","Idaho","ID",2020-12-27,2021-01-02,7,2020,"53",1787065,349,135,296,53,214,7.55428593811641,2.96575670163089,0.179054054054054
"United States","Idaho","ID",2021-01-03,2021-01-09,7,2021,"1",1787065,389,80,299,90,309,4.47661388925417,5.03619062541094,0.301003344481605
"United States","Idaho","ID",2021-01-10,2021-01-16,7,2021,"2",1787065,343,77,296,47,266,4.30874086840714,2.63001065993682,0.158783783783784
"United States","Idaho","ID",2021-01-17,2021-01-23,7,2021,"3",1787065,342,63,298,44,279,3.52533343778766,2.46213763908979,0.147651006711409
"United States","Idaho","ID",2021-01-24,2021-01-30,7,2021,"4",1787065,287,57,294,-7,230,3.18958739609359,-0.39170371530974,-0.0238095238095238
"United States","Idaho","ID",2021-01-31,2021-02-06,7,2021,"5",1787065,331,42,299,32,289,2.35022229185844,1.79064555570167,0.107023411371237
"United States","Idaho","ID",2021-02-07,2021-02-13,7,2021,"6",1787065,308,37,304,4,271,2.07043392378005,0.223830694462708,0.013157894736842
"United States","Idaho","ID",2021-02-14,2021-02-20,7,2021,"7",1787065,301,22,307,-6,279,1.2310688195449,-0.335746041694063,-0.0195439739413681
"United States","Idaho","ID",2021-02-21,2021-02-27,7,2021,"8",1787065,305,34,306,-1,271,1.90256090293302,-0.0559576736156771,-0.00326797385620914
"United States","Idaho","ID",2021-02-28,2021-03-06,7,2021,"9",1787065,309,17,300,9,292,0.951280451466511,0.503619062541094,0.03
"United States","Idaho","ID",2021-03-07,2021-03-13,7,2021,"10",1787065,311,33,300,11,278,1.84660322931734,0.615534409772448,0.0366666666666666
"United States","Idaho","ID",2021-03-14,2021-03-20,7,2021,"11",1787065,295,31,297,-2,264,1.73468788208599,-0.111915347231354,-0.0067340067340067
"United States","Idaho","ID",2021-03-21,2021-03-27,7,2021,"12",1787065,303,15,297,6,288,0.839365104235157,0.335746041694063,0.0202020202020201
"United States","Idaho","ID",2021-03-28,2021-04-03,7,2021,"13",1787065,324,10,296,28,314,0.559576736156771,1.56681486123896,0.0945945945945945
"United States","Idaho","ID",2021-04-04,2021-04-10,7,2021,"14",1787065,347,23,294,53,324,1.28702649316057,2.96575670163089,0.180272108843538
"United States","Idaho","ID",2021-04-11,2021-04-17,7,2021,"15",1787065,280,28,288,-8,252,1.56681486123896,-0.447661388925417,-0.0277777777777778
"United States","Idaho","ID",2021-04-18,2021-04-24,7,2021,"16",1787065,284,14,286,-2,270,0.783407430619479,-0.111915347231354,-0.00699300699300698
"United States","Idaho","ID",2021-04-25,2021-05-01,7,2021,"17",1787065,273,15,280,-7,258,0.839365104235157,-0.39170371530974,-0.025
"United States","Idaho","ID",2021-05-02,2021-05-08,7,2021,"18",1787065,276,15,276,0,261,0.839365104235157,0,0
"United States","Idaho","ID",2021-05-09,2021-05-15,7,2021,"19",1787065,290,3,278,12,287,0.167873020847031,0.671492083388125,0.0431654676258992
"United States","Idaho","ID",2021-05-16,2021-05-22,7,2021,"20",1787065,330,16,282,48,314,0.895322777850834,2.6859683335525,0.170212765957447
"United States","Idaho","ID",2021-05-23,2021-05-29,7,2021,"21",1787065,324,10,281,43,314,0.559576736156771,2.40617996547412,0.153024911032029
"United States","Idaho","ID",2021-05-30,2021-06-05,7,2021,"22",1787065,295,11,279,16,284,0.615534409772448,0.895322777850834,0.0573476702508962
"United States","Idaho","ID",2021-06-06,2021-06-12,7,2021,"23",1787065,318,15,279,39,303,0.839365104235157,2.18234927101141,0.139784946236559
"United States","Idaho","ID",2021-06-13,2021-06-19,7,2021,"24",1787065,300,6,274,26,294,0.335746041694063,1.4548995140076,0.0948905109489051
"United States","Idaho","ID",2021-06-20,2021-06-26,7,2021,"25",1787065,202,23,271,-69,179,1.28702649316057,-3.86107947948172,-0.254612546125461
"United States","Illinois","IL",2019-12-29,2020-01-04,7,2020,"1",12671821,2191,0,2357,-166,2191,0,-1.30999325195645,-0.0704285108188375
"United States","Illinois","IL",2020-01-05,2020-01-11,7,2020,"2",12671821,2252,0,2381,-129,2252,0,-1.01800680423121,-0.0541789164216716
"United States","Illinois","IL",2020-01-12,2020-01-18,7,2020,"3",12671821,2231,0,2344,-113,2231,0,-0.891742394404088,-0.0482081911262798
"United States","Illinois","IL",2020-01-19,2020-01-25,7,2020,"4",12671821,2199,0,2346,-147,2199,0,-1.16005426528673,-0.0626598465473146
"United States","Illinois","IL",2020-01-26,2020-02-01,7,2020,"5",12671821,2137,0,2328,-191,2137,0,-1.50728139231133,-0.0820446735395189
"United States","Illinois","IL",2020-02-02,2020-02-08,7,2020,"6",12671821,2232,0,2308,-76,2232,0,-0.599755946678855,-0.0329289428076257
"United States","Illinois","IL",2020-02-09,2020-02-15,7,2020,"7",12671821,2216,0,2275,-59,2216,0,-0.465600011237532,-0.0259340659340659
"United States","Illinois","IL",2020-02-16,2020-02-22,7,2020,"8",12671821,2207,0,2251,-44,2207,0,-0.347227127024601,-0.0195468680586406
"United States","Illinois","IL",2020-02-23,2020-02-29,7,2020,"9",12671821,2209,0,2212,-3,2209,0,-0.0236745768425864,-0.00135623869801083
"United States","Illinois","IL",2020-03-01,2020-03-07,7,2020,"10",12671821,2254,0,2212,42,2254,0,0.33144407579621,0.018987341772152
"United States","Illinois","IL",2020-03-08,2020-03-14,7,2020,"11",12671821,2191,0,2187,4,2191,0,0.0315661024567819,0.00182898948331056
"United States","Illinois","IL",2020-03-15,2020-03-21,7,2020,"12",12671821,2283,6,2169,114,2277,0.0473491536851728,0.899633920018283,0.0525587828492393
"United States","Illinois","IL",2020-03-22,2020-03-28,7,2020,"13",12671821,2304,41,2153,151,2263,0.323552550182014,1.19162036774352,0.0701346957733395
"United States","Illinois","IL",2020-03-29,2020-04-04,7,2020,"14",12671821,2622,197,2141,481,2425,1.55463054599651,3.79582382042802,0.224661373190098
"United States","Illinois","IL",2020-04-05,2020-04-11,7,2020,"15",12671821,2870,433,2111,759,2437,3.41703059094664,5.98966794117436,0.359545239223117
"United States","Illinois","IL",2020-04-12,2020-04-18,7,2020,"16",12671821,2912,582,2100,812,2330,4.59286790746176,6.40791879872672,0.386666666666667
"United States","Illinois","IL",2020-04-19,2020-04-25,7,2020,"17",12671821,3010,616,2067,943,2394,4.86117977834441,7.44170865418632,0.456216739235607
"United States","Illinois","IL",2020-04-26,2020-05-02,7,2020,"18",12671821,2952,679,2028,924,2273,5.35834589203872,7.29176966751661,0.455621301775148
"United States","Illinois","IL",2020-05-03,2020-05-09,7,2020,"19",12671821,2962,793,2008,954,2169,6.257979812057,7.52851543594247,0.475099601593626
"United States","Illinois","IL",2020-05-10,2020-05-16,7,2020,"20",12671821,2865,780,1972,893,2085,6.15538997907246,7.04713237347655,0.452839756592292
"United States","Illinois","IL",2020-05-17,2020-05-23,7,2020,"21",12671821,2638,663,1973,665,1975,5.23208148221159,5.24786453343998,0.33705017739483
"United States","Illinois","IL",2020-05-24,2020-05-30,7,2020,"22",12671821,2547,540,1970,577,2007,4.26142383166555,4.55341027939078,0.292893401015228
"United States","Illinois","IL",2020-05-31,2020-06-06,7,2020,"23",12671821,2511,533,1955,556,1978,4.20618315236618,4.38768824149268,0.284398976982097
"United States","Illinois","IL",2020-06-07,2020-06-13,7,2020,"24",12671821,2270,426,1954,316,1844,3.36178991164727,2.49372209408577,0.16171954964176
"United States","Illinois","IL",2020-06-14,2020-06-20,7,2020,"25",12671821,2255,336,1931,324,1919,2.65155260636968,2.55685429899933,0.167788710512688
"United States","Illinois","IL",2020-06-21,2020-06-27,7,2020,"26",12671821,2134,248,1942,192,1886,1.95709835232048,1.51517291792553,0.0988671472708549
"United States","Illinois","IL",2020-06-28,2020-07-04,7,2020,"27",12671821,2182,141,1927,255,2041,1.11270511160156,2.01233903161984,0.132330046704722
"United States","Illinois","IL",2020-07-05,2020-07-11,7,2020,"28",12671821,2189,154,1914,275,2035,1.2152949445861,2.17016954390375,0.14367816091954
"United States","Illinois","IL",2020-07-12,2020-07-18,7,2020,"29",12671821,2087,122,1902,185,1965,0.962766124931847,1.45993223862616,0.0972660357518402
"United States","Illinois","IL",2020-07-19,2020-07-25,7,2020,"30",12671821,2034,107,1899,135,1927,0.844393240718915,1.06535595791639,0.0710900473933649
"United States","Illinois","IL",2020-07-26,2020-08-01,7,2020,"31",12671821,2071,106,1880,191,1965,0.836501715104719,1.50728139231133,0.101595744680851
"United States","Illinois","IL",2020-08-02,2020-08-08,7,2020,"32",12671821,2138,128,1870,268,2010,1.01011527861702,2.11492886460438,0.14331550802139
"United States","Illinois","IL",2020-08-09,2020-08-15,7,2020,"33",12671821,2126,95,1873,253,2031,0.749694933348569,1.99655598039145,0.135077415910304
"United States","Illinois","IL",2020-08-16,2020-08-22,7,2020,"34",12671821,2151,148,1876,275,2003,1.16794579090093,2.17016954390375,0.146588486140725
"United States","Illinois","IL",2020-08-23,2020-08-29,7,2020,"35",12671821,2120,134,1884,236,1986,1.05746443230219,1.86240004495013,0.125265392781316
"United States","Illinois","IL",2020-08-30,2020-09-05,7,2020,"36",12671821,2198,158,1903,295,2040,1.24686104704288,2.32800005618766,0.155018392012612
"United States","Illinois","IL",2020-09-06,2020-09-12,7,2020,"37",12671821,2080,129,1922,158,1951,1.01800680423121,1.24686104704288,0.0822060353798126
"United States","Illinois","IL",2020-09-13,2020-09-19,7,2020,"38",12671821,2080,141,1938,142,1939,1.11270511160156,1.12059663721576,0.0732714138286894
"United States","Illinois","IL",2020-09-20,2020-09-26,7,2020,"39",12671821,2295,152,1954,341,2143,1.19951189335771,2.69101023444065,0.174513817809621
"United States","Illinois","IL",2020-09-27,2020-10-03,7,2020,"40",12671821,2138,186,1945,193,1952,1.46782376424036,1.52306444353972,0.0992287917737789
"United States","Illinois","IL",2020-10-04,2020-10-10,7,2020,"41",12671821,2333,201,1936,397,2132,1.58619664845329,3.1329356688356,0.205061983471074
"United States","Illinois","IL",2020-10-11,2020-10-17,7,2020,"42",12671821,2281,217,1943,338,2064,1.71246105828042,2.66733565759807,0.173957797220793
"United States","Illinois","IL",2020-10-18,2020-10-24,7,2020,"43",12671821,2290,289,1945,345,2001,2.28065090250249,2.72257633689744,0.177377892030848
"United States","Illinois","IL",2020-10-25,2020-10-31,7,2020,"44",12671821,2455,228,1942,513,2227,1.79926784003657,4.04835264008227,0.264160659114315
"United States","Illinois","IL",2020-11-01,2020-11-07,7,2020,"45",12671821,2699,444,1968,731,2255,3.50383737270279,5.76870522397688,0.371443089430894
"United States","Illinois","IL",2020-11-08,2020-11-14,7,2020,"46",12671821,2905,515,1980,925,2390,4.06413569131066,7.29966119313081,0.467171717171717
"United States","Illinois","IL",2020-11-15,2020-11-21,7,2020,"47",12671821,3186,762,1987,1199,2424,6.01334251801694,9.46193921142036,0.603422244589834
"United States","Illinois","IL",2020-11-22,2020-11-28,7,2020,"48",12671821,3151,707,2013,1138,2444,5.57930860923619,8.98055614895444,0.565325384997516
"United States","Illinois","IL",2020-11-29,2020-12-05,7,2020,"49",12671821,3282,1041,2041,1241,2241,8.21507816437748,9.79338328721657,0.608035276825086
"United States","Illinois","IL",2020-12-06,2020-12-12,7,2020,"50",12671821,3345,998,2051,1294,2347,7.87574256296707,10.2116341447689,0.630911750365675
"United States","Illinois","IL",2020-12-13,2020-12-19,7,2020,"51",12671821,3130,944,2083,1047,2186,7.44960017980052,8.26242731806265,0.502640422467595
"United States","Illinois","IL",2020-12-20,2020-12-26,7,2020,"52",12671821,3040,745,2114,926,2295,5.87918658257562,7.307552718745,0.438032166508988
"United States","Illinois","IL",2020-12-27,2021-01-02,7,2020,"53",12671821,3031,802,2128,903,2229,6.32900354258476,7.12604762961851,0.424342105263158
"United States","Illinois","IL",2021-01-03,2021-01-09,7,2021,"1",12671821,2794,827,2170,624,1967,6.52629168293965,4.92431198325797,0.287557603686636
"United States","Illinois","IL",2021-01-10,2021-01-16,7,2021,"2",12671821,2741,684,2207,534,2057,5.3978035201097,4.21407467798038,0.241957408246488
"United States","Illinois","IL",2021-01-17,2021-01-23,7,2021,"3",12671821,2616,531,2197,419,2085,4.19040010113779,3.3065492323479,0.190714610832954
"United States","Illinois","IL",2021-01-24,2021-01-30,7,2021,"4",12671821,2592,494,2201,391,2098,3.89841365341256,3.08558651515043,0.177646524307133
"United States","Illinois","IL",2021-01-31,2021-02-06,7,2021,"5",12671821,2568,382,2197,371,2186,3.01456278462267,2.92775600286652,0.168866636322258
"United States","Illinois","IL",2021-02-07,2021-02-13,7,2021,"6",12671821,2483,344,2177,306,2139,2.71468481128324,2.41480683794381,0.140560404225999
"United States","Illinois","IL",2021-02-14,2021-02-20,7,2021,"7",12671821,2445,308,2141,304,2137,2.4305898891722,2.39902378671542,0.141989724427837
"United States","Illinois","IL",2021-02-21,2021-02-27,7,2021,"8",12671821,2340,260,2129,211,2080,2.05179665969082,1.66511190459524,0.0991075622357915
"United States","Illinois","IL",2021-02-28,2021-03-06,7,2021,"9",12671821,2184,258,2103,81,1926,2.03601360846243,0.639213574749833,0.0385164051355207
"United States","Illinois","IL",2021-03-07,2021-03-13,7,2021,"10",12671821,2115,174,2107,8,1941,1.37312545687001,0.0631322049135637,0.00379686758424302
"United States","Illinois","IL",2021-03-14,2021-03-20,7,2021,"11",12671821,2124,133,2082,42,1991,1.049572906688,0.33144407579621,0.0201729106628241
"United States","Illinois","IL",2021-03-21,2021-03-27,7,2021,"12",12671821,2134,171,2065,69,1963,1.34945088002742,0.544515267379487,0.0334140435835351
"United States","Illinois","IL",2021-03-28,2021-04-03,7,2021,"13",12671821,2186,2402,2064,122,-216,18.9554445252975,0.962766124931847,0.0591085271317831
"United States","Illinois","IL",2021-04-04,2021-04-10,7,2021,"14",12671821,2241,142,2043,198,2099,1.12059663721576,1.5625220716107,0.0969162995594715
"United States","Illinois","IL",2021-04-11,2021-04-17,7,2021,"15",12671821,2128,168,2018,110,1960,1.32577630318484,0.868067817561501,0.0545094152626362
"United States","Illinois","IL",2021-04-18,2021-04-24,7,2021,"16",12671821,2241,169,2006,235,2072,1.33366782879903,1.85450851933593,0.117148554336989
"United States","Illinois","IL",2021-04-25,2021-05-01,7,2021,"17",12671821,2247,216,1993,254,2031,1.70456953266622,2.00444750600565,0.12744606121425
"United States","Illinois","IL",2021-05-02,2021-05-08,7,2021,"18",12671821,2179,216,1989,190,1963,1.70456953266622,1.49938986669714,0.0955253896430368
"United States","Illinois","IL",2021-05-09,2021-05-15,7,2021,"19",12671821,2146,179,1972,174,1967,1.41258308494099,1.37312545687001,0.088235294117647
"United States","Illinois","IL",2021-05-16,2021-05-22,7,2021,"20",12671821,2231,210,1962,269,2021,1.65722037898105,2.12282039021858,0.13710499490316
"United States","Illinois","IL",2021-05-23,2021-05-29,7,2021,"21",12671821,2032,231,1933,99,1801,1.82294241687915,0.781261035805351,0.0512157268494569
"United States","Illinois","IL",2021-05-30,2021-06-05,7,2021,"22",12671821,2185,116,1918,267,2069,0.915416971246674,2.10703733899019,0.139207507820647
"United States","Illinois","IL",2021-06-06,2021-06-12,7,2021,"23",12671821,2083,187,1911,172,1896,1.47571528985455,1.35734240564162,0.0900052328623757
"United States","Illinois","IL",2021-06-13,2021-06-19,7,2021,"24",12671821,1969,97,1898,71,1872,0.76547798457696,0.560298318607878,0.0374077976817704
"United States","Illinois","IL",2021-06-20,2021-06-26,7,2021,"25",12671821,1814,71,1882,-68,1743,0.560298318607878,-0.536623741765292,-0.0361317747077577
"United States","Indiana","IN",2019-12-29,2020-01-04,7,2020,"1",6732219,1470,0,1480,-10,1470,0,-0.148539434026136,-0.0067567567567568
"United States","Indiana","IN",2020-01-05,2020-01-11,7,2020,"2",6732219,1386,0,1494,-108,1386,0,-1.60422588748227,-0.072289156626506
"United States","Indiana","IN",2020-01-12,2020-01-18,7,2020,"3",6732219,1389,0,1494,-105,1389,0,-1.55966405727443,-0.070281124497992
"United States","Indiana","IN",2020-01-19,2020-01-25,7,2020,"4",6732219,1422,0,1477,-55,1422,0,-0.816966887143749,-0.037237643872715
"United States","Indiana","IN",2020-01-26,2020-02-01,7,2020,"5",6732219,1380,0,1439,-59,1380,0,-0.876382660754203,-0.0410006949270326
"United States","Indiana","IN",2020-02-02,2020-02-08,7,2020,"6",6732219,1363,0,1437,-74,1363,0,-1.09919181179341,-0.0514961725817675
"United States","Indiana","IN",2020-02-09,2020-02-15,7,2020,"7",6732219,1429,0,1417,12,1429,0,0.178247320831363,0.00846859562455893
"United States","Indiana","IN",2020-02-16,2020-02-22,7,2020,"8",6732219,1412,0,1411,1,1412,0,0.0148539434026136,0.000708717221828525
"United States","Indiana","IN",2020-02-23,2020-02-29,7,2020,"9",6732219,1449,0,1384,65,1449,0,0.965506321169885,0.0469653179190752
"United States","Indiana","IN",2020-03-01,2020-03-07,7,2020,"10",6732219,1372,0,1388,-16,1372,0,-0.237663094441818,-0.0115273775216138
"United States","Indiana","IN",2020-03-08,2020-03-14,7,2020,"11",6732219,1407,0,1388,19,1407,0,0.282224924649659,0.0136887608069165
"United States","Indiana","IN",2020-03-15,2020-03-21,7,2020,"12",6732219,1329,9,1386,-57,1320,0.133685490623523,-0.846674773948976,-0.0411255411255411
"United States","Indiana","IN",2020-03-22,2020-03-28,7,2020,"13",6732219,1486,38,1368,118,1448,0.564449849299317,1.75276532150841,0.0862573099415205
"United States","Indiana","IN",2020-03-29,2020-04-04,7,2020,"14",6732219,1581,138,1349,232,1443,2.04984418956068,3.44611486940636,0.171979243884359
"United States","Indiana","IN",2020-04-05,2020-04-11,7,2020,"15",6732219,1633,207,1336,297,1426,3.07476628434102,4.41162119057624,0.222305389221557
"United States","Indiana","IN",2020-04-12,2020-04-18,7,2020,"16",6732219,1510,224,1315,195,1286,3.32728332218545,2.89651896350965,0.14828897338403
"United States","Indiana","IN",2020-04-19,2020-04-25,7,2020,"17",6732219,1597,227,1293,304,1370,3.37184515239329,4.51559879439454,0.235112142304718
"United States","Indiana","IN",2020-04-26,2020-05-02,7,2020,"18",6732219,1537,272,1262,275,1265,4.0402726055109,4.08483443571874,0.217908082408875
"United States","Indiana","IN",2020-05-03,2020-05-09,7,2020,"19",6732219,1583,247,1236,347,1336,3.66892402044556,5.15431836070692,0.280744336569579
"United States","Indiana","IN",2020-05-10,2020-05-16,7,2020,"20",6732219,1572,234,1228,344,1338,3.47582275621158,5.10975653049908,0.280130293159609
"United States","Indiana","IN",2020-05-17,2020-05-23,7,2020,"21",6732219,1474,216,1212,262,1258,3.20845177496454,3.89173317148477,0.216171617161716
"United States","Indiana","IN",2020-05-24,2020-05-30,7,2020,"22",6732219,1383,131,1218,165,1252,1.94586658574238,2.45090066143125,0.135467980295567
"United States","Indiana","IN",2020-05-31,2020-06-06,7,2020,"23",6732219,1396,167,1203,193,1229,2.48060854823647,2.86681107670443,0.160432252701579
"United States","Indiana","IN",2020-06-07,2020-06-13,7,2020,"24",6732219,1392,121,1198,194,1271,1.79732715171625,2.88166502010704,0.161936560934892
"United States","Indiana","IN",2020-06-14,2020-06-20,7,2020,"25",6732219,1353,115,1203,150,1238,1.70820349130057,2.22809151039204,0.124688279301746
"United States","Indiana","IN",2020-06-21,2020-06-27,7,2020,"26",6732219,1380,78,1201,179,1302,1.15860758540386,2.65885586906784,0.149042464612823
"United States","Indiana","IN",2020-06-28,2020-07-04,7,2020,"27",6732219,1345,70,1190,155,1275,1.03977603818295,2.30236122740511,0.130252100840336
"United States","Indiana","IN",2020-07-05,2020-07-11,7,2020,"28",6732219,1352,69,1194,158,1283,1.02492209478034,2.34692305761295,0.132328308207705
"United States","Indiana","IN",2020-07-12,2020-07-18,7,2020,"29",6732219,1383,64,1183,200,1319,0.950652377767271,2.97078868052272,0.169061707523246
"United States","Indiana","IN",2020-07-19,2020-07-25,7,2020,"30",6732219,1318,71,1170,148,1247,1.05462998158557,2.19838362358681,0.126495726495726
"United States","Indiana","IN",2020-07-26,2020-08-01,7,2020,"31",6732219,1367,73,1160,207,1294,1.08433786839079,3.07476628434102,0.178448275862069
"United States","Indiana","IN",2020-08-02,2020-08-08,7,2020,"32",6732219,1344,63,1161,183,1281,0.935798434364657,2.71827164267829,0.157622739018088
"United States","Indiana","IN",2020-08-09,2020-08-15,7,2020,"33",6732219,1372,87,1163,209,1285,1.29229307602738,3.10447417114624,0.179707652622528
"United States","Indiana","IN",2020-08-16,2020-08-22,7,2020,"34",6732219,1359,80,1165,194,1279,1.18831547220909,2.88166502010704,0.166523605150215
"United States","Indiana","IN",2020-08-23,2020-08-29,7,2020,"35",6732219,1356,284,1163,193,1072,4.21851992634227,2.86681107670443,0.165950128976784
"United States","Indiana","IN",2020-08-30,2020-09-05,7,2020,"36",6732219,1271,77,1170,101,1194,1.14375364200125,1.50024828366397,0.0863247863247862
"United States","Indiana","IN",2020-09-06,2020-09-12,7,2020,"37",6732219,1343,75,1164,179,1268,1.11404575519602,2.65885586906784,0.153780068728522
"United States","Indiana","IN",2020-09-13,2020-09-19,7,2020,"38",6732219,1409,66,1165,244,1343,0.980360264572498,3.62436219023772,0.209442060085837
"United States","Indiana","IN",2020-09-20,2020-09-26,7,2020,"39",6732219,1441,74,1172,269,1367,1.09919181179341,3.99571077530306,0.229522184300341
"United States","Indiana","IN",2020-09-27,2020-10-03,7,2020,"40",6732219,1411,92,1180,231,1319,1.36656279304045,3.43126092600374,0.195762711864407
"United States","Indiana","IN",2020-10-04,2020-10-10,7,2020,"41",6732219,1442,113,1187,255,1329,1.67849560449534,3.78775556766647,0.214827295703454
"United States","Indiana","IN",2020-10-11,2020-10-17,7,2020,"42",6732219,1524,136,1200,324,1388,2.02013630275545,4.81267766244681,0.27
"United States","Indiana","IN",2020-10-18,2020-10-24,7,2020,"43",6732219,1514,200,1198,316,1314,2.97078868052272,4.6938461152259,0.263772954924875
"United States","Indiana","IN",2020-10-25,2020-10-31,7,2020,"44",6732219,1600,213,1208,392,1387,3.1638899447567,5.82274581382454,0.324503311258278
"United States","Indiana","IN",2020-11-01,2020-11-07,7,2020,"45",6732219,1655,260,1218,437,1395,3.86202528467954,6.49117326694215,0.358784893267652
"United States","Indiana","IN",2020-11-08,2020-11-14,7,2020,"46",6732219,1721,296,1229,492,1425,4.39676724717363,7.3081401540859,0.400325467860049
"United States","Indiana","IN",2020-11-15,2020-11-21,7,2020,"47",6732219,1936,359,1235,701,1577,5.33256568153829,10.4126143252321,0.567611336032389
"United States","Indiana","IN",2020-11-22,2020-11-28,7,2020,"48",6732219,2015,417,1257,758,1598,6.19409439888988,11.2592890991811,0.6030230708035
"United States","Indiana","IN",2020-11-29,2020-12-05,7,2020,"49",6732219,1943,544,1276,667,1399,8.08054521102181,9.90758024954328,0.522727272727273
"United States","Indiana","IN",2020-12-06,2020-12-12,7,2020,"50",6732219,2119,550,1303,816,1569,8.16966887143749,12.1208178165327,0.626247122026094
"United States","Indiana","IN",2020-12-13,2020-12-19,7,2020,"51",6732219,2060,581,1321,739,1479,8.63014111691851,10.9770641745315,0.559424678274035
"United States","Indiana","IN",2020-12-20,2020-12-26,7,2020,"52",6732219,2010,463,1342,668,1547,6.8773757954101,9.92243419294589,0.497764530551416
"United States","Indiana","IN",2020-12-27,2021-01-02,7,2020,"53",6732219,2045,609,1362,683,1436,9.04605153219169,10.1452433439851,0.501468428781204
"United States","Indiana","IN",2021-01-03,2021-01-09,7,2021,"1",6732219,1966,556,1386,580,1410,8.25879253185317,8.61528717351589,0.418470418470418
"United States","Indiana","IN",2021-01-10,2021-01-16,7,2021,"2",6732219,1923,321,1391,532,1602,4.76811583223897,7.90229789019044,0.382458662832495
"United States","Indiana","IN",2021-01-17,2021-01-23,7,2021,"3",6732219,1797,405,1394,403,1392,6.01584707805851,5.98613919125328,0.28909612625538
"United States","Indiana","IN",2021-01-24,2021-01-30,7,2021,"4",6732219,1635,275,1395,240,1360,4.08483443571874,3.56494641662727,0.172043010752688
"United States","Indiana","IN",2021-01-31,2021-02-06,7,2021,"5",6732219,1617,1785,1388,229,-168,26.5142889736653,3.40155303919852,0.164985590778098
"United States","Indiana","IN",2021-02-07,2021-02-13,7,2021,"6",6732219,1510,397,1376,134,1113,5.8970155308376,1.99042841595022,0.0973837209302326
"United States","Indiana","IN",2021-02-14,2021-02-20,7,2021,"7",6732219,1470,189,1358,112,1281,2.80739530309397,1.66364166109272,0.0824742268041236
"United States","Indiana","IN",2021-02-21,2021-02-27,7,2021,"8",6732219,1442,222,1349,93,1220,3.29757543538022,1.38141673644307,0.0689399555226093
"United States","Indiana","IN",2021-02-28,2021-03-06,7,2021,"9",6732219,1415,168,1340,75,1247,2.49546249163909,1.11404575519602,0.0559701492537314
"United States","Indiana","IN",2021-03-07,2021-03-13,7,2021,"10",6732219,1380,119,1328,52,1261,1.76761926491102,0.772405056935908,0.0391566265060241
"United States","Indiana","IN",2021-03-14,2021-03-20,7,2021,"11",6732219,1308,82,1334,-26,1226,1.21802335901432,-0.386202528467954,-0.0194902548725637
"United States","Indiana","IN",2021-03-21,2021-03-27,7,2021,"12",6732219,1301,85,1336,-35,1216,1.26258518922216,-0.519888019091476,-0.0261976047904192
"United States","Indiana","IN",2021-03-28,2021-04-03,7,2021,"13",6732219,1279,64,1332,-53,1215,0.950652377767271,-0.787259000338521,-0.0397897897897898
"United States","Indiana","IN",2021-04-04,2021-04-10,7,2021,"14",6732219,1363,60,1320,43,1303,0.891236604156817,0.638719566312385,0.0325757575757575
"United States","Indiana","IN",2021-04-11,2021-04-17,7,2021,"15",6732219,1383,78,1305,78,1305,1.15860758540386,1.15860758540386,0.0597701149425287
"United States","Indiana","IN",2021-04-18,2021-04-24,7,2021,"16",6732219,1270,55,1284,-14,1215,0.816966887143749,-0.207955207636591,-0.0109034267912772
"United States","Indiana","IN",2021-04-25,2021-05-01,7,2021,"17",6732219,1344,67,1283,61,1277,0.995214207975112,0.90609054755943,0.0475448168355417
"United States","Indiana","IN",2021-05-02,2021-05-08,7,2021,"18",6732219,1292,67,1275,17,1225,0.995214207975112,0.252517037844431,0.0133333333333334
"United States","Indiana","IN",2021-05-09,2021-05-15,7,2021,"19",6732219,1255,66,1264,-9,1189,0.980360264572498,-0.133685490623523,-0.007120253164557
"United States","Indiana","IN",2021-05-16,2021-05-22,7,2021,"20",6732219,1304,82,1253,51,1222,1.21802335901432,0.757551113533294,0.0407023144453311
"United States","Indiana","IN",2021-05-23,2021-05-29,7,2021,"21",6732219,1261,62,1237,24,1199,0.920944490962044,0.356494641662727,0.0194017784963623
"United States","Indiana","IN",2021-05-30,2021-06-05,7,2021,"22",6732219,1278,70,1231,47,1208,1.03977603818295,0.69813533992284,0.0381803411860275
"United States","Indiana","IN",2021-06-06,2021-06-12,7,2021,"23",6732219,1141,60,1223,-82,1081,0.891236604156817,-1.21802335901432,-0.0670482420278005
"United States","Indiana","IN",2021-06-13,2021-06-19,7,2021,"24",6732219,1126,50,1229,-103,1076,0.742697170130681,-1.5299561704692,-0.0838079739625712
"United States","Indiana","IN",2021-06-20,2021-06-26,7,2021,"25",6732219,809,27,1235,-426,782,0.401056471870568,-6.3277798895134,-0.344939271255061
"United States","Iowa","IA",2019-12-29,2020-01-04,7,2020,"1",3155070,665,0,686,-21,665,0,-0.665595375062994,-0.0306122448979592
"United States","Iowa","IA",2020-01-05,2020-01-11,7,2020,"2",3155070,647,0,695,-48,647,0,-1.52136085728684,-0.0690647482014388
"United States","Iowa","IA",2020-01-12,2020-01-18,7,2020,"3",3155070,620,0,685,-65,620,0,-2.06017616090927,-0.0948905109489051
"United States","Iowa","IA",2020-01-19,2020-01-25,7,2020,"4",3155070,640,0,676,-36,640,0,-1.14102064296513,-0.0532544378698225
"United States","Iowa","IA",2020-01-26,2020-02-01,7,2020,"5",3155070,615,0,674,-59,615,0,-1.87000605374841,-0.0875370919881305
"United States","Iowa","IA",2020-02-02,2020-02-08,7,2020,"6",3155070,637,0,666,-29,637,0,-0.919155517944134,-0.0435435435435435
"United States","Iowa","IA",2020-02-09,2020-02-15,7,2020,"7",3155070,600,0,657,-57,600,0,-1.80661601802813,-0.08675799086758
"United States","Iowa","IA",2020-02-16,2020-02-22,7,2020,"8",3155070,643,0,647,-4,643,0,-0.12678007144057,-0.00618238021638329
"United States","Iowa","IA",2020-02-23,2020-02-29,7,2020,"9",3155070,642,0,635,7,642,0,0.221865125020998,0.0110236220472442
"United States","Iowa","IA",2020-03-01,2020-03-07,7,2020,"10",3155070,624,0,630,-6,624,0,-0.190170107160855,-0.00952380952380949
"United States","Iowa","IA",2020-03-08,2020-03-14,7,2020,"11",3155070,636,0,621,15,636,0,0.475425267902138,0.0241545893719808
"United States","Iowa","IA",2020-03-15,2020-03-21,7,2020,"12",3155070,598,0,612,-14,598,0,-0.443730250041996,-0.0228758169934641
"United States","Iowa","IA",2020-03-22,2020-03-28,7,2020,"13",3155070,595,3,605,-10,592,0.0950850535804277,-0.316950178601426,-0.0165289256198347
"United States","Iowa","IA",2020-03-29,2020-04-04,7,2020,"14",3155070,608,8,598,10,600,0.25356014288114,0.316950178601426,0.0167224080267558
"United States","Iowa","IA",2020-04-05,2020-04-11,7,2020,"15",3155070,597,23,594,3,574,0.728985410783279,0.0950850535804277,0.00505050505050497
"United States","Iowa","IA",2020-04-12,2020-04-18,7,2020,"16",3155070,633,40,594,39,593,1.2678007144057,1.23610569654556,0.0656565656565657
"United States","Iowa","IA",2020-04-19,2020-04-25,7,2020,"17",3155070,587,38,593,-6,549,1.20441067868542,-0.190170107160855,-0.0101180438448567
"United States","Iowa","IA",2020-04-26,2020-05-02,7,2020,"18",3155070,673,63,590,83,610,1.99678612518898,2.63068648239183,0.140677966101695
"United States","Iowa","IA",2020-05-03,2020-05-09,7,2020,"19",3155070,702,76,587,115,626,2.40882135737083,3.64492705391639,0.195911413969336
"United States","Iowa","IA",2020-05-10,2020-05-16,7,2020,"20",3155070,674,95,569,105,579,3.01102669671354,3.32797687531497,0.184534270650264
"United States","Iowa","IA",2020-05-17,2020-05-23,7,2020,"21",3155070,619,98,548,71,521,3.10611175029397,2.25034626807012,0.12956204379562
"United States","Iowa","IA",2020-05-24,2020-05-30,7,2020,"22",3155070,632,83,547,85,549,2.63068648239183,2.69407651811212,0.155393053016453
"United States","Iowa","IA",2020-05-31,2020-06-06,7,2020,"23",3155070,600,71,550,50,529,2.25034626807012,1.58475089300713,0.0909090909090908
"United States","Iowa","IA",2020-06-07,2020-06-13,7,2020,"24",3155070,589,51,546,43,538,1.61644591086727,1.36288576798613,0.0787545787545787
"United States","Iowa","IA",2020-06-14,2020-06-20,7,2020,"25",3155070,575,32,550,25,543,1.01424057152456,0.792375446503564,0.0454545454545454
"United States","Iowa","IA",2020-06-21,2020-06-27,7,2020,"26",3155070,552,23,542,10,529,0.728985410783279,0.316950178601426,0.018450184501845
"United States","Iowa","IA",2020-06-28,2020-07-04,7,2020,"27",3155070,596,17,527,69,579,0.538815303622424,2.18695623234984,0.130929791271347
"United States","Iowa","IA",2020-07-05,2020-07-11,7,2020,"28",3155070,567,27,518,49,540,0.855765482223849,1.55305587514699,0.0945945945945945
"United States","Iowa","IA",2020-07-12,2020-07-18,7,2020,"29",3155070,601,39,518,83,562,1.23610569654556,2.63068648239183,0.16023166023166
"United States","Iowa","IA",2020-07-19,2020-07-25,7,2020,"30",3155070,651,39,512,139,612,1.23610569654556,4.40560748255982,0.271484375
"United States","Iowa","IA",2020-07-26,2020-08-01,7,2020,"31",3155070,650,46,515,135,604,1.45797082156656,4.27882741111925,0.262135922330097
"United States","Iowa","IA",2020-08-02,2020-08-08,7,2020,"32",3155070,649,53,510,139,596,1.67983594658756,4.40560748255982,0.272549019607843
"United States","Iowa","IA",2020-08-09,2020-08-15,7,2020,"33",3155070,669,48,516,153,621,1.52136085728684,4.84933773260181,0.296511627906977
"United States","Iowa","IA",2020-08-16,2020-08-22,7,2020,"34",3155070,625,57,516,109,568,1.80661601802813,3.45475694675554,0.211240310077519
"United States","Iowa","IA",2020-08-23,2020-08-29,7,2020,"35",3155070,691,78,518,173,613,2.47221139309112,5.48323808980466,0.333976833976834
"United States","Iowa","IA",2020-08-30,2020-09-05,7,2020,"36",3155070,597,52,527,70,545,1.64814092872741,2.21865125020998,0.132827324478178
"United States","Iowa","IA",2020-09-06,2020-09-12,7,2020,"37",3155070,637,48,530,107,589,1.52136085728684,3.39136691103525,0.20188679245283
"United States","Iowa","IA",2020-09-13,2020-09-19,7,2020,"38",3155070,642,56,528,114,586,1.77492100016798,3.61323203605625,0.215909090909091
"United States","Iowa","IA",2020-09-20,2020-09-26,7,2020,"39",3155070,641,47,535,106,594,1.4896658394267,3.35967189317511,0.198130841121495
"United States","Iowa","IA",2020-09-27,2020-10-03,7,2020,"40",3155070,680,66,549,131,614,2.09187117876941,4.15204733967868,0.238615664845173
"United States","Iowa","IA",2020-10-04,2020-10-10,7,2020,"41",3155070,733,77,571,162,656,2.44051637523098,5.1345928933431,0.283712784588441
"United States","Iowa","IA",2020-10-11,2020-10-17,7,2020,"42",3155070,688,72,566,122,616,2.28204128593026,3.86679217893739,0.215547703180212
"United States","Iowa","IA",2020-10-18,2020-10-24,7,2020,"43",3155070,750,103,562,188,647,3.26458683959468,5.9586633577068,0.334519572953737
"United States","Iowa","IA",2020-10-25,2020-10-31,7,2020,"44",3155070,759,86,569,190,673,2.72577153597226,6.02205339342709,0.333919156414763
"United States","Iowa","IA",2020-11-01,2020-11-07,7,2020,"45",3155070,860,100,566,294,760,3.16950178601426,9.31833525088191,0.519434628975265
"United States","Iowa","IA",2020-11-08,2020-11-14,7,2020,"46",3155070,905,154,576,329,751,4.88103275046196,10.4276608759869,0.571180555555556
"United States","Iowa","IA",2020-11-15,2020-11-21,7,2020,"47",3155070,998,186,582,416,812,5.89527332198652,13.1851274298193,0.714776632302405
"United States","Iowa","IA",2020-11-22,2020-11-28,7,2020,"48",3155070,976,192,575,401,784,6.08544342914737,12.7097021619172,0.697391304347826
"United States","Iowa","IA",2020-11-29,2020-12-05,7,2020,"49",3155070,1002,279,578,424,723,8.84290998297977,13.4386875727004,0.73356401384083
"United States","Iowa","IA",2020-12-06,2020-12-12,7,2020,"50",3155070,950,582,587,363,368,18.446500394603,11.5052914832318,0.61839863713799
"United States","Iowa","IA",2020-12-13,2020-12-19,7,2020,"51",3155070,864,242,595,269,622,7.6701943221545,8.52595980437835,0.452100840336134
"United States","Iowa","IA",2020-12-20,2020-12-26,7,2020,"52",3155070,834,293,606,228,541,9.28664023302177,7.22646407211251,0.376237623762376
"United States","Iowa","IA",2020-12-27,2021-01-02,7,2020,"53",3155070,743,201,618,125,542,6.37069858988866,3.96187723251782,0.202265372168285
"United States","Iowa","IA",2021-01-03,2021-01-09,7,2021,"1",3155070,799,183,628,171,616,5.80018826840609,5.41984805408438,0.272292993630573
"United States","Iowa","IA",2021-01-10,2021-01-16,7,2021,"2",3155070,760,194,633,127,566,6.14883346486766,4.02526726823811,0.200631911532386
"United States","Iowa","IA",2021-01-17,2021-01-23,7,2021,"3",3155070,754,165,633,121,589,5.22967794692352,3.83509716107725,0.191153238546603
"United States","Iowa","IA",2021-01-24,2021-01-30,7,2021,"4",3155070,650,165,634,16,485,5.22967794692352,0.507120285762281,0.025236593059937
"United States","Iowa","IA",2021-01-31,2021-02-06,7,2021,"5",3155070,655,457,637,18,198,14.4846231620852,0.570510321482566,0.0282574568288854
"United States","Iowa","IA",2021-02-07,2021-02-13,7,2021,"6",3155070,613,128,635,-22,485,4.05696228609825,-0.697290392923136,-0.0346456692913386
"United States","Iowa","IA",2021-02-14,2021-02-20,7,2021,"7",3155070,664,100,633,31,564,3.16950178601426,0.982545553664419,0.0489731437598737
"United States","Iowa","IA",2021-02-21,2021-02-27,7,2021,"8",3155070,591,135,637,-46,456,4.27882741111925,-1.45797082156656,-0.0722135007849294
"United States","Iowa","IA",2021-02-28,2021-03-06,7,2021,"9",3155070,623,79,637,-14,544,2.50390641095126,-0.443730250041996,-0.021978021978022
"United States","Iowa","IA",2021-03-07,2021-03-13,7,2021,"10",3155070,563,84,624,-61,479,2.66238150025198,-1.9333960894687,-0.0977564102564102
"United States","Iowa","IA",2021-03-14,2021-03-20,7,2021,"11",3155070,506,40,614,-108,466,1.2678007144057,-3.4230619288954,-0.175895765472313
"United States","Iowa","IA",2021-03-21,2021-03-27,7,2021,"12",3155070,568,43,616,-48,525,1.36288576798613,-1.52136085728684,-0.0779220779220779
"United States","Iowa","IA",2021-03-28,2021-04-03,7,2021,"13",3155070,577,38,615,-38,539,1.20441067868542,-1.20441067868542,-0.0617886178861788
"United States","Iowa","IA",2021-04-04,2021-04-10,7,2021,"14",3155070,631,94,601,30,537,2.9793316788534,0.950850535804277,0.0499168053244592
"United States","Iowa","IA",2021-04-11,2021-04-17,7,2021,"15",3155070,572,32,602,-30,540,1.01424057152456,-0.950850535804277,-0.0498338870431894
"United States","Iowa","IA",2021-04-18,2021-04-24,7,2021,"16",3155070,617,26,605,12,591,0.824070464363707,0.380340214321711,0.0198347107438017
"United States","Iowa","IA",2021-04-25,2021-05-01,7,2021,"17",3155070,632,43,593,39,589,1.36288576798613,1.23610569654556,0.0657672849915683
"United States","Iowa","IA",2021-05-02,2021-05-08,7,2021,"18",3155070,567,33,588,-21,534,1.0459355893847,-0.665595375062994,-0.0357142857142857
"United States","Iowa","IA",2021-05-09,2021-05-15,7,2021,"19",3155070,551,15,590,-39,536,0.475425267902138,-1.23610569654556,-0.0661016949152542
"United States","Iowa","IA",2021-05-16,2021-05-22,7,2021,"20",3155070,526,36,582,-56,490,1.14102064296513,-1.77492100016798,-0.0962199312714777
"United States","Iowa","IA",2021-05-23,2021-05-29,7,2021,"21",3155070,560,19,576,-16,541,0.602205339342709,-0.507120285762281,-0.0277777777777778
"United States","Iowa","IA",2021-05-30,2021-06-05,7,2021,"22",3155070,532,14,580,-48,518,0.443730250041996,-1.52136085728684,-0.0827586206896552
"United States","Iowa","IA",2021-06-06,2021-06-12,7,2021,"23",3155070,549,30,573,-24,519,0.950850535804277,-0.760680428643422,-0.0418848167539267
"United States","Iowa","IA",2021-06-13,2021-06-19,7,2021,"24",3155070,522,12,574,-52,510,0.380340214321711,-1.64814092872741,-0.0905923344947736
"United States","Iowa","IA",2021-06-20,2021-06-26,7,2021,"25",3155070,420,16,582,-162,404,0.507120285762281,-5.1345928933431,-0.278350515463918
"United States","Kansas","KS",2019-12-29,2020-01-04,7,2020,"1",2913314,591,0,612,-21,591,0,-0.720828582157639,-0.0343137254901961
"United States","Kansas","KS",2020-01-05,2020-01-11,7,2020,"2",2913314,560,0,562,-2,560,0,-0.0686503411578704,-0.00355871886120995
"United States","Kansas","KS",2020-01-12,2020-01-18,7,2020,"3",2913314,576,0,609,-33,576,0,-1.13273062910486,-0.0541871921182266
"United States","Kansas","KS",2020-01-19,2020-01-25,7,2020,"4",2913314,571,0,596,-25,571,0,-0.85812926447338,-0.0419463087248322
"United States","Kansas","KS",2020-01-26,2020-02-01,7,2020,"5",2913314,549,0,590,-41,549,0,-1.40733199373634,-0.0694915254237288
"United States","Kansas","KS",2020-02-02,2020-02-08,7,2020,"6",2913314,503,0,588,-85,503,0,-2.91763949920949,-0.144557823129252
"United States","Kansas","KS",2020-02-09,2020-02-15,7,2020,"7",2913314,575,0,577,-2,575,0,-0.0686503411578704,-0.00346620450606583
"United States","Kansas","KS",2020-02-16,2020-02-22,7,2020,"8",2913314,559,0,576,-17,559,0,-0.583527899841898,-0.0295138888888888
"United States","Kansas","KS",2020-02-23,2020-02-29,7,2020,"9",2913314,548,0,572,-24,548,0,-0.823804093894445,-0.041958041958042
"United States","Kansas","KS",2020-03-01,2020-03-07,7,2020,"10",2913314,575,0,563,12,575,0,0.411902046947222,0.0213143872113677
"United States","Kansas","KS",2020-03-08,2020-03-14,7,2020,"11",2913314,522,1,553,-31,521,0.0343251705789352,-1.06408028794699,-0.0560578661844484
"United States","Kansas","KS",2020-03-15,2020-03-21,7,2020,"12",2913314,515,1,543,-28,514,0.0343251705789352,-0.961104776210185,-0.0515653775322283
"United States","Kansas","KS",2020-03-22,2020-03-28,7,2020,"13",2913314,523,3,538,-15,520,0.102975511736806,-0.514877558684028,-0.0278810408921933
"United States","Kansas","KS",2020-03-29,2020-04-04,7,2020,"14",2913314,550,16,527,23,534,0.549202729262963,0.78947892331551,0.0436432637571158
"United States","Kansas","KS",2020-04-05,2020-04-11,7,2020,"15",2913314,525,34,516,9,491,1.1670557996838,0.308926535210417,0.0174418604651163
"United States","Kansas","KS",2020-04-12,2020-04-18,7,2020,"16",2913314,546,32,507,39,514,1.09840545852593,1.33868165257847,0.0769230769230769
"United States","Kansas","KS",2020-04-19,2020-04-25,7,2020,"17",2913314,541,33,502,39,508,1.13273062910486,1.33868165257847,0.0776892430278884
"United States","Kansas","KS",2020-04-26,2020-05-02,7,2020,"18",2913314,526,22,496,30,504,0.755153752736574,1.02975511736806,0.060483870967742
"United States","Kansas","KS",2020-05-03,2020-05-09,7,2020,"19",2913314,507,31,493,14,476,1.06408028794699,0.480552388105093,0.028397565922921
"United States","Kansas","KS",2020-05-10,2020-05-16,7,2020,"20",2913314,530,21,488,42,509,0.720828582157639,1.44165716431528,0.0860655737704918
"United States","Kansas","KS",2020-05-17,2020-05-23,7,2020,"21",2913314,520,10,484,36,510,0.343251705789352,1.23570614084167,0.0743801652892562
"United States","Kansas","KS",2020-05-24,2020-05-30,7,2020,"22",2913314,506,9,481,25,497,0.308926535210417,0.85812926447338,0.0519750519750519
"United States","Kansas","KS",2020-05-31,2020-06-06,7,2020,"23",2913314,499,19,478,21,480,0.652178240999769,0.720828582157639,0.0439330543933054
"United States","Kansas","KS",2020-06-07,2020-06-13,7,2020,"24",2913314,516,11,482,34,505,0.377576876368287,1.1670557996838,0.0705394190871369
"United States","Kansas","KS",2020-06-14,2020-06-20,7,2020,"25",2913314,508,19,477,31,489,0.652178240999769,1.06408028794699,0.0649895178197064
"United States","Kansas","KS",2020-06-21,2020-06-27,7,2020,"26",2913314,521,6,480,41,515,0.205951023473611,1.40733199373634,0.0854166666666667
"United States","Kansas","KS",2020-06-28,2020-07-04,7,2020,"27",2913314,562,7,480,82,555,0.240276194052546,2.81466398747269,0.170833333333333
"United States","Kansas","KS",2020-07-05,2020-07-11,7,2020,"28",2913314,504,13,483,21,491,0.446227217526157,0.720828582157639,0.0434782608695652
"United States","Kansas","KS",2020-07-12,2020-07-18,7,2020,"29",2913314,518,17,481,37,501,0.583527899841898,1.2700313114206,0.0769230769230769
"United States","Kansas","KS",2020-07-19,2020-07-25,7,2020,"30",2913314,540,19,475,65,521,0.652178240999769,2.23113608763079,0.136842105263158
"United States","Kansas","KS",2020-07-26,2020-08-01,7,2020,"31",2913314,543,34,470,73,509,1.1670557996838,2.50573745226227,0.15531914893617
"United States","Kansas","KS",2020-08-02,2020-08-08,7,2020,"32",2913314,601,22,469,132,579,0.755153752736574,4.53092251641945,0.281449893390192
"United States","Kansas","KS",2020-08-09,2020-08-15,7,2020,"33",2913314,577,27,464,113,550,0.92677960563125,3.87874427541968,0.243534482758621
"United States","Kansas","KS",2020-08-16,2020-08-22,7,2020,"34",2913314,514,23,467,47,491,0.78947892331551,1.61328301720995,0.100642398286938
"United States","Kansas","KS",2020-08-23,2020-08-29,7,2020,"35",2913314,532,18,468,64,514,0.617853070420833,2.19681091705185,0.136752136752137
"United States","Kansas","KS",2020-08-30,2020-09-05,7,2020,"36",2913314,566,33,471,95,533,1.13273062910486,3.26089120499884,0.201698513800425
"United States","Kansas","KS",2020-09-06,2020-09-12,7,2020,"37",2913314,581,41,470,111,540,1.40733199373634,3.81009393426181,0.236170212765958
"United States","Kansas","KS",2020-09-13,2020-09-19,7,2020,"38",2913314,553,76,478,75,477,2.60871296399907,2.57438779342014,0.156903765690377
"United States","Kansas","KS",2020-09-20,2020-09-26,7,2020,"39",2913314,601,34,477,124,567,1.1670557996838,4.25632115178796,0.259958071278826
"United States","Kansas","KS",2020-09-27,2020-10-03,7,2020,"40",2913314,580,66,476,104,514,2.26546125820972,3.56981774020926,0.218487394957983
"United States","Kansas","KS",2020-10-04,2020-10-10,7,2020,"41",2913314,638,65,477,161,573,2.23113608763079,5.52635246320857,0.337526205450734
"United States","Kansas","KS",2020-10-11,2020-10-17,7,2020,"42",2913314,636,96,479,157,540,3.29521637557778,5.38905178089283,0.32776617954071
"United States","Kansas","KS",2020-10-18,2020-10-24,7,2020,"43",2913314,658,116,480,178,542,3.98171978715648,6.10988036305046,0.370833333333333
"United States","Kansas","KS",2020-10-25,2020-10-31,7,2020,"44",2913314,577,54,488,89,523,1.8535592112625,3.05494018152523,0.182377049180328
"United States","Kansas","KS",2020-11-01,2020-11-07,7,2020,"45",2913314,679,137,500,179,542,4.70254836931412,6.1442055336294,0.358
"United States","Kansas","KS",2020-11-08,2020-11-14,7,2020,"46",2913314,719,88,503,216,631,3.0206150109463,7.41423684505,0.429423459244533
"United States","Kansas","KS",2020-11-15,2020-11-21,7,2020,"47",2913314,782,156,510,272,626,5.35472661031389,9.33644639747037,0.533333333333333
"United States","Kansas","KS",2020-11-22,2020-11-28,7,2020,"48",2913314,814,119,519,295,695,4.08469529889329,10.1259253207859,0.56840077071291
"United States","Kansas","KS",2020-11-29,2020-12-05,7,2020,"49",2913314,871,257,525,346,614,8.82156883878634,11.8765090203116,0.659047619047619
"United States","Kansas","KS",2020-12-06,2020-12-12,7,2020,"50",2913314,880,286,530,350,594,9.81699878557547,12.0138097026273,0.660377358490566
"United States","Kansas","KS",2020-12-13,2020-12-19,7,2020,"51",2913314,931,269,544,387,662,9.23347088573357,13.2838410140479,0.711397058823529
"United States","Kansas","KS",2020-12-20,2020-12-26,7,2020,"52",2913314,855,0,560,295,855,0,10.1259253207859,0.526785714285714
"United States","Kansas","KS",2020-12-27,2021-01-02,7,2020,"53",2913314,811,537,566,245,274,18.4326166008882,8.40966679183912,0.432862190812721
"United States","Kansas","KS",2021-01-03,2021-01-09,7,2021,"1",2913314,789,270,574,215,519,9.2677960563125,7.37991167447107,0.374564459930314
"United States","Kansas","KS",2021-01-10,2021-01-16,7,2021,"2",2913314,795,354,584,211,441,12.1511103849431,7.24261099215533,0.361301369863014
"United States","Kansas","KS",2021-01-17,2021-01-23,7,2021,"3",2913314,682,96,579,103,586,3.29521637557778,3.53549256963032,0.177892918825561
"United States","Kansas","KS",2021-01-24,2021-01-30,7,2021,"4",2913314,697,181,572,125,516,6.21285587478727,4.2906463223669,0.218531468531469
"United States","Kansas","KS",2021-01-31,2021-02-06,7,2021,"5",2913314,687,322,579,108,365,11.0527049264171,3.707118422525,0.186528497409326
"United States","Kansas","KS",2021-02-07,2021-02-13,7,2021,"6",2913314,588,263,578,10,325,9.02751986225996,0.343251705789352,0.0173010380622838
"United States","Kansas","KS",2021-02-14,2021-02-20,7,2021,"7",2913314,593,266,572,21,327,9.13049537399676,0.720828582157639,0.0367132867132867
"United States","Kansas","KS",2021-02-21,2021-02-27,7,2021,"8",2913314,600,122,574,26,478,4.18767081063009,0.892454435052315,0.0452961672473868
"United States","Kansas","KS",2021-02-28,2021-03-06,7,2021,"9",2913314,558,94,576,-18,464,3.22656603441991,-0.617853070420833,-0.03125
"United States","Kansas","KS",2021-03-07,2021-03-13,7,2021,"10",2913314,533,52,567,-34,481,1.78490887010463,-1.1670557996838,-0.0599647266313933
"United States","Kansas","KS",2021-03-14,2021-03-20,7,2021,"11",2913314,511,15,560,-49,496,0.514877558684028,-1.68193335836782,-0.0875
"United States","Kansas","KS",2021-03-21,2021-03-27,7,2021,"12",2913314,527,-21,548,-21,548,-0.720828582157639,-0.720828582157639,-0.0383211678832117
"United States","Kansas","KS",2021-03-28,2021-04-03,7,2021,"13",2913314,527,41,538,-11,486,1.40733199373634,-0.377576876368287,-0.0204460966542751
"United States","Kansas","KS",2021-04-04,2021-04-10,7,2021,"14",2913314,513,5,528,-15,508,0.171625852894676,-0.514877558684028,-0.0284090909090909
"United States","Kansas","KS",2021-04-11,2021-04-17,7,2021,"15",2913314,501,18,520,-19,483,0.617853070420833,-0.652178240999769,-0.0365384615384615
"United States","Kansas","KS",2021-04-18,2021-04-24,7,2021,"16",2913314,534,12,513,21,522,0.411902046947222,0.720828582157639,0.0409356725146199
"United States","Kansas","KS",2021-04-25,2021-05-01,7,2021,"17",2913314,519,14,513,6,505,0.480552388105093,0.205951023473611,0.0116959064327486
"United States","Kansas","KS",2021-05-02,2021-05-08,7,2021,"18",2913314,521,34,506,15,487,1.1670557996838,0.514877558684028,0.0296442687747036
"United States","Kansas","KS",2021-05-09,2021-05-15,7,2021,"19",2913314,515,22,504,11,493,0.755153752736574,0.377576876368287,0.0218253968253967
"United States","Kansas","KS",2021-05-16,2021-05-22,7,2021,"20",2913314,561,19,502,59,542,0.652178240999769,2.02518506415718,0.117529880478088
"United States","Kansas","KS",2021-05-23,2021-05-29,7,2021,"21",2913314,485,19,501,-16,466,0.652178240999769,-0.549202729262963,-0.0319361277445109
"United States","Kansas","KS",2021-05-30,2021-06-05,7,2021,"22",2913314,522,8,501,21,514,0.274601364631482,0.720828582157639,0.0419161676646707
"United States","Kansas","KS",2021-06-06,2021-06-12,7,2021,"23",2913314,537,22,500,37,515,0.755153752736574,1.2700313114206,0.0740000000000001
"United States","Kansas","KS",2021-06-13,2021-06-19,7,2021,"24",2913314,497,23,502,-5,474,0.78947892331551,-0.171625852894676,-0.00996015936254979
"United States","Kansas","KS",2021-06-20,2021-06-26,7,2021,"25",2913314,439,18,500,-61,421,0.617853070420833,-2.09383540531505,-0.122
"United States","Kentucky","KY",2019-12-29,2020-01-04,7,2020,"1",4467673,1093,0,1050,43,1093,0,0.962469724171845,0.0409523809523809
"United States","Kentucky","KY",2020-01-05,2020-01-11,7,2020,"2",4467673,1058,0,1049,9,1058,0,0.201447151570851,0.00857959961868437
"United States","Kentucky","KY",2020-01-12,2020-01-18,7,2020,"3",4467673,1041,0,1037,4,1041,0,0.0895320673648228,0.00385728061716484
"United States","Kentucky","KY",2020-01-19,2020-01-25,7,2020,"4",4467673,944,0,1025,-81,944,0,-1.81302436413766,-0.0790243902439024
"United States","Kentucky","KY",2020-01-26,2020-02-01,7,2020,"5",4467673,978,0,1010,-32,978,0,-0.716256538918582,-0.0316831683168317
"United States","Kentucky","KY",2020-02-02,2020-02-08,7,2020,"6",4467673,956,0,991,-35,956,0,-0.7834055894422,-0.0353178607467205
"United States","Kentucky","KY",2020-02-09,2020-02-15,7,2020,"7",4467673,955,0,994,-39,955,0,-0.872937656807022,-0.0392354124748491
"United States","Kentucky","KY",2020-02-16,2020-02-22,7,2020,"8",4467673,992,0,990,2,992,0,0.0447660336824114,0.00202020202020203
"United States","Kentucky","KY",2020-02-23,2020-02-29,7,2020,"9",4467673,1022,0,974,48,1022,0,1.07438480837787,0.0492813141683779
"United States","Kentucky","KY",2020-03-01,2020-03-07,7,2020,"10",4467673,1006,0,970,36,1006,0,0.805788606283405,0.0371134020618558
"United States","Kentucky","KY",2020-03-08,2020-03-14,7,2020,"11",4467673,1021,0,969,52,1021,0,1.1639168757427,0.0536635706914346
"United States","Kentucky","KY",2020-03-15,2020-03-21,7,2020,"12",4467673,949,3,958,-9,946,0.0671490505236171,-0.201447151570851,-0.00939457202505223
"United States","Kentucky","KY",2020-03-22,2020-03-28,7,2020,"13",4467673,937,7,950,-13,930,0.15668111788844,-0.290979218935674,-0.0136842105263157
"United States","Kentucky","KY",2020-03-29,2020-04-04,7,2020,"14",4467673,1048,30,948,100,1018,0.671490505236171,2.23830168412057,0.105485232067511
"United States","Kentucky","KY",2020-04-05,2020-04-11,7,2020,"15",4467673,1026,54,946,80,972,1.20868290942511,1.79064134729646,0.0845665961945032
"United States","Kentucky","KY",2020-04-12,2020-04-18,7,2020,"16",4467673,960,50,938,22,910,1.11915084206029,0.492426370506525,0.023454157782516
"United States","Kentucky","KY",2020-04-19,2020-04-25,7,2020,"17",4467673,975,61,926,49,914,1.36536402731355,1.09676782521908,0.0529157667386608
"United States","Kentucky","KY",2020-04-26,2020-05-02,7,2020,"18",4467673,998,43,914,84,955,0.962469724171845,1.88017341466128,0.0919037199124726
"United States","Kentucky","KY",2020-05-03,2020-05-09,7,2020,"19",4467673,1006,56,902,104,950,1.25344894310752,2.32783375148539,0.11529933481153
"United States","Kentucky","KY",2020-05-10,2020-05-16,7,2020,"20",4467673,995,30,890,105,965,0.671490505236171,2.3502167683266,0.117977528089888
"United States","Kentucky","KY",2020-05-17,2020-05-23,7,2020,"21",4467673,998,57,884,114,941,1.27583195994872,2.55166391989745,0.1289592760181
"United States","Kentucky","KY",2020-05-24,2020-05-30,7,2020,"22",4467673,987,40,888,99,947,0.895320673648228,2.21591866727936,0.111486486486486
"United States","Kentucky","KY",2020-05-31,2020-06-06,7,2020,"23",4467673,918,38,882,36,880,0.850554639965817,0.805788606283405,0.0408163265306123
"United States","Kentucky","KY",2020-06-07,2020-06-13,7,2020,"24",4467673,1002,29,881,121,973,0.649107488394965,2.70834503778589,0.137343927355278
"United States","Kentucky","KY",2020-06-14,2020-06-20,7,2020,"25",4467673,966,26,881,85,940,0.581958437871348,1.90255643150248,0.0964812712826333
"United States","Kentucky","KY",2020-06-21,2020-06-27,7,2020,"26",4467673,937,30,878,59,907,0.671490505236171,1.32059799363114,0.0671981776765376
"United States","Kentucky","KY",2020-06-28,2020-07-04,7,2020,"27",4467673,993,31,875,118,962,0.693873522077377,2.64119598726227,0.134857142857143
"United States","Kentucky","KY",2020-07-05,2020-07-11,7,2020,"28",4467673,1047,37,861,186,1010,0.828171623124611,4.16324113246426,0.21602787456446
"United States","Kentucky","KY",2020-07-12,2020-07-18,7,2020,"29",4467673,936,45,862,74,891,1.00723575785426,1.65634324624922,0.08584686774942
"United States","Kentucky","KY",2020-07-19,2020-07-25,7,2020,"30",4467673,968,29,859,109,939,0.649107488394965,2.43974883569142,0.126891734575087
"United States","Kentucky","KY",2020-07-26,2020-08-01,7,2020,"31",4467673,1031,44,855,176,987,0.984852741013051,3.9394109640522,0.205847953216374
"United States","Kentucky","KY",2020-08-02,2020-08-08,7,2020,"32",4467673,1007,32,850,157,975,0.716256538918582,3.5141336440693,0.184705882352941
"United States","Kentucky","KY",2020-08-09,2020-08-15,7,2020,"33",4467673,1015,38,852,163,977,0.850554639965817,3.64843174511653,0.19131455399061
"United States","Kentucky","KY",2020-08-16,2020-08-22,7,2020,"34",4467673,1078,62,853,225,1016,1.38774704415475,5.03617878927128,0.263774912075029
"United States","Kentucky","KY",2020-08-23,2020-08-29,7,2020,"35",4467673,1007,49,850,157,958,1.09676782521908,3.5141336440693,0.184705882352941
"United States","Kentucky","KY",2020-08-30,2020-09-05,7,2020,"36",4467673,1055,72,862,193,983,1.61157721256681,4.3199222503527,0.223897911832947
"United States","Kentucky","KY",2020-09-06,2020-09-12,7,2020,"37",4467673,1020,64,867,153,956,1.43251307783716,3.42460157670447,0.176470588235294
"United States","Kentucky","KY",2020-09-13,2020-09-19,7,2020,"38",4467673,1017,51,874,143,966,1.14153385890149,3.20077140829242,0.163615560640732
"United States","Kentucky","KY",2020-09-20,2020-09-26,7,2020,"39",4467673,1069,46,873,196,1023,1.02961877469546,4.38707130087632,0.224513172966781
"United States","Kentucky","KY",2020-09-27,2020-10-03,7,2020,"40",4467673,1008,51,885,123,957,1.14153385890149,2.7531110714683,0.138983050847458
"United States","Kentucky","KY",2020-10-04,2020-10-10,7,2020,"41",4467673,1068,44,885,183,1024,0.984852741013051,4.09609208194064,0.206779661016949
"United States","Kentucky","KY",2020-10-11,2020-10-17,7,2020,"42",4467673,1127,63,894,233,1064,1.41013006099596,5.21524292400093,0.260626398210291
"United States","Kentucky","KY",2020-10-18,2020-10-24,7,2020,"43",4467673,1183,92,901,282,1091,2.05923754939092,6.31201074922001,0.312985571587125
"United States","Kentucky","KY",2020-10-25,2020-10-31,7,2020,"44",4467673,1125,79,911,214,1046,1.76825833045525,4.78996560401802,0.234906695938529
"United States","Kentucky","KY",2020-11-01,2020-11-07,7,2020,"45",4467673,1181,76,922,259,1105,1.70110927993163,5.79720136187228,0.280911062906724
"United States","Kentucky","KY",2020-11-08,2020-11-14,7,2020,"46",4467673,1187,98,923,264,1089,2.19353565043816,5.9091164460783,0.28602383531961
"United States","Kentucky","KY",2020-11-15,2020-11-21,7,2020,"47",4467673,1289,125,930,359,1164,2.79787710515071,8.03550304599285,0.386021505376344
"United States","Kentucky","KY",2020-11-22,2020-11-28,7,2020,"48",4467673,1332,102,942,390,1230,2.28306771780298,8.72937656807022,0.414012738853503
"United States","Kentucky","KY",2020-11-29,2020-12-05,7,2020,"49",4467673,1357,178,958,399,1179,3.98417699773462,8.93082371964108,0.416492693110647
"United States","Kentucky","KY",2020-12-06,2020-12-12,7,2020,"50",4467673,1410,130,961,449,1280,2.90979218935674,10.0499745617014,0.467221644120708
"United States","Kentucky","KY",2020-12-13,2020-12-19,7,2020,"51",4467673,1382,179,986,396,1203,4.00656001457582,8.86367466911746,0.401622718052738
"United States","Kentucky","KY",2020-12-20,2020-12-26,7,2020,"52",4467673,1485,163,1013,472,1322,3.64843174511653,10.5647839490491,0.465942744323791
"United States","Kentucky","KY",2020-12-27,2021-01-02,7,2020,"53",4467673,1409,164,1024,385,1245,3.67081476195774,8.6174614838642,0.3759765625
"United States","Kentucky","KY",2021-01-03,2021-01-09,7,2021,"1",4467673,1292,178,1037,255,1114,3.98417699773462,5.70766929450745,0.245901639344262
"United States","Kentucky","KY",2021-01-10,2021-01-16,7,2021,"2",4467673,1408,216,1038,370,1192,4.83473163770043,8.28171623124611,0.35645472061657
"United States","Kentucky","KY",2021-01-17,2021-01-23,7,2021,"3",4467673,1328,294,1035,293,1034,6.58060695131448,6.55822393447327,0.283091787439613
"United States","Kentucky","KY",2021-01-24,2021-01-30,7,2021,"4",4467673,1265,328,1023,242,937,7.34162952391547,5.41669007557178,0.236559139784946
"United States","Kentucky","KY",2021-01-31,2021-02-06,7,2021,"5",4467673,1176,306,1023,153,870,6.84920315340894,3.42460157670447,0.149560117302053
"United States","Kentucky","KY",2021-02-07,2021-02-13,7,2021,"6",4467673,1173,252,1017,156,921,5.64052024398384,3.49175062722809,0.153392330383481
"United States","Kentucky","KY",2021-02-14,2021-02-20,7,2021,"7",4467673,1147,154,1017,130,993,3.44698459354568,2.90979218935674,0.127826941986234
"United States","Kentucky","KY",2021-02-21,2021-02-27,7,2021,"8",4467673,1119,199,1010,109,920,4.45422035139994,2.43974883569142,0.107920792079208
"United States","Kentucky","KY",2021-02-28,2021-03-06,7,2021,"9",4467673,1076,181,1005,71,895,4.05132604825823,1.5891941957256,0.0706467661691543
"United States","Kentucky","KY",2021-03-07,2021-03-13,7,2021,"10",4467673,1139,160,999,140,979,3.58128269459291,3.1336223577688,0.14014014014014
"United States","Kentucky","KY",2021-03-14,2021-03-20,7,2021,"11",4467673,1025,754,989,36,271,16.8767946982691,0.805788606283405,0.0364004044489383
"United States","Kentucky","KY",2021-03-21,2021-03-27,7,2021,"12",4467673,1036,290,977,59,746,6.49107488394965,1.32059799363114,0.060388945752303
"United States","Kentucky","KY",2021-03-28,2021-04-03,7,2021,"13",4467673,988,139,977,11,849,3.11123934092759,0.246213185253263,0.0112589559877174
"United States","Kentucky","KY",2021-04-04,2021-04-10,7,2021,"14",4467673,1063,92,967,96,971,2.05923754939092,2.14876961675575,0.0992761116856256
"United States","Kentucky","KY",2021-04-11,2021-04-17,7,2021,"15",4467673,1041,89,961,80,952,1.99208849886731,1.79064134729646,0.0832466181061395
"United States","Kentucky","KY",2021-04-18,2021-04-24,7,2021,"16",4467673,1037,106,956,81,931,2.3725997851678,1.81302436413766,0.0847280334728033
"United States","Kentucky","KY",2021-04-25,2021-05-01,7,2021,"17",4467673,1011,77,952,59,934,1.72349229677284,1.32059799363114,0.0619747899159664
"United States","Kentucky","KY",2021-05-02,2021-05-08,7,2021,"18",4467673,986,65,943,43,921,1.45489609467837,0.962469724171845,0.0455991516436904
"United States","Kentucky","KY",2021-05-09,2021-05-15,7,2021,"19",4467673,935,70,931,4,865,1.5668111788844,0.0895320673648228,0.00429645542427504
"United States","Kentucky","KY",2021-05-16,2021-05-22,7,2021,"20",4467673,1034,57,913,121,977,1.27583195994872,2.70834503778589,0.132530120481928
"United States","Kentucky","KY",2021-05-23,2021-05-29,7,2021,"21",4467673,1021,77,912,109,944,1.72349229677284,2.43974883569142,0.119517543859649
"United States","Kentucky","KY",2021-05-30,2021-06-05,7,2021,"22",4467673,933,309,917,16,624,6.91635220393256,0.358128269459291,0.0174482006543075
"United States","Kentucky","KY",2021-06-06,2021-06-12,7,2021,"23",4467673,911,64,916,-5,847,1.43251307783716,-0.111915084206028,-0.00545851528384278
"United States","Kentucky","KY",2021-06-13,2021-06-19,7,2021,"24",4467673,905,25,915,-10,880,0.559575421030143,-0.223830168412057,-0.0109289617486339
"United States","Kentucky","KY",2021-06-20,2021-06-26,7,2021,"25",4467673,754,24,919,-165,730,0.537192404188937,-3.69319777879894,-0.179542981501632
"United States","Louisiana","LA",2019-12-29,2020-01-04,7,2020,"1",4648794,927,0,992,-65,927,0,-1.39821209543809,-0.0655241935483871
"United States","Louisiana","LA",2020-01-05,2020-01-11,7,2020,"2",4648794,967,0,989,-22,967,0,-0.473241016917506,-0.0222446916076845
"United States","Louisiana","LA",2020-01-12,2020-01-18,7,2020,"3",4648794,960,0,987,-27,960,0,-0.580795793489666,-0.0273556231003039
"United States","Louisiana","LA",2020-01-19,2020-01-25,7,2020,"4",4648794,970,0,1000,-30,970,0,-0.645328659432963,-0.03
"United States","Louisiana","LA",2020-01-26,2020-02-01,7,2020,"5",4648794,977,0,990,-13,977,0,-0.279642419087617,-0.0131313131313131
"United States","Louisiana","LA",2020-02-02,2020-02-08,7,2020,"6",4648794,956,0,993,-37,956,0,-0.795905346633987,-0.0372608257804632
"United States","Louisiana","LA",2020-02-09,2020-02-15,7,2020,"7",4648794,951,0,976,-25,951,0,-0.537773882860802,-0.0256147540983607
"United States","Louisiana","LA",2020-02-16,2020-02-22,7,2020,"8",4648794,950,0,955,-5,950,0,-0.10755477657216,-0.00523560209424079
"United States","Louisiana","LA",2020-02-23,2020-02-29,7,2020,"9",4648794,993,0,937,56,993,0,1.2046134976082,0.0597652081109925
"United States","Louisiana","LA",2020-03-01,2020-03-07,7,2020,"10",4648794,964,0,929,35,964,0,0.752883436005123,0.0376749192680301
"United States","Louisiana","LA",2020-03-08,2020-03-14,7,2020,"11",4648794,994,1,935,59,993,0.0215109553144321,1.26914636355149,0.0631016042780748
"United States","Louisiana","LA",2020-03-15,2020-03-21,7,2020,"12",4648794,955,19,940,15,936,0.40870815097421,0.322664329716481,0.0159574468085106
"United States","Louisiana","LA",2020-03-22,2020-03-28,7,2020,"13",4648794,1233,117,935,298,1116,2.51678177178855,6.41026468370076,0.318716577540107
"United States","Louisiana","LA",2020-03-29,2020-04-04,7,2020,"14",4648794,1390,271,922,468,1119,5.8294688902111,10.0671270871542,0.507592190889371
"United States","Louisiana","LA",2020-04-05,2020-04-11,7,2020,"15",4648794,1529,395,923,606,1134,8.49682734920067,13.0356389205458,0.656554712892741
"United States","Louisiana","LA",2020-04-12,2020-04-18,7,2020,"16",4648794,1360,465,922,438,895,10.0025942212109,9.42179842772125,0.475054229934924
"United States","Louisiana","LA",2020-04-19,2020-04-25,7,2020,"17",4648794,1248,375,907,341,873,8.06660824291203,7.33523576222134,0.375964718853363
"United States","Louisiana","LA",2020-04-26,2020-05-02,7,2020,"18",4648794,1171,302,897,274,869,6.49630850495849,5.89400175615439,0.30546265328874
"United States","Louisiana","LA",2020-05-03,2020-05-09,7,2020,"19",4648794,1129,241,896,233,888,5.18414023077813,5.01205258826268,0.260044642857143
"United States","Louisiana","LA",2020-05-10,2020-05-16,7,2020,"20",4648794,1105,225,891,214,880,4.83996494574722,4.60334443728847,0.240179573512907
"United States","Louisiana","LA",2020-05-17,2020-05-23,7,2020,"21",4648794,1052,149,891,161,903,3.20513234185038,3.46326380562357,0.180695847362514
"United States","Louisiana","LA",2020-05-24,2020-05-30,7,2020,"22",4648794,1054,118,887,167,936,2.53829272710299,3.59232953751016,0.188275084554679
"United States","Louisiana","LA",2020-05-31,2020-06-06,7,2020,"23",4648794,1016,134,870,146,882,2.8824680121339,3.14059947590708,0.167816091954023
"United States","Louisiana","LA",2020-06-07,2020-06-13,7,2020,"24",4648794,951,78,856,95,873,1.6778545145257,2.04354075487105,0.110981308411215
"United States","Louisiana","LA",2020-06-14,2020-06-20,7,2020,"25",4648794,1004,99,859,145,905,2.12958457612878,3.11908852059265,0.168800931315483
"United States","Louisiana","LA",2020-06-21,2020-06-27,7,2020,"26",4648794,998,88,860,138,910,1.89296406767002,2.96851183339163,0.16046511627907
"United States","Louisiana","LA",2020-06-28,2020-07-04,7,2020,"27",4648794,985,92,851,134,893,1.97900788892775,2.8824680121339,0.157461809635723
"United States","Louisiana","LA",2020-07-05,2020-07-11,7,2020,"28",4648794,1061,126,852,209,935,2.71038036961844,4.49578966071631,0.245305164319249
"United States","Louisiana","LA",2020-07-12,2020-07-18,7,2020,"29",4648794,1152,104,849,303,1048,2.23713935270094,6.51781946027292,0.356890459363958
"United States","Louisiana","LA",2020-07-19,2020-07-25,7,2020,"30",4648794,1213,204,849,364,1009,4.38823488414415,7.82998773445328,0.428739693757362
"United States","Louisiana","LA",2020-07-26,2020-08-01,7,2020,"31",4648794,1205,232,849,356,973,4.99054163294824,7.65790009193782,0.419316843345112
"United States","Louisiana","LA",2020-08-02,2020-08-08,7,2020,"32",4648794,1243,254,860,383,989,5.46378264986575,8.23869588542749,0.445348837209302
"United States","Louisiana","LA",2020-08-09,2020-08-15,7,2020,"33",4648794,1181,218,855,326,963,4.6893882585462,7.01257143250486,0.381286549707602
"United States","Louisiana","LA",2020-08-16,2020-08-22,7,2020,"34",4648794,1132,239,847,285,893,5.14111832014927,6.13062226461314,0.336481700118064
"United States","Louisiana","LA",2020-08-23,2020-08-29,7,2020,"35",4648794,1098,195,847,251,903,4.19463628631426,5.39924978392245,0.296340023612751
"United States","Louisiana","LA",2020-08-30,2020-09-05,7,2020,"36",4648794,1110,131,863,247,979,2.8179351461906,5.31320596266473,0.286210892236385
"United States","Louisiana","LA",2020-09-06,2020-09-12,7,2020,"37",4648794,1027,160,859,168,867,3.44175285030913,3.61384049282459,0.19557625145518
"United States","Louisiana","LA",2020-09-13,2020-09-19,7,2020,"38",4648794,1040,140,856,184,900,3.01153374402049,3.9580157778555,0.214953271028037
"United States","Louisiana","LA",2020-09-20,2020-09-26,7,2020,"39",4648794,991,90,867,124,901,1.93598597829889,2.66735845898958,0.143021914648212
"United States","Louisiana","LA",2020-09-27,2020-10-03,7,2020,"40",4648794,1036,125,868,168,911,2.68886941430401,3.61384049282459,0.193548387096774
"United States","Louisiana","LA",2020-10-04,2020-10-10,7,2020,"41",4648794,1044,55,863,181,989,1.18310254229376,3.89348291191221,0.20973348783314
"United States","Louisiana","LA",2020-10-11,2020-10-17,7,2020,"42",4648794,991,85,867,124,906,1.82843120172673,2.66735845898958,0.143021914648212
"United States","Louisiana","LA",2020-10-18,2020-10-24,7,2020,"43",4648794,1008,87,878,130,921,1.87145311235559,2.79642419087617,0.148063781321184
"United States","Louisiana","LA",2020-10-25,2020-10-31,7,2020,"44",4648794,951,91,886,65,860,1.95749693361332,1.39821209543809,0.0733634311512414
"United States","Louisiana","LA",2020-11-01,2020-11-07,7,2020,"45",4648794,1052,82,899,153,970,1.76389833578343,3.29117616310811,0.170189098998888
"United States","Louisiana","LA",2020-11-08,2020-11-14,7,2020,"46",4648794,1056,98,903,153,958,2.10807362081434,3.29117616310811,0.169435215946844
"United States","Louisiana","LA",2020-11-15,2020-11-21,7,2020,"47",4648794,1068,348,923,145,720,7.48581244942237,3.11908852059265,0.157096424702059
"United States","Louisiana","LA",2020-11-22,2020-11-28,7,2020,"48",4648794,1084,174,927,157,910,3.74290622471118,3.37721998436584,0.169363538295577
"United States","Louisiana","LA",2020-11-29,2020-12-05,7,2020,"49",4648794,1103,139,927,176,964,2.99002278870606,3.78592813534005,0.189859762675297
"United States","Louisiana","LA",2020-12-06,2020-12-12,7,2020,"50",4648794,1238,220,939,299,1018,4.73241016917506,6.43177563901519,0.318423855165069
"United States","Louisiana","LA",2020-12-13,2020-12-19,7,2020,"51",4648794,1207,228,941,266,979,4.90449781169052,5.72191411363894,0.282678002125399
"United States","Louisiana","LA",2020-12-20,2020-12-26,7,2020,"52",4648794,1240,278,935,305,962,5.98004557741212,6.56084137090179,0.32620320855615
"United States","Louisiana","LA",2020-12-27,2021-01-02,7,2020,"53",4648794,1251,214,939,312,1037,4.60334443728847,6.71141805810281,0.332268370607029
"United States","Louisiana","LA",2021-01-03,2021-01-09,7,2021,"1",4648794,1393,347,950,443,1046,7.46430149410793,9.52935320429341,0.466315789473684
"United States","Louisiana","LA",2021-01-10,2021-01-16,7,2021,"2",4648794,1413,247,951,462,1166,5.31320596266473,9.93806135526762,0.485804416403786
"United States","Louisiana","LA",2021-01-17,2021-01-23,7,2021,"3",4648794,1368,403,956,412,965,8.66891499171613,8.86251358954602,0.430962343096234
"United States","Louisiana","LA",2021-01-24,2021-01-30,7,2021,"4",4648794,1252,318,959,293,934,6.8404837899894,6.3027099071286,0.305526590198123
"United States","Louisiana","LA",2021-01-31,2021-02-06,7,2021,"5",4648794,1201,275,948,253,926,5.91551271146882,5.44227169455132,0.266877637130802
"United States","Louisiana","LA",2021-02-07,2021-02-13,7,2021,"6",4648794,1167,200,934,233,967,4.30219106288642,5.01205258826268,0.249464668094219
"United States","Louisiana","LA",2021-02-14,2021-02-20,7,2021,"7",4648794,1167,165,913,254,1002,3.54930762688129,5.46378264986575,0.278203723986856
"United States","Louisiana","LA",2021-02-21,2021-02-27,7,2021,"8",4648794,1106,148,894,212,958,3.18362138653595,4.5603225266596,0.237136465324385
"United States","Louisiana","LA",2021-02-28,2021-03-06,7,2021,"9",4648794,1079,127,885,194,952,2.73189132493288,4.17312533099982,0.219209039548023
"United States","Louisiana","LA",2021-03-07,2021-03-13,7,2021,"10",4648794,1049,145,885,164,904,3.11908852059265,3.52779667156686,0.185310734463277
"United States","Louisiana","LA",2021-03-14,2021-03-20,7,2021,"11",4648794,1006,127,875,131,879,2.73189132493288,2.8179351461906,0.149714285714286
"United States","Louisiana","LA",2021-03-21,2021-03-27,7,2021,"12",4648794,1022,100,885,137,922,2.15109553144321,2.9470008780772,0.154802259887006
"United States","Louisiana","LA",2021-03-28,2021-04-03,7,2021,"13",4648794,982,75,881,101,907,1.61332164858241,2.17260648675764,0.114642451759364
"United States","Louisiana","LA",2021-04-04,2021-04-10,7,2021,"14",4648794,958,53,868,90,905,1.1400806316649,1.93598597829889,0.1036866359447
"United States","Louisiana","LA",2021-04-11,2021-04-17,7,2021,"15",4648794,968,66,870,98,902,1.41972305075252,2.10807362081434,0.112643678160919
"United States","Louisiana","LA",2021-04-18,2021-04-24,7,2021,"16",4648794,1000,54,863,137,946,1.16159158697933,2.9470008780772,0.158748551564311
"United States","Louisiana","LA",2021-04-25,2021-05-01,7,2021,"17",4648794,969,46,863,106,923,0.989503944463876,2.2801612633298,0.122827346465817
"United States","Louisiana","LA",2021-05-02,2021-05-08,7,2021,"18",4648794,898,51,871,27,847,1.09705872103604,0.580795793489666,0.0309988518943742
"United States","Louisiana","LA",2021-05-09,2021-05-15,7,2021,"19",4648794,900,45,861,39,855,0.967992989149444,0.838927257262851,0.0452961672473868
"United States","Louisiana","LA",2021-05-16,2021-05-22,7,2021,"20",4648794,891,44,867,24,847,0.946482033835012,0.51626292754637,0.027681660899654
"United States","Louisiana","LA",2021-05-23,2021-05-29,7,2021,"21",4648794,898,54,866,32,844,1.16159158697933,0.688350570061827,0.0369515011547343
"United States","Louisiana","LA",2021-05-30,2021-06-05,7,2021,"22",4648794,922,39,857,65,883,0.838927257262851,1.39821209543809,0.0758459743290549
"United States","Louisiana","LA",2021-06-06,2021-06-12,7,2021,"23",4648794,903,33,857,46,870,0.709861525376259,0.989503944463876,0.0536756126021003
"United States","Louisiana","LA",2021-06-13,2021-06-19,7,2021,"24",4648794,829,40,847,-18,789,0.860438212577283,-0.387197195659778,-0.0212514757969303
"United States","Louisiana","LA",2021-06-20,2021-06-26,7,2021,"25",4648794,685,35,841,-156,650,0.752883436005123,-3.35570902905141,-0.185493460166469
"United States","Maine","ME",2019-12-29,2020-01-04,7,2020,"1",1344212,320,0,296,24,320,0,1.78543265496811,0.0810810810810811
"United States","Maine","ME",2020-01-05,2020-01-11,7,2020,"2",1344212,318,0,298,20,318,0,1.48786054580676,0.0671140939597314
"United States","Maine","ME",2020-01-12,2020-01-18,7,2020,"3",1344212,295,0,302,-7,295,0,-0.520751191032367,-0.0231788079470199
"United States","Maine","ME",2020-01-19,2020-01-25,7,2020,"4",1344212,308,0,298,10,308,0,0.743930272903381,0.0335570469798658
"United States","Maine","ME",2020-01-26,2020-02-01,7,2020,"5",1344212,288,0,297,-9,288,0,-0.669537245613043,-0.0303030303030303
"United States","Maine","ME",2020-02-02,2020-02-08,7,2020,"6",1344212,316,0,295,21,316,0,1.5622535730971,0.0711864406779661
"United States","Maine","ME",2020-02-09,2020-02-15,7,2020,"7",1344212,329,0,290,39,329,0,2.90132806432319,0.13448275862069
"United States","Maine","ME",2020-02-16,2020-02-22,7,2020,"8",1344212,299,0,290,9,299,0,0.669537245613043,0.0310344827586206
"United States","Maine","ME",2020-02-23,2020-02-29,7,2020,"9",1344212,292,0,293,-1,292,0,-0.0743930272903381,-0.0034129692832765
"United States","Maine","ME",2020-03-01,2020-03-07,7,2020,"10",1344212,313,0,290,23,313,0,1.71103962767778,0.0793103448275863
"United States","Maine","ME",2020-03-08,2020-03-14,7,2020,"11",1344212,301,0,290,11,301,0,0.818323300193719,0.0379310344827586
"United States","Maine","ME",2020-03-15,2020-03-21,7,2020,"12",1344212,277,0,292,-15,277,0,-1.11589540935507,-0.0513698630136986
"United States","Maine","ME",2020-03-22,2020-03-28,7,2020,"13",1344212,279,1,301,-22,278,0.0743930272903381,-1.63664660038744,-0.0730897009966778
"United States","Maine","ME",2020-03-29,2020-04-04,7,2020,"14",1344212,300,9,297,3,291,0.669537245613043,0.223179081871014,0.0101010101010102
"United States","Maine","ME",2020-04-05,2020-04-11,7,2020,"15",1344212,304,9,294,10,295,0.669537245613043,0.743930272903381,0.0340136054421769
"United States","Maine","ME",2020-04-12,2020-04-18,7,2020,"16",1344212,310,13,291,19,297,0.967109354774396,1.41346751851642,0.0652920962199313
"United States","Maine","ME",2020-04-19,2020-04-25,7,2020,"17",1344212,285,18,286,-1,267,1.33907449122609,-0.0743930272903381,-0.00349650349650354
"United States","Maine","ME",2020-04-26,2020-05-02,7,2020,"18",1344212,277,6,275,2,271,0.446358163742029,0.148786054580676,0.00727272727272732
"United States","Maine","ME",2020-05-03,2020-05-09,7,2020,"19",1344212,293,8,277,16,285,0.595144218322705,1.19028843664541,0.0577617328519855
"United States","Maine","ME",2020-05-10,2020-05-16,7,2020,"20",1344212,256,6,275,-19,250,0.446358163742029,-1.41346751851642,-0.0690909090909091
"United States","Maine","ME",2020-05-17,2020-05-23,7,2020,"21",1344212,267,7,270,-3,260,0.520751191032367,-0.223179081871014,-0.0111111111111111
"United States","Maine","ME",2020-05-24,2020-05-30,7,2020,"22",1344212,302,12,269,33,290,0.892716327484057,2.45496990058116,0.122676579925651
"United States","Maine","ME",2020-05-31,2020-06-06,7,2020,"23",1344212,255,9,270,-15,246,0.669537245613043,-1.11589540935507,-0.0555555555555556
"United States","Maine","ME",2020-06-07,2020-06-13,7,2020,"24",1344212,254,2,270,-16,252,0.148786054580676,-1.19028843664541,-0.0592592592592592
"United States","Maine","ME",2020-06-14,2020-06-20,7,2020,"25",1344212,275,2,269,6,273,0.148786054580676,0.446358163742029,0.0223048327137547
"United States","Maine","ME",2020-06-21,2020-06-27,7,2020,"26",1344212,299,2,270,29,297,0.148786054580676,2.15739779141981,0.107407407407407
"United States","Maine","ME",2020-06-28,2020-07-04,7,2020,"27",1344212,280,5,272,8,275,0.371965136451691,0.595144218322705,0.0294117647058822
"United States","Maine","ME",2020-07-05,2020-07-11,7,2020,"28",1344212,289,5,274,15,284,0.371965136451691,1.11589540935507,0.0547445255474452
"United States","Maine","ME",2020-07-12,2020-07-18,7,2020,"29",1344212,294,3,268,26,291,0.223179081871014,1.93421870954879,0.0970149253731343
"United States","Maine","ME",2020-07-19,2020-07-25,7,2020,"30",1344212,282,2,269,13,280,0.148786054580676,0.967109354774396,0.0483271375464684
"United States","Maine","ME",2020-07-26,2020-08-01,7,2020,"31",1344212,283,4,275,8,279,0.297572109161353,0.595144218322705,0.0290909090909091
"United States","Maine","ME",2020-08-02,2020-08-08,7,2020,"32",1344212,276,2,276,0,274,0.148786054580676,0,0
"United States","Maine","ME",2020-08-09,2020-08-15,7,2020,"33",1344212,280,2,271,9,278,0.148786054580676,0.669537245613043,0.033210332103321
"United States","Maine","ME",2020-08-16,2020-08-22,7,2020,"34",1344212,312,3,274,38,309,0.223179081871014,2.82693503703285,0.138686131386861
"United States","Maine","ME",2020-08-23,2020-08-29,7,2020,"35",1344212,285,2,270,15,283,0.148786054580676,1.11589540935507,0.0555555555555556
"United States","Maine","ME",2020-08-30,2020-09-05,7,2020,"36",1344212,289,2,271,18,287,0.148786054580676,1.33907449122609,0.0664206642066421
"United States","Maine","ME",2020-09-06,2020-09-12,7,2020,"37",1344212,319,0,274,45,319,0,3.34768622806522,0.164233576642336
"United States","Maine","ME",2020-09-13,2020-09-19,7,2020,"38",1344212,299,5,281,18,294,0.371965136451691,1.33907449122609,0.0640569395017794
"United States","Maine","ME",2020-09-20,2020-09-26,7,2020,"39",1344212,309,1,284,25,308,0.0743930272903381,1.85982568225845,0.0880281690140845
"United States","Maine","ME",2020-09-27,2020-10-03,7,2020,"40",1344212,289,2,291,-2,287,0.148786054580676,-0.148786054580676,-0.00687285223367695
"United States","Maine","ME",2020-10-04,2020-10-10,7,2020,"41",1344212,302,1,290,12,301,0.0743930272903381,0.892716327484057,0.0413793103448277
"United States","Maine","ME",2020-10-11,2020-10-17,7,2020,"42",1344212,275,3,288,-13,272,0.223179081871014,-0.967109354774396,-0.0451388888888888
"United States","Maine","ME",2020-10-18,2020-10-24,7,2020,"43",1344212,275,0,288,-13,275,0,-0.967109354774396,-0.0451388888888888
"United States","Maine","ME",2020-10-25,2020-10-31,7,2020,"44",1344212,275,1,287,-12,274,0.0743930272903381,-0.892716327484057,-0.0418118466898955
"United States","Maine","ME",2020-11-01,2020-11-07,7,2020,"45",1344212,334,5,287,47,329,0.371965136451691,3.49647228264589,0.163763066202091
"United States","Maine","ME",2020-11-08,2020-11-14,7,2020,"46",1344212,323,11,289,34,312,0.818323300193719,2.5293629278715,0.117647058823529
"United States","Maine","ME",2020-11-15,2020-11-21,7,2020,"47",1344212,307,13,301,6,294,0.967109354774396,0.446358163742029,0.0199335548172757
"United States","Maine","ME",2020-11-22,2020-11-28,7,2020,"48",1344212,349,15,301,48,334,1.11589540935507,3.57086530993623,0.159468438538206
"United States","Maine","ME",2020-11-29,2020-12-05,7,2020,"49",1344212,342,35,303,39,307,2.60375595516183,2.90132806432319,0.128712871287129
"United States","Maine","ME",2020-12-06,2020-12-12,7,2020,"50",1344212,353,31,304,49,322,2.30618384600048,3.64525833722657,0.161184210526316
"United States","Maine","ME",2020-12-13,2020-12-19,7,2020,"51",1344212,324,35,303,21,289,2.60375595516183,1.5622535730971,0.0693069306930694
"United States","Maine","ME",2020-12-20,2020-12-26,7,2020,"52",1344212,347,27,302,45,320,2.00861173683913,3.34768622806522,0.149006622516556
"United States","Maine","ME",2020-12-27,2021-01-02,7,2020,"53",1344212,355,116,306,49,239,8.62959116567922,3.64525833722657,0.160130718954248
"United States","Maine","ME",2021-01-03,2021-01-09,7,2021,"1",1344212,345,42,307,38,303,3.1245071461942,2.82693503703285,0.123778501628665
"United States","Maine","ME",2021-01-10,2021-01-16,7,2021,"2",1344212,366,62,307,59,304,4.61236769200096,4.38918861012995,0.192182410423453
"United States","Maine","ME",2021-01-17,2021-01-23,7,2021,"3",1344212,339,52,307,32,287,3.86843741909758,2.38057687329082,0.104234527687296
"United States","Maine","ME",2021-01-24,2021-01-30,7,2021,"4",1344212,360,36,306,54,324,2.67814898245217,4.01722347367826,0.176470588235294
"United States","Maine","ME",2021-01-31,2021-02-06,7,2021,"5",1344212,305,8,305,0,297,0.595144218322705,0,0
"United States","Maine","ME",2021-02-07,2021-02-13,7,2021,"6",1344212,331,13,303,28,318,0.967109354774396,2.08300476412947,0.0924092409240924
"United States","Maine","ME",2021-02-14,2021-02-20,7,2021,"7",1344212,292,11,304,-12,281,0.818323300193719,-0.892716327484057,-0.0394736842105263
"United States","Maine","ME",2021-02-21,2021-02-27,7,2021,"8",1344212,283,44,303,-20,239,3.27329320077488,-1.48786054580676,-0.066006600660066
"United States","Maine","ME",2021-02-28,2021-03-06,7,2021,"9",1344212,331,4,309,22,327,0.297572109161353,1.63664660038744,0.0711974110032363
"United States","Maine","ME",2021-03-07,2021-03-13,7,2021,"10",1344212,287,17,308,-21,270,1.26468146393575,-1.5622535730971,-0.0681818181818182
"United States","Maine","ME",2021-03-14,2021-03-20,7,2021,"11",1344212,249,4,311,-62,245,0.297572109161353,-4.61236769200096,-0.19935691318328
"United States","Maine","ME",2021-03-21,2021-03-27,7,2021,"12",1344212,269,8,309,-40,261,0.595144218322705,-2.97572109161353,-0.129449838187702
"United States","Maine","ME",2021-03-28,2021-04-03,7,2021,"13",1344212,313,9,312,1,304,0.669537245613043,0.0743930272903381,0.00320512820512819
"United States","Maine","ME",2021-04-04,2021-04-10,7,2021,"14",1344212,290,5,307,-17,285,0.371965136451691,-1.26468146393575,-0.0553745928338762
"United States","Maine","ME",2021-04-11,2021-04-17,7,2021,"15",1344212,311,14,304,7,297,1.04150238206473,0.520751191032367,0.0230263157894737
"United States","Maine","ME",2021-04-18,2021-04-24,7,2021,"16",1344212,295,8,298,-3,287,0.595144218322705,-0.223179081871014,-0.0100671140939598
"United States","Maine","ME",2021-04-25,2021-05-01,7,2021,"17",1344212,306,17,288,18,289,1.26468146393575,1.33907449122609,0.0625
"United States","Maine","ME",2021-05-02,2021-05-08,7,2021,"18",1344212,299,6,285,14,293,0.446358163742029,1.04150238206473,0.0491228070175438
"United States","Maine","ME",2021-05-09,2021-05-15,7,2021,"19",1344212,297,6,284,13,291,0.446358163742029,0.967109354774396,0.045774647887324
"United States","Maine","ME",2021-05-16,2021-05-22,7,2021,"20",1344212,340,18,277,63,322,1.33907449122609,4.6867607192913,0.227436823104693
"United States","Maine","ME",2021-05-23,2021-05-29,7,2021,"21",1344212,317,6,275,42,311,0.446358163742029,3.1245071461942,0.152727272727273
"United States","Maine","ME",2021-05-30,2021-06-05,7,2021,"22",1344212,299,14,277,22,285,1.04150238206473,1.63664660038744,0.0794223826714802
"United States","Maine","ME",2021-06-06,2021-06-12,7,2021,"23",1344212,324,6,277,47,318,0.446358163742029,3.49647228264589,0.169675090252708
"United States","Maine","ME",2021-06-13,2021-06-19,7,2021,"24",1344212,300,9,278,22,291,0.669537245613043,1.63664660038744,0.079136690647482
"United States","Maine","ME",2021-06-20,2021-06-26,7,2021,"25",1344212,310,4,277,33,306,0.297572109161353,2.45496990058116,0.11913357400722
"United States","Maryland","MD",2019-12-29,2020-01-04,7,2020,"1",6045680,1049,0,1084,-35,1049,0,-0.578925778407061,-0.0322878228782287
"United States","Maryland","MD",2020-01-05,2020-01-11,7,2020,"2",6045680,1035,0,1080,-45,1035,0,-0.744333143666221,-0.0416666666666666
"United States","Maryland","MD",2020-01-12,2020-01-18,7,2020,"3",6045680,988,0,1085,-97,988,0,-1.60445144301385,-0.0894009216589862
"United States","Maryland","MD",2020-01-19,2020-01-25,7,2020,"4",6045680,1003,0,1081,-78,1003,0,-1.29017744902145,-0.0721554116558741
"United States","Maryland","MD",2020-01-26,2020-02-01,7,2020,"5",6045680,1034,0,1081,-47,1034,0,-0.777414616718053,-0.0434782608695652
"United States","Maryland","MD",2020-02-02,2020-02-08,7,2020,"6",6045680,1004,0,1071,-67,1004,0,-1.10822934723637,-0.0625583566760037
"United States","Maryland","MD",2020-02-09,2020-02-15,7,2020,"7",6045680,1019,0,1062,-43,1019,0,-0.711251670614389,-0.0404896421845574
"United States","Maryland","MD",2020-02-16,2020-02-22,7,2020,"8",6045680,973,0,1053,-80,973,0,-1.32325892207328,-0.0759734093067427
"United States","Maryland","MD",2020-02-23,2020-02-29,7,2020,"9",6045680,1082,0,1039,43,1082,0,0.711251670614389,0.0413859480269489
"United States","Maryland","MD",2020-03-01,2020-03-07,7,2020,"10",6045680,1049,0,1020,29,1049,0,0.479681359251565,0.0284313725490195
"United States","Maryland","MD",2020-03-08,2020-03-14,7,2020,"11",6045680,1005,0,999,6,1005,0,0.0992444191554961,0.00600600600600609
"United States","Maryland","MD",2020-03-15,2020-03-21,7,2020,"12",6045680,1064,3,989,75,1061,0.0496222095777481,1.2405552394437,0.0758341759352881
"United States","Maryland","MD",2020-03-22,2020-03-28,7,2020,"13",6045680,1092,7,987,105,1085,0.115785155681412,1.73677733522118,0.106382978723404
"United States","Maryland","MD",2020-03-29,2020-04-04,7,2020,"14",6045680,1191,43,977,214,1148,0.711251670614389,3.53971761654603,0.219037871033777
"United States","Maryland","MD",2020-04-05,2020-04-11,7,2020,"15",6045680,1353,149,978,375,1204,2.46456974236149,6.20277619721851,0.383435582822086
"United States","Maryland","MD",2020-04-12,2020-04-18,7,2020,"16",6045680,1357,172,965,392,1185,2.84500668245756,6.48396871815908,0.406217616580311
"United States","Maryland","MD",2020-04-19,2020-04-25,7,2020,"17",6045680,1538,321,954,584,1217,5.30957642481904,9.65979013113496,0.612159329140461
"United States","Maryland","MD",2020-04-26,2020-05-02,7,2020,"18",6045680,1523,397,934,589,1126,6.56667240078866,9.74249381376454,0.630620985010707
"United States","Maryland","MD",2020-05-03,2020-05-09,7,2020,"19",6045680,1445,337,926,519,1108,5.5742282092337,8.58464225695042,0.560475161987041
"United States","Maryland","MD",2020-05-10,2020-05-16,7,2020,"20",6045680,1431,343,924,507,1088,5.6734726283892,8.38615341863943,0.548701298701299
"United States","Maryland","MD",2020-05-17,2020-05-23,7,2020,"21",6045680,1336,315,924,412,1021,5.21033200566355,6.8147834486774,0.445887445887446
"United States","Maryland","MD",2020-05-24,2020-05-30,7,2020,"22",6045680,1265,320,917,348,945,5.29303568829313,5.75617631101878,0.379498364231189
"United States","Maryland","MD",2020-05-31,2020-06-06,7,2020,"23",6045680,1167,361,926,241,806,5.97120588585569,3.98631750274576,0.260259179265659
"United States","Maryland","MD",2020-06-07,2020-06-13,7,2020,"24",6045680,1158,184,927,231,974,3.04349552076855,3.8209101374866,0.249190938511327
"United States","Maryland","MD",2020-06-14,2020-06-20,7,2020,"25",6045680,1070,141,929,141,929,2.33224385015416,2.33224385015416,0.151776103336921
"United States","Maryland","MD",2020-06-21,2020-06-27,7,2020,"26",6045680,1031,108,928,103,923,1.78639954479893,1.70369586216935,0.110991379310345
"United States","Maryland","MD",2020-06-28,2020-07-04,7,2020,"27",6045680,1051,79,934,117,972,1.30671818554737,1.93526617353218,0.125267665952891
"United States","Maryland","MD",2020-07-05,2020-07-11,7,2020,"28",6045680,1031,79,927,104,952,1.30671818554737,1.72023659869527,0.112189859762675
"United States","Maryland","MD",2020-07-12,2020-07-18,7,2020,"29",6045680,1026,69,922,104,957,1.14131082028821,1.72023659869527,0.112798264642082
"United States","Maryland","MD",2020-07-19,2020-07-25,7,2020,"30",6045680,1002,63,912,90,939,1.04206640113271,1.48866628733244,0.0986842105263157
"United States","Maryland","MD",2020-07-26,2020-08-01,7,2020,"31",6045680,1067,66,906,161,1001,1.09168861071046,2.66305858067248,0.177704194260486
"United States","Maryland","MD",2020-08-02,2020-08-08,7,2020,"32",6045680,1007,69,897,110,938,1.14131082028821,1.81948101785076,0.12263099219621
"United States","Maryland","MD",2020-08-09,2020-08-15,7,2020,"33",6045680,1064,65,914,150,999,1.07514787418454,2.4811104788874,0.164113785557987
"United States","Maryland","MD",2020-08-16,2020-08-22,7,2020,"34",6045680,1002,48,910,92,954,0.793955353243969,1.52174776038427,0.101098901098901
"United States","Maryland","MD",2020-08-23,2020-08-29,7,2020,"35",6045680,1040,62,914,126,978,1.02552566460679,2.08413280226542,0.137855579868709
"United States","Maryland","MD",2020-08-30,2020-09-05,7,2020,"36",6045680,1046,53,918,128,993,0.876659035873549,2.11721427531725,0.139433551198257
"United States","Maryland","MD",2020-09-06,2020-09-12,7,2020,"37",6045680,996,38,908,88,958,0.628547987984809,1.45558481428061,0.0969162995594715
"United States","Maryland","MD",2020-09-13,2020-09-19,7,2020,"38",6045680,991,40,911,80,951,0.661629461036641,1.32325892207328,0.0878155872667399
"United States","Maryland","MD",2020-09-20,2020-09-26,7,2020,"39",6045680,1071,49,924,147,1022,0.810496089769885,2.43148826930966,0.159090909090909
"United States","Maryland","MD",2020-09-27,2020-10-03,7,2020,"40",6045680,1074,31,934,140,1043,0.512762832303397,2.31570311362824,0.149892933618844
"United States","Maryland","MD",2020-10-04,2020-10-10,7,2020,"41",6045680,1086,34,941,145,1052,0.562385041881145,2.39840679625782,0.154091392136025
"United States","Maryland","MD",2020-10-11,2020-10-17,7,2020,"42",6045680,1052,49,965,87,1003,0.810496089769885,1.43904407775469,0.0901554404145077
"United States","Maryland","MD",2020-10-18,2020-10-24,7,2020,"43",6045680,1101,45,957,144,1056,0.744333143666221,2.38186605973191,0.150470219435737
"United States","Maryland","MD",2020-10-25,2020-10-31,7,2020,"44",6045680,1071,58,969,102,1013,0.959362718503129,1.68715512564343,0.105263157894737
"United States","Maryland","MD",2020-11-01,2020-11-07,7,2020,"45",6045680,1088,56,976,112,1032,0.926281245451298,1.8525624909026,0.114754098360656
"United States","Maryland","MD",2020-11-08,2020-11-14,7,2020,"46",6045680,1106,80,985,121,1026,1.32325892207328,2.00142911963584,0.122842639593909
"United States","Maryland","MD",2020-11-15,2020-11-21,7,2020,"47",6045680,1224,130,988,236,1094,2.15029574836908,3.90361382011618,0.238866396761134
"United States","Maryland","MD",2020-11-22,2020-11-28,7,2020,"48",6045680,1185,161,1001,184,1024,2.66305858067248,3.04349552076855,0.183816183816184
"United States","Maryland","MD",2020-11-29,2020-12-05,7,2020,"49",6045680,1258,221,998,260,1037,3.65550277222744,4.30059149673817,0.260521042084168
"United States","Maryland","MD",2020-12-06,2020-12-12,7,2020,"50",6045680,1378,276,1024,354,1102,4.56524328115282,5.85542073017427,0.345703125
"United States","Maryland","MD",2020-12-13,2020-12-19,7,2020,"51",6045680,1432,305,1033,399,1127,5.04492464040439,6.59975387384049,0.386253630203291
"United States","Maryland","MD",2020-12-20,2020-12-26,7,2020,"52",6045680,1337,280,1046,291,1057,4.63140622725649,4.81335432904156,0.278202676864245
"United States","Maryland","MD",2020-12-27,2021-01-02,7,2020,"53",6045680,1477,275,1058,419,1202,4.54870254462691,6.93056860435882,0.396030245746692
"United States","Maryland","MD",2021-01-03,2021-01-09,7,2021,"1",6045680,1364,287,1063,301,1077,4.7471913829379,4.97876169430072,0.283160865475071
"United States","Maryland","MD",2021-01-10,2021-01-16,7,2021,"2",6045680,1435,271,1073,362,1164,4.48253959852324,5.9877466223816,0.337371854613234
"United States","Maryland","MD",2021-01-17,2021-01-23,7,2021,"3",6045680,1374,309,1071,303,1065,5.11108758650805,5.01184316735256,0.282913165266107
"United States","Maryland","MD",2021-01-24,2021-01-30,7,2021,"4",6045680,1330,286,1065,265,1044,4.73065064641198,4.38329517936775,0.248826291079812
"United States","Maryland","MD",2021-01-31,2021-02-06,7,2021,"5",6045680,1281,147,1068,213,1134,2.43148826930966,3.52317688002011,0.199438202247191
"United States","Maryland","MD",2021-02-07,2021-02-13,7,2021,"6",6045680,1304,202,1069,235,1102,3.34122877823504,3.88707308359027,0.219831618334893
"United States","Maryland","MD",2021-02-14,2021-02-20,7,2021,"7",6045680,1177,159,1058,119,1018,2.62997710762065,1.96834764658401,0.112476370510397
"United States","Maryland","MD",2021-02-21,2021-02-27,7,2021,"8",6045680,1182,164,1051,131,1018,2.71268079025023,2.166836484895,0.124643196955281
"United States","Maryland","MD",2021-02-28,2021-03-06,7,2021,"9",6045680,1152,86,1050,102,1066,1.42250334122878,1.68715512564343,0.0971428571428572
"United States","Maryland","MD",2021-03-07,2021-03-13,7,2021,"10",6045680,1099,102,1046,53,997,1.68715512564343,0.876659035873549,0.0506692160611855
"United States","Maryland","MD",2021-03-14,2021-03-20,7,2021,"11",6045680,1150,122,1033,117,1028,2.01796985616176,1.93526617353218,0.113262342691191
"United States","Maryland","MD",2021-03-21,2021-03-27,7,2021,"12",6045680,1120,81,1026,94,1039,1.3397996585992,1.55482923343611,0.0916179337231968
"United States","Maryland","MD",2021-03-28,2021-04-03,7,2021,"13",6045680,1068,81,1022,46,987,1.3397996585992,0.760873880192137,0.0450097847358122
"United States","Maryland","MD",2021-04-04,2021-04-10,7,2021,"14",6045680,1165,103,1006,159,1062,1.70369586216935,2.62997710762065,0.158051689860835
"United States","Maryland","MD",2021-04-11,2021-04-17,7,2021,"15",6045680,1041,101,1001,40,940,1.67061438911752,0.661629461036641,0.0399600399600399
"United States","Maryland","MD",2021-04-18,2021-04-24,7,2021,"16",6045680,1109,109,978,131,1000,1.80294028132485,2.166836484895,0.133946830265849
"United States","Maryland","MD",2021-04-25,2021-05-01,7,2021,"17",6045680,1088,97,972,116,991,1.60445144301385,1.91872543700626,0.119341563786008
"United States","Maryland","MD",2021-05-02,2021-05-08,7,2021,"18",6045680,1020,110,954,66,910,1.81948101785076,1.09168861071046,0.0691823899371069
"United States","Maryland","MD",2021-05-09,2021-05-15,7,2021,"19",6045680,1055,71,944,111,984,1.17439229334004,1.83602175437668,0.117584745762712
"United States","Maryland","MD",2021-05-16,2021-05-22,7,2021,"20",6045680,1010,80,928,82,930,1.32325892207328,1.35634039512511,0.0883620689655173
"United States","Maryland","MD",2021-05-23,2021-05-29,7,2021,"21",6045680,1026,612,939,87,414,10.1229307538606,1.43904407775469,0.0926517571884984
"United States","Maryland","MD",2021-05-30,2021-06-05,7,2021,"22",6045680,1004,41,940,64,963,0.678170197562557,1.05860713765863,0.0680851063829788
"United States","Maryland","MD",2021-06-06,2021-06-12,7,2021,"23",6045680,889,48,944,-55,841,0.793955353243969,-0.909740508925381,-0.0582627118644068
"United States","Maryland","MD",2021-06-13,2021-06-19,7,2021,"24",6045680,951,33,947,4,918,0.545844305355229,0.0661629461036641,0.00422386483632531
"United States","Maryland","MD",2021-06-20,2021-06-26,7,2021,"25",6045680,801,30,951,-150,771,0.496222095777481,-2.4811104788874,-0.157728706624606
"United States","Massachusetts","MA",2019-12-29,2020-01-04,7,2020,"1",6949503,1242,0,1356,-114,1242,0,-1.64040507644935,-0.084070796460177
"United States","Massachusetts","MA",2020-01-05,2020-01-11,7,2020,"2",6949503,1266,0,1358,-92,1266,0,-1.32383567573106,-0.0677466863033873
"United States","Massachusetts","MA",2020-01-12,2020-01-18,7,2020,"3",6949503,1189,0,1369,-180,1189,0,-2.59011327860424,-0.131482834185537
"United States","Massachusetts","MA",2020-01-19,2020-01-25,7,2020,"4",6949503,1302,0,1349,-47,1302,0,-0.676307356079996,-0.0348406226834692
"United States","Massachusetts","MA",2020-01-26,2020-02-01,7,2020,"5",6949503,1205,0,1320,-115,1205,0,-1.65479459466382,-0.0871212121212122
"United States","Massachusetts","MA",2020-02-02,2020-02-08,7,2020,"6",6949503,1233,0,1297,-64,1233,0,-0.920929165725952,-0.0493446414803392
"United States","Massachusetts","MA",2020-02-09,2020-02-15,7,2020,"7",6949503,1251,0,1281,-30,1251,0,-0.43168554643404,-0.0234192037470726
"United States","Massachusetts","MA",2020-02-16,2020-02-22,7,2020,"8",6949503,1166,0,1267,-101,1166,0,-1.45334133966127,-0.079715864246251
"United States","Massachusetts","MA",2020-02-23,2020-02-29,7,2020,"9",6949503,1278,0,1240,38,1278,0,0.546801692149784,0.0306451612903227
"United States","Massachusetts","MA",2020-03-01,2020-03-07,7,2020,"10",6949503,1216,0,1235,-19,1216,0,-0.273400846074892,-0.0153846153846153
"United States","Massachusetts","MA",2020-03-08,2020-03-14,7,2020,"11",6949503,1311,0,1229,82,1311,0,1.17994049358638,0.0667209113100082
"United States","Massachusetts","MA",2020-03-15,2020-03-21,7,2020,"12",6949503,1170,2,1225,-55,1168,0.028779036428936,-0.79142350179574,-0.0448979591836735
"United States","Massachusetts","MA",2020-03-22,2020-03-28,7,2020,"13",6949503,1290,42,1220,70,1248,0.604359765007656,1.00726627501276,0.0573770491803278
"United States","Massachusetts","MA",2020-03-29,2020-04-04,7,2020,"14",6949503,1549,172,1218,331,1377,2.4749971328885,4.76293052898891,0.27175697865353
"United States","Massachusetts","MA",2020-04-05,2020-04-11,7,2020,"15",6949503,2038,470,1200,838,1568,6.76307356079996,12.0584162637242,0.698333333333333
"United States","Massachusetts","MA",2020-04-12,2020-04-18,7,2020,"16",6949503,2494,874,1196,1298,1620,12.576438919445,18.6775946423795,1.08528428093645
"United States","Massachusetts","MA",2020-04-19,2020-04-25,7,2020,"17",6949503,2535,1170,1183,1352,1365,16.8357363109276,19.4546286259607,1.14285714285714
"United States","Massachusetts","MA",2020-04-26,2020-05-02,7,2020,"18",6949503,2310,1116,1170,1140,1194,16.0587023273463,16.4040507644935,0.974358974358974
"United States","Massachusetts","MA",2020-05-03,2020-05-09,7,2020,"19",6949503,2071,994,1146,925,1077,14.3031811051812,13.3103043483829,0.807155322862129
"United States","Massachusetts","MA",2020-05-10,2020-05-16,7,2020,"20",6949503,1886,865,1148,738,1021,12.4469332555148,10.6194644422774,0.642857142857143
"United States","Massachusetts","MA",2020-05-17,2020-05-23,7,2020,"21",6949503,1578,599,1136,442,979,8.61932141046633,6.36016705079486,0.389084507042254
"United States","Massachusetts","MA",2020-05-24,2020-05-30,7,2020,"22",6949503,1360,464,1117,243,896,6.67673645151315,3.49665292611572,0.217547000895255
"United States","Massachusetts","MA",2020-05-31,2020-06-06,7,2020,"23",6949503,1236,521,1114,122,715,7.49693898973783,1.7555212221651,0.10951526032316
"United States","Massachusetts","MA",2020-06-07,2020-06-13,7,2020,"24",6949503,1140,287,1106,34,853,4.12979172755232,0.489243619291912,0.030741410488246
"United States","Massachusetts","MA",2020-06-14,2020-06-20,7,2020,"25",6949503,1129,251,1111,18,878,3.61176907183147,0.259011327860424,0.0162016201620161
"United States","Massachusetts","MA",2020-06-21,2020-06-27,7,2020,"26",6949503,1084,214,1102,-18,870,3.07935689789615,-0.259011327860424,-0.0163339382940109
"United States","Massachusetts","MA",2020-06-28,2020-07-04,7,2020,"27",6949503,1048,130,1101,-53,918,1.87063736788084,-0.762644465366804,-0.0481380563124433
"United States","Massachusetts","MA",2020-07-05,2020-07-11,7,2020,"28",6949503,1047,139,1094,-47,908,2.00014303181105,-0.676307356079996,-0.0429616087751371
"United States","Massachusetts","MA",2020-07-12,2020-07-18,7,2020,"29",6949503,1060,109,1089,-29,951,1.56845748537701,-0.417296028219572,-0.0266299357208448
"United States","Massachusetts","MA",2020-07-19,2020-07-25,7,2020,"30",6949503,1089,91,1083,6,998,1.30944615751659,0.086337109286808,0.0055401662049861
"United States","Massachusetts","MA",2020-07-26,2020-08-01,7,2020,"31",6949503,1022,116,1075,-53,906,1.66918411287829,-0.762644465366804,-0.0493023255813954
"United States","Massachusetts","MA",2020-08-02,2020-08-08,7,2020,"32",6949503,996,95,1077,-81,901,1.36700423037446,-1.16555097537191,-0.075208913649025
"United States","Massachusetts","MA",2020-08-09,2020-08-15,7,2020,"33",6949503,1049,99,1077,-28,950,1.42456230323233,-0.402906510005104,-0.0259981429897864
"United States","Massachusetts","MA",2020-08-16,2020-08-22,7,2020,"34",6949503,1037,101,1076,-39,936,1.45334133966127,-0.561191210364252,-0.0362453531598513
"United States","Massachusetts","MA",2020-08-23,2020-08-29,7,2020,"35",6949503,1059,115,1077,-18,944,1.65479459466382,-0.259011327860424,-0.0167130919220055
"United States","Massachusetts","MA",2020-08-30,2020-09-05,7,2020,"36",6949503,1014,80,1073,-59,934,1.15116145715744,-0.848981574653612,-0.0549860205032618
"United States","Massachusetts","MA",2020-09-06,2020-09-12,7,2020,"37",6949503,1012,80,1063,-51,932,1.15116145715744,-0.733865428937868,-0.0479774223894638
"United States","Massachusetts","MA",2020-09-13,2020-09-19,7,2020,"38",6949503,1094,99,1073,21,995,1.42456230323233,0.302179882503828,0.0195712954333644
"United States","Massachusetts","MA",2020-09-20,2020-09-26,7,2020,"39",6949503,1125,96,1080,45,1029,1.38139374858893,0.64752831965106,0.0416666666666667
"United States","Massachusetts","MA",2020-09-27,2020-10-03,7,2020,"40",6949503,1105,116,1086,19,989,1.66918411287829,0.273400846074892,0.0174953959484345
"United States","Massachusetts","MA",2020-10-04,2020-10-10,7,2020,"41",6949503,1101,80,1093,8,1021,1.15116145715744,0.115116145715744,0.00731930466605668
"United States","Massachusetts","MA",2020-10-11,2020-10-17,7,2020,"42",6949503,1131,136,1107,24,995,1.95697447716765,0.345348437147232,0.0216802168021679
"United States","Massachusetts","MA",2020-10-18,2020-10-24,7,2020,"43",6949503,1196,116,1120,76,1080,1.66918411287829,1.09360338429957,0.0678571428571428
"United States","Massachusetts","MA",2020-10-25,2020-10-31,7,2020,"44",6949503,1089,152,1133,-44,937,2.18720676859914,-0.633138801436592,-0.0388349514563107
"United States","Massachusetts","MA",2020-11-01,2020-11-07,7,2020,"45",6949503,1218,134,1146,72,1084,1.92819544073871,1.0360453114417,0.0628272251308901
"United States","Massachusetts","MA",2020-11-08,2020-11-14,7,2020,"46",6949503,1234,168,1139,95,1066,2.41743906003062,1.36700423037446,0.0834064969271291
"United States","Massachusetts","MA",2020-11-15,2020-11-21,7,2020,"47",6949503,1214,195,1153,61,1019,2.80595605182126,0.877760611082548,0.0529054640069384
"United States","Massachusetts","MA",2020-11-22,2020-11-28,7,2020,"48",6949503,1261,188,1138,123,1073,2.70522942431998,1.76991074037956,0.108084358523726
"United States","Massachusetts","MA",2020-11-29,2020-12-05,7,2020,"49",6949503,1331,277,1152,179,1054,3.98589654540764,2.57572376038977,0.155381944444444
"United States","Massachusetts","MA",2020-12-06,2020-12-12,7,2020,"50",6949503,1351,354,1173,178,997,5.09388944792167,2.5613342421753,0.151747655583973
"United States","Massachusetts","MA",2020-12-13,2020-12-19,7,2020,"51",6949503,1426,350,1194,232,1076,5.0363313750638,3.33836822575658,0.194304857621441
"United States","Massachusetts","MA",2020-12-20,2020-12-26,7,2020,"52",6949503,1552,60,1188,364,1492,0.86337109286808,5.23778463006635,0.306397306397306
"United States","Massachusetts","MA",2020-12-27,2021-01-02,7,2020,"53",6949503,1526,785,1228,298,741,11.2957717983574,4.28807642791146,0.242671009771987
"United States","Massachusetts","MA",2021-01-03,2021-01-09,7,2021,"1",6949503,1556,572,1250,306,984,8.2308044186757,4.40319257362721,0.2448
"United States","Massachusetts","MA",2021-01-10,2021-01-16,7,2021,"2",6949503,1569,509,1254,315,1060,7.32426477116421,4.53269823755742,0.251196172248804
"United States","Massachusetts","MA",2021-01-17,2021-01-23,7,2021,"3",6949503,1534,481,1267,267,1053,6.92135826115911,3.84200136326296,0.210734017363852
"United States","Massachusetts","MA",2021-01-24,2021-01-30,7,2021,"4",6949503,1578,467,1259,319,1111,6.71990500615656,4.59025631041529,0.253375694996029
"United States","Massachusetts","MA",2021-01-31,2021-02-06,7,2021,"5",6949503,1512,390,1250,262,1122,5.61191210364252,3.77005377219062,0.2096
"United States","Massachusetts","MA",2021-02-07,2021-02-13,7,2021,"6",6949503,1372,503,1246,126,869,7.2379276618774,1.81307929502297,0.101123595505618
"United States","Massachusetts","MA",2021-02-14,2021-02-20,7,2021,"7",6949503,1351,355,1238,113,996,5.10827896613614,1.62601555823488,0.0912762520193862
"United States","Massachusetts","MA",2021-02-21,2021-02-27,7,2021,"8",6949503,1273,288,1227,46,985,4.14418124576678,0.661917837865528,0.0374898125509373
"United States","Massachusetts","MA",2021-02-28,2021-03-06,7,2021,"9",6949503,1226,307,1200,26,919,4.41758209184168,0.374127473576168,0.0216666666666667
"United States","Massachusetts","MA",2021-03-07,2021-03-13,7,2021,"10",6949503,1217,206,1188,29,1011,2.96424075218041,0.417296028219572,0.0244107744107744
"United States","Massachusetts","MA",2021-03-14,2021-03-20,7,2021,"11",6949503,1207,252,1181,26,955,3.62615859004594,0.374127473576168,0.0220152413209145
"United States","Massachusetts","MA",2021-03-21,2021-03-27,7,2021,"12",6949503,1152,219,1176,-24,933,3.15130448896849,-0.345348437147232,-0.0204081632653061
"United States","Massachusetts","MA",2021-03-28,2021-04-03,7,2021,"13",6949503,1125,230,1176,-51,895,3.30958918932764,-0.733865428937868,-0.0433673469387755
"United States","Massachusetts","MA",2021-04-04,2021-04-10,7,2021,"14",6949503,1121,98,1176,-55,1023,1.41017278501786,-0.79142350179574,-0.0467687074829932
"United States","Massachusetts","MA",2021-04-11,2021-04-17,7,2021,"15",6949503,1145,76,1158,-13,1069,1.09360338429957,-0.187063736788084,-0.0112262521588946
"United States","Massachusetts","MA",2021-04-18,2021-04-24,7,2021,"16",6949503,1104,89,1146,-42,1015,1.28066712108765,-0.604359765007656,-0.0366492146596858
"United States","Massachusetts","MA",2021-04-25,2021-05-01,7,2021,"17",6949503,1122,73,1125,-3,1049,1.05043482965616,-0.043168554643404,-0.00266666666666671
"United States","Massachusetts","MA",2021-05-02,2021-05-08,7,2021,"18",6949503,1148,59,1108,40,1089,0.848981574653612,0.57558072857872,0.036101083032491
"United States","Massachusetts","MA",2021-05-09,2021-05-15,7,2021,"19",6949503,1113,66,1101,12,1047,0.949708202154888,0.172674218573616,0.0108991825613078
"United States","Massachusetts","MA",2021-05-16,2021-05-22,7,2021,"20",6949503,1170,76,1098,72,1094,1.09360338429957,1.0360453114417,0.0655737704918034
"United States","Massachusetts","MA",2021-05-23,2021-05-29,7,2021,"21",6949503,1080,50,1088,-8,1030,0.7194759107234,-0.115116145715744,-0.00735294117647056
"United States","Massachusetts","MA",2021-05-30,2021-06-05,7,2021,"22",6949503,1075,39,1089,-14,1036,0.561191210364252,-0.201453255002552,-0.0128558310376492
"United States","Massachusetts","MA",2021-06-06,2021-06-12,7,2021,"23",6949503,1053,30,1089,-36,1023,0.43168554643404,-0.518022655720848,-0.0330578512396694
"United States","Massachusetts","MA",2021-06-13,2021-06-19,7,2021,"24",6949503,970,23,1092,-122,947,0.330958918932764,-1.7555212221651,-0.111721611721612
"United States","Massachusetts","MA",2021-06-20,2021-06-26,7,2021,"25",6949503,912,25,1088,-176,887,0.3597379553617,-2.53255520574637,-0.161764705882353
"United States","Michigan","MI",2019-12-29,2020-01-04,7,2020,"1",9986857,2015,0,2100,-85,2015,0,-0.851118625209112,-0.0404761904761904
"United States","Michigan","MI",2020-01-05,2020-01-11,7,2020,"2",9986857,2065,0,2120,-55,2065,0,-0.550723816311779,-0.0259433962264151
"United States","Michigan","MI",2020-01-12,2020-01-18,7,2020,"3",9986857,1937,0,2118,-181,1937,0,-1.81238201368058,-0.0854579792256847
"United States","Michigan","MI",2020-01-19,2020-01-25,7,2020,"4",9986857,2012,0,2102,-90,2012,0,-0.901184426692001,-0.0428163653663178
"United States","Michigan","MI",2020-01-26,2020-02-01,7,2020,"5",9986857,2004,0,2087,-83,2004,0,-0.831092304615957,-0.0397700047915669
"United States","Michigan","MI",2020-02-02,2020-02-08,7,2020,"6",9986857,1940,0,2071,-131,1940,0,-1.31172399885169,-0.0632544664413327
"United States","Michigan","MI",2020-02-09,2020-02-15,7,2020,"7",9986857,2013,0,2055,-42,2013,0,-0.420552732456267,-0.0204379562043796
"United States","Michigan","MI",2020-02-16,2020-02-22,7,2020,"8",9986857,2056,0,2057,-1,2056,0,-0.0100131602965778,-0.000486144871171601
"United States","Michigan","MI",2020-02-23,2020-02-29,7,2020,"9",9986857,1973,0,2033,-60,1973,0,-0.600789617794668,-0.029513034923758
"United States","Michigan","MI",2020-03-01,2020-03-07,7,2020,"10",9986857,1988,0,2020,-32,1988,0,-0.320421129490489,-0.0158415841584159
"United States","Michigan","MI",2020-03-08,2020-03-14,7,2020,"11",9986857,1955,0,2013,-58,1955,0,-0.580763297201512,-0.0288127173373075
"United States","Michigan","MI",2020-03-15,2020-03-21,7,2020,"12",9986857,2036,5,2004,32,2031,0.050065801482889,0.320421129490489,0.0159680638722555
"United States","Michigan","MI",2020-03-22,2020-03-28,7,2020,"13",9986857,2432,99,2010,422,2333,0.991302869361201,4.22555364515583,0.209950248756219
"United States","Michigan","MI",2020-03-29,2020-04-04,7,2020,"14",9986857,3117,436,1990,1127,2681,4.36573788930792,11.2848316542432,0.566331658291457
"United States","Michigan","MI",2020-04-05,2020-04-11,7,2020,"15",9986857,3385,851,1970,1415,2534,8.5211994123877,14.1686218196576,0.718274111675127
"United States","Michigan","MI",2020-04-12,2020-04-18,7,2020,"16",9986857,3159,918,1946,1213,2241,9.19208115225841,12.1459634397489,0.623329907502569
"United States","Michigan","MI",2020-04-19,2020-04-25,7,2020,"17",9986857,2806,966,1912,894,1840,9.67271284649415,8.95176530514055,0.467573221757322
"United States","Michigan","MI",2020-04-26,2020-05-02,7,2020,"18",9986857,2588,745,1880,708,1843,7.45980442095046,7.08931748997708,0.376595744680851
"United States","Michigan","MI",2020-05-03,2020-05-09,7,2020,"19",9986857,2241,505,1844,397,1736,5.05664594977179,3.97522463774138,0.21529284164859
"United States","Michigan","MI",2020-05-10,2020-05-16,7,2020,"20",9986857,2160,354,1830,330,1806,3.54465874498854,3.30434289787067,0.180327868852459
"United States","Michigan","MI",2020-05-17,2020-05-23,7,2020,"21",9986857,2012,340,1815,197,1672,3.40447450083645,1.97259257842582,0.108539944903581
"United States","Michigan","MI",2020-05-24,2020-05-30,7,2020,"22",9986857,1962,244,1815,147,1718,2.44321111236498,1.47193456359694,0.0809917355371901
"United States","Michigan","MI",2020-05-31,2020-06-06,7,2020,"23",9986857,2000,426,1817,183,1574,4.26560628634214,1.83240833427374,0.100715465052284
"United States","Michigan","MI",2020-06-07,2020-06-13,7,2020,"24",9986857,1860,122,1804,56,1738,1.22160555618249,0.560736976608356,0.0310421286031042
"United States","Michigan","MI",2020-06-14,2020-06-20,7,2020,"25",9986857,1885,75,1804,81,1810,0.750987022243334,0.811065984022801,0.04490022172949
"United States","Michigan","MI",2020-06-21,2020-06-27,7,2020,"26",9986857,1918,67,1801,117,1851,0.670881739870712,1.1715397546996,0.064963908939478
"United States","Michigan","MI",2020-06-28,2020-07-04,7,2020,"27",9986857,1984,65,1780,204,1919,0.650855419277557,2.04268470050187,0.114606741573034
"United States","Michigan","MI",2020-07-05,2020-07-11,7,2020,"28",9986857,1890,95,1761,129,1795,0.95125022817489,1.29169767825854,0.0732538330494037
"United States","Michigan","MI",2020-07-12,2020-07-18,7,2020,"29",9986857,1879,51,1750,129,1828,0.510671175125467,1.29169767825854,0.0737142857142856
"United States","Michigan","MI",2020-07-19,2020-07-25,7,2020,"30",9986857,1891,36,1740,151,1855,0.360473770676801,1.51198720478325,0.0867816091954023
"United States","Michigan","MI",2020-07-26,2020-08-01,7,2020,"31",9986857,1968,57,1740,228,1911,0.570750136904934,2.28300054761974,0.131034482758621
"United States","Michigan","MI",2020-08-02,2020-08-08,7,2020,"32",9986857,1868,63,1731,137,1805,0.630829098684401,1.37180296063116,0.0791450028885037
"United States","Michigan","MI",2020-08-09,2020-08-15,7,2020,"33",9986857,2024,66,1725,299,1958,0.660868579574134,2.99393492867676,0.173333333333333
"United States","Michigan","MI",2020-08-16,2020-08-22,7,2020,"34",9986857,1926,69,1725,201,1857,0.690908060463868,2.01264521961214,0.116521739130435
"United States","Michigan","MI",2020-08-23,2020-08-29,7,2020,"35",9986857,1936,57,1712,224,1879,0.570750136904934,2.24294790643343,0.130841121495327
"United States","Michigan","MI",2020-08-30,2020-09-05,7,2020,"36",9986857,1959,94,1717,242,1865,0.941237067878313,2.42318479177183,0.140943506115317
"United States","Michigan","MI",2020-09-06,2020-09-12,7,2020,"37",9986857,1942,105,1725,217,1837,1.05138183114067,2.17285578435738,0.125797101449275
"United States","Michigan","MI",2020-09-13,2020-09-19,7,2020,"38",9986857,1905,58,1747,158,1847,0.580763297201512,1.58207932685929,0.0904407555809961
"United States","Michigan","MI",2020-09-20,2020-09-26,7,2020,"39",9986857,2006,75,1759,247,1931,0.750987022243334,2.47325059325471,0.140420693575895
"United States","Michigan","MI",2020-09-27,2020-10-03,7,2020,"40",9986857,2033,80,1776,257,1953,0.801052823726223,2.57338219622049,0.144707207207207
"United States","Michigan","MI",2020-10-04,2020-10-10,7,2020,"41",9986857,2146,95,1786,360,2051,0.95125022817489,3.60473770676801,0.201567749160134
"United States","Michigan","MI",2020-10-11,2020-10-17,7,2020,"42",9986857,2029,121,1799,230,1908,1.21159239588591,2.30302686821289,0.127848804891606
"United States","Michigan","MI",2020-10-18,2020-10-24,7,2020,"43",9986857,2207,182,1814,393,2025,1.82239517397716,3.93517199655507,0.21664829106946
"United States","Michigan","MI",2020-10-25,2020-10-31,7,2020,"44",9986857,2177,174,1811,366,2003,1.74228989160454,3.66481666854747,0.202098288238542
"United States","Michigan","MI",2020-11-01,2020-11-07,7,2020,"45",9986857,2347,181,1827,520,2166,1.81238201368058,5.20684335422045,0.284619594964423
"United States","Michigan","MI",2020-11-08,2020-11-14,7,2020,"46",9986857,2426,494,1823,603,1932,4.94650118650943,6.03793565883641,0.330773450356555
"United States","Michigan","MI",2020-11-15,2020-11-21,7,2020,"47",9986857,2623,503,1837,786,2120,5.03661962917863,7.87034399311014,0.427871529667937
"United States","Michigan","MI",2020-11-22,2020-11-28,7,2020,"48",9986857,2661,588,1843,818,2073,5.88773825438774,8.19076512260063,0.44384156266956
"United States","Michigan","MI",2020-11-29,2020-12-05,7,2020,"49",9986857,2804,855,1867,937,1949,8.56125205357401,9.38233119789339,0.50187466523835
"United States","Michigan","MI",2020-12-06,2020-12-12,7,2020,"50",9986857,2958,878,1876,1082,2080,8.7915547403953,10.8342394408972,0.576759061833689
"United States","Michigan","MI",2020-12-13,2020-12-19,7,2020,"51",9986857,2765,878,1897,868,1887,8.7915547403953,8.69142313742952,0.457564575645756
"United States","Michigan","MI",2020-12-20,2020-12-26,7,2020,"52",9986857,2633,616,1923,710,2017,6.16810674269192,7.10934381057023,0.369214768590744
"United States","Michigan","MI",2020-12-27,2021-01-02,7,2020,"53",9986857,2552,615,1958,594,1937,6.15809358239534,5.94781721616721,0.303370786516854
"United States","Michigan","MI",2021-01-03,2021-01-09,7,2021,"1",9986857,2354,841,1991,363,1513,8.42106780942192,3.63477718765774,0.18232044198895
"United States","Michigan","MI",2021-01-10,2021-01-16,7,2021,"2",9986857,2418,509,2014,404,1909,5.0966985909581,4.04531675981743,0.200595829195631
"United States","Michigan","MI",2021-01-17,2021-01-23,7,2021,"3",9986857,2364,524,2021,343,1840,5.24689599540676,3.43451398172618,0.169717961405245
"United States","Michigan","MI",2021-01-24,2021-01-30,7,2021,"4",9986857,2207,347,2027,180,1860,3.47456662291249,1.802368853384,0.088801184015787
"United States","Michigan","MI",2021-01-31,2021-02-06,7,2021,"5",9986857,2309,331,2000,309,1978,3.31435605816725,3.09406653164254,0.1545
"United States","Michigan","MI",2021-02-07,2021-02-13,7,2021,"6",9986857,2105,265,2007,98,1840,2.65348747859312,0.981289709064624,0.0488290981564523
"United States","Michigan","MI",2021-02-14,2021-02-20,7,2021,"7",9986857,2127,222,1997,130,1905,2.22292158584027,1.30171083855511,0.0650976464697046
"United States","Michigan","MI",2021-02-21,2021-02-27,7,2021,"8",9986857,2093,166,1998,95,1927,1.66218460923191,0.95125022817489,0.0475475475475475
"United States","Michigan","MI",2021-02-28,2021-03-06,7,2021,"9",9986857,2051,151,1993,58,1900,1.51198720478325,0.580763297201512,0.0291018564977421
"United States","Michigan","MI",2021-03-07,2021-03-13,7,2021,"10",9986857,1893,115,1978,-85,1778,1.15151343410645,-0.851118625209112,-0.0429726996966633
"United States","Michigan","MI",2021-03-14,2021-03-20,7,2021,"11",9986857,2056,134,1962,94,1922,1.34176347974142,0.941237067878313,0.0479102956167177
"United States","Michigan","MI",2021-03-21,2021-03-27,7,2021,"12",9986857,2142,141,1962,180,2001,1.41185560181747,1.802368853384,0.0917431192660549
"United States","Michigan","MI",2021-03-28,2021-04-03,7,2021,"13",9986857,2105,210,1953,152,1895,2.10276366228134,1.52200036507982,0.0778289810547874
"United States","Michigan","MI",2021-04-04,2021-04-10,7,2021,"14",9986857,2401,303,1948,453,2098,3.03398756986307,4.53596161434974,0.232546201232033
"United States","Michigan","MI",2021-04-11,2021-04-17,7,2021,"15",9986857,2362,371,1945,417,1991,3.71488247003036,4.17548784367294,0.21439588688946
"United States","Michigan","MI",2021-04-18,2021-04-24,7,2021,"16",9986857,2506,475,1917,589,2031,4.75625114087445,5.89775141468432,0.307250912884716
"United States","Michigan","MI",2021-04-25,2021-05-01,7,2021,"17",9986857,2450,484,1900,550,1966,4.84636958354365,5.50723816311779,0.289473684210526
"United States","Michigan","MI",2021-05-02,2021-05-08,7,2021,"18",9986857,2385,484,1886,499,1901,4.84636958354365,4.99656698799232,0.26458112407211
"United States","Michigan","MI",2021-05-09,2021-05-15,7,2021,"19",9986857,2298,413,1861,437,1885,4.13543520248663,4.3757510496045,0.23481998925309
"United States","Michigan","MI",2021-05-16,2021-05-22,7,2021,"20",9986857,2347,350,1851,496,1997,3.50460610380223,4.96652750710258,0.267963263101026
"United States","Michigan","MI",2021-05-23,2021-05-29,7,2021,"21",9986857,2169,236,1843,326,1933,2.36310582999236,3.26429025668436,0.176885512750949
"United States","Michigan","MI",2021-05-30,2021-06-05,7,2021,"22",9986857,2123,212,1838,285,1911,2.12278998287449,2.85375068452467,0.155059847660501
"United States","Michigan","MI",2021-06-06,2021-06-12,7,2021,"23",9986857,2085,190,1833,252,1895,1.90250045634978,2.5233163947376,0.137479541734861
"United States","Michigan","MI",2021-06-13,2021-06-19,7,2021,"24",9986857,1845,84,1844,1,1761,0.841105464912534,0.0100131602965778,0.000542299349240771
"United States","Michigan","MI",2021-06-20,2021-06-26,7,2021,"25",9986857,1284,97,1848,-564,1187,0.971276548768046,-5.64742240726987,-0.305194805194805
"United States","Minnesota","MN",2019-12-29,2020-01-04,7,2020,"1",5639632,1009,0,989,20,1009,0,0.354633068256936,0.0202224469160768
"United States","Minnesota","MN",2020-01-05,2020-01-11,7,2020,"2",5639632,950,0,969,-19,950,0,-0.336901414844089,-0.0196078431372549
"United States","Minnesota","MN",2020-01-12,2020-01-18,7,2020,"3",5639632,946,0,966,-20,946,0,-0.354633068256936,-0.020703933747412
"United States","Minnesota","MN",2020-01-19,2020-01-25,7,2020,"4",5639632,955,0,955,0,955,0,0,0
"United States","Minnesota","MN",2020-01-26,2020-02-01,7,2020,"5",5639632,942,0,954,-12,942,0,-0.212779840954162,-0.0125786163522013
"United States","Minnesota","MN",2020-02-02,2020-02-08,7,2020,"6",5639632,919,0,953,-34,919,0,-0.602876216036791,-0.0356768100734522
"United States","Minnesota","MN",2020-02-09,2020-02-15,7,2020,"7",5639632,941,0,949,-8,941,0,-0.141853227302774,-0.00842992623814542
"United States","Minnesota","MN",2020-02-16,2020-02-22,7,2020,"8",5639632,913,0,943,-30,913,0,-0.531949602385404,-0.031813361611877
"United States","Minnesota","MN",2020-02-23,2020-02-29,7,2020,"9",5639632,933,0,934,-1,933,0,-0.0177316534128468,-0.00107066381156318
"United States","Minnesota","MN",2020-03-01,2020-03-07,7,2020,"10",5639632,944,0,933,11,944,0,0.195048187541315,0.0117899249732047
"United States","Minnesota","MN",2020-03-08,2020-03-14,7,2020,"11",5639632,882,0,915,-33,882,0,-0.585144562623944,-0.0360655737704918
"United States","Minnesota","MN",2020-03-15,2020-03-21,7,2020,"12",5639632,894,1,905,-11,893,0.0177316534128468,-0.195048187541315,-0.0121546961325967
"United States","Minnesota","MN",2020-03-22,2020-03-28,7,2020,"13",5639632,909,4,909,0,905,0.0709266136513872,0,0
"United States","Minnesota","MN",2020-03-29,2020-04-04,7,2020,"14",5639632,928,19,914,14,909,0.336901414844089,0.248243147779855,0.0153172866520788
"United States","Minnesota","MN",2020-04-05,2020-04-11,7,2020,"15",5639632,943,40,908,35,903,0.709266136513872,0.620607869449638,0.0385462555066078
"United States","Minnesota","MN",2020-04-12,2020-04-18,7,2020,"16",5639632,955,57,893,62,898,1.01070424453227,1.0993625115965,0.0694288913773795
"United States","Minnesota","MN",2020-04-19,2020-04-25,7,2020,"17",5639632,1016,122,887,129,894,2.16326171636731,2.28738329025724,0.14543404735062
"United States","Minnesota","MN",2020-04-26,2020-05-02,7,2020,"18",5639632,1042,150,867,175,892,2.65974801192702,3.10303934724819,0.201845444059977
"United States","Minnesota","MN",2020-05-03,2020-05-09,7,2020,"19",5639632,1057,164,858,199,893,2.90799115970687,3.52859902915651,0.231934731934732
"United States","Minnesota","MN",2020-05-10,2020-05-16,7,2020,"20",5639632,1000,141,847,153,859,2.5001631312114,2.71294297216556,0.180637544273908
"United States","Minnesota","MN",2020-05-17,2020-05-23,7,2020,"21",5639632,1005,150,851,154,855,2.65974801192702,2.73067462557841,0.18096357226792
"United States","Minnesota","MN",2020-05-24,2020-05-30,7,2020,"22",5639632,1017,176,844,173,841,3.12077100066104,3.0675760404225,0.204976303317536
"United States","Minnesota","MN",2020-05-31,2020-06-06,7,2020,"23",5639632,1038,143,833,205,895,2.53562643803709,3.63498894963359,0.24609843937575
"United States","Minnesota","MN",2020-06-07,2020-06-13,7,2020,"24",5639632,973,114,820,153,859,2.02140848906453,2.71294297216556,0.186585365853658
"United States","Minnesota","MN",2020-06-14,2020-06-20,7,2020,"25",5639632,941,91,829,112,850,1.61358046056906,1.98594518223884,0.135102533172497
"United States","Minnesota","MN",2020-06-21,2020-06-27,7,2020,"26",5639632,840,45,828,12,795,0.797924403578106,0.212779840954162,0.0144927536231885
"United States","Minnesota","MN",2020-06-28,2020-07-04,7,2020,"27",5639632,876,49,822,54,827,0.868851017229493,0.957509284293727,0.0656934306569343
"United States","Minnesota","MN",2020-07-05,2020-07-11,7,2020,"28",5639632,865,33,825,40,832,0.585144562623944,0.709266136513872,0.0484848484848486
"United States","Minnesota","MN",2020-07-12,2020-07-18,7,2020,"29",5639632,869,39,824,45,830,0.691534483101025,0.797924403578106,0.0546116504854368
"United States","Minnesota","MN",2020-07-19,2020-07-25,7,2020,"30",5639632,878,7,826,52,871,0.124121573889928,0.922045977468033,0.062953995157385
"United States","Minnesota","MN",2020-07-26,2020-08-01,7,2020,"31",5639632,818,61,824,-6,757,1.08163085818365,-0.106389920477081,-0.00728155339805825
"United States","Minnesota","MN",2020-08-02,2020-08-08,7,2020,"32",5639632,897,42,829,68,855,0.744729443339565,1.20575243207358,0.0820265379975875
"United States","Minnesota","MN",2020-08-09,2020-08-15,7,2020,"33",5639632,888,51,829,59,837,0.904314324055187,1.04616755135796,0.0711700844390832
"United States","Minnesota","MN",2020-08-16,2020-08-22,7,2020,"34",5639632,907,62,833,74,845,1.0993625115965,1.31214235255066,0.0888355342136855
"United States","Minnesota","MN",2020-08-23,2020-08-29,7,2020,"35",5639632,919,53,836,83,866,0.93977763088088,1.47172723326628,0.0992822966507176
"United States","Minnesota","MN",2020-08-30,2020-09-05,7,2020,"36",5639632,895,37,836,59,858,0.656071176275331,1.04616755135796,0.0705741626794258
"United States","Minnesota","MN",2020-09-06,2020-09-12,7,2020,"37",5639632,893,55,839,54,838,0.975240937706574,0.957509284293727,0.0643623361144219
"United States","Minnesota","MN",2020-09-13,2020-09-19,7,2020,"38",5639632,957,57,853,104,900,1.01070424453227,1.84409195493607,0.121922626025791
"United States","Minnesota","MN",2020-09-20,2020-09-26,7,2020,"39",5639632,969,41,862,107,928,0.726997789926719,1.89728691517461,0.124129930394432
"United States","Minnesota","MN",2020-09-27,2020-10-03,7,2020,"40",5639632,886,69,867,19,817,1.22348408548643,0.336901414844089,0.0219146482122261
"United States","Minnesota","MN",2020-10-04,2020-10-10,7,2020,"41",5639632,1013,58,874,139,955,1.02843589794511,2.4646998243857,0.159038901601831
"United States","Minnesota","MN",2020-10-11,2020-10-17,7,2020,"42",5639632,953,20,879,74,933,0.354633068256936,1.31214235255066,0.0841865756541524
"United States","Minnesota","MN",2020-10-18,2020-10-24,7,2020,"43",5639632,1030,95,888,142,935,1.68450707422045,2.51789478462425,0.15990990990991
"United States","Minnesota","MN",2020-10-25,2020-10-31,7,2020,"44",5639632,1075,229,889,186,846,4.06054863154192,3.2980875347895,0.209223847019123
"United States","Minnesota","MN",2020-11-01,2020-11-07,7,2020,"45",5639632,1145,149,889,256,996,2.64201635851417,4.53930327368878,0.287964004499438
"United States","Minnesota","MN",2020-11-08,2020-11-14,7,2020,"46",5639632,1196,281,889,307,915,4.98259460900995,5.44361759774397,0.34533183352081
"United States","Minnesota","MN",2020-11-15,2020-11-21,7,2020,"47",5639632,1326,336,887,439,990,5.95783554671652,7.78419584823974,0.494926719278467
"United States","Minnesota","MN",2020-11-22,2020-11-28,7,2020,"48",5639632,1397,280,884,513,1117,4.9648629555971,9.09633820079041,0.580316742081448
"United States","Minnesota","MN",2020-11-29,2020-12-05,7,2020,"49",5639632,1334,398,876,458,936,7.05719805831303,8.12109726308383,0.52283105022831
"United States","Minnesota","MN",2020-12-06,2020-12-12,7,2020,"50",5639632,1382,440,892,490,942,7.80192750165259,8.68851017229493,0.54932735426009
"United States","Minnesota","MN",2020-12-13,2020-12-19,7,2020,"51",5639632,1269,421,908,361,848,7.4650260868085,6.40112688203769,0.397577092511013
"United States","Minnesota","MN",2020-12-20,2020-12-26,7,2020,"52",5639632,1203,327,923,280,876,5.7982506660009,4.9648629555971,0.303358613217768
"United States","Minnesota","MN",2020-12-27,2021-01-02,7,2020,"53",5639632,1194,270,946,248,924,4.78754642146863,4.39745004638601,0.26215644820296
"United States","Minnesota","MN",2021-01-03,2021-01-09,7,2021,"1",5639632,1140,286,953,187,854,5.07125287607418,3.31581918820235,0.196222455403987
"United States","Minnesota","MN",2021-01-10,2021-01-16,7,2021,"2",5639632,1085,224,962,123,861,3.97189036447768,2.18099336978016,0.127858627858628
"United States","Minnesota","MN",2021-01-17,2021-01-23,7,2021,"3",5639632,953,176,962,-9,777,3.12077100066104,-0.159584880715621,-0.00935550935550933
"United States","Minnesota","MN",2021-01-24,2021-01-30,7,2021,"4",5639632,929,124,942,-13,805,2.198725023193,-0.230511494367008,-0.0138004246284501
"United States","Minnesota","MN",2021-01-31,2021-02-06,7,2021,"5",5639632,988,103,935,53,885,1.82636030152322,0.93977763088088,0.0566844919786096
"United States","Minnesota","MN",2021-02-07,2021-02-13,7,2021,"6",5639632,916,80,927,-11,836,1.41853227302774,-0.195048187541315,-0.0118662351672061
"United States","Minnesota","MN",2021-02-14,2021-02-20,7,2021,"7",5639632,909,54,924,-15,855,0.957509284293727,-0.265974801192702,-0.0162337662337663
"United States","Minnesota","MN",2021-02-21,2021-02-27,7,2021,"8",5639632,974,53,907,67,921,0.93977763088088,1.18802077866074,0.0738699007717751
"United States","Minnesota","MN",2021-02-28,2021-03-06,7,2021,"9",5639632,937,69,895,42,868,1.22348408548643,0.744729443339565,0.046927374301676
"United States","Minnesota","MN",2021-03-07,2021-03-13,7,2021,"10",5639632,868,195,895,-27,673,3.45767241550513,-0.478754642146863,-0.0301675977653632
"United States","Minnesota","MN",2021-03-14,2021-03-20,7,2021,"11",5639632,869,37,893,-24,832,0.656071176275331,-0.425559681908323,-0.026875699888018
"United States","Minnesota","MN",2021-03-21,2021-03-27,7,2021,"12",5639632,868,47,880,-12,821,0.833387710403799,-0.212779840954162,-0.0136363636363637
"United States","Minnesota","MN",2021-03-28,2021-04-03,7,2021,"13",5639632,875,50,893,-18,825,0.88658267064234,-0.319169761431242,-0.0201567749160134
"United States","Minnesota","MN",2021-04-04,2021-04-10,7,2021,"14",5639632,877,69,896,-19,808,1.22348408548643,-0.336901414844089,-0.0212053571428571
"United States","Minnesota","MN",2021-04-11,2021-04-17,7,2021,"15",5639632,893,61,892,1,832,1.08163085818365,0.0177316534128468,0.00112107623318392
"United States","Minnesota","MN",2021-04-18,2021-04-24,7,2021,"16",5639632,936,67,892,44,869,1.18802077866074,0.780192750165259,0.0493273542600896
"United States","Minnesota","MN",2021-04-25,2021-05-01,7,2021,"17",5639632,965,82,898,67,883,1.45399557985344,1.18802077866074,0.0746102449888641
"United States","Minnesota","MN",2021-05-02,2021-05-08,7,2021,"18",5639632,894,70,881,13,824,1.24121573889928,0.230511494367008,0.0147559591373438
"United States","Minnesota","MN",2021-05-09,2021-05-15,7,2021,"19",5639632,927,62,886,41,865,1.0993625115965,0.726997789926719,0.0462753950338601
"United States","Minnesota","MN",2021-05-16,2021-05-22,7,2021,"20",5639632,865,77,876,-11,788,1.3653373127892,-0.195048187541315,-0.0125570776255708
"United States","Minnesota","MN",2021-05-23,2021-05-29,7,2021,"21",5639632,809,55,855,-46,754,0.975240937706574,-0.815656056990953,-0.0538011695906433
"United States","Minnesota","MN",2021-05-30,2021-06-05,7,2021,"22",5639632,803,43,839,-36,760,0.762461096752412,-0.638339522862485,-0.0429082240762813
"United States","Minnesota","MN",2021-06-06,2021-06-12,7,2021,"23",5639632,830,42,830,0,788,0.744729443339565,0,0
"United States","Minnesota","MN",2021-06-13,2021-06-19,7,2021,"24",5639632,785,33,827,-42,752,0.585144562623944,-0.744729443339565,-0.0507859733978234
"United States","Minnesota","MN",2021-06-20,2021-06-26,7,2021,"25",5639632,758,42,833,-75,716,0.744729443339565,-1.32987400596351,-0.0900360144057623
"United States","Mississippi","MS",2019-12-29,2020-01-04,7,2020,"1",2976149,673,0,705,-32,673,0,-1.07521498419602,-0.0453900709219858
"United States","Mississippi","MS",2020-01-05,2020-01-11,7,2020,"2",2976149,648,0,707,-59,648,0,-1.98242762711141,-0.0834512022630834
"United States","Mississippi","MS",2020-01-12,2020-01-18,7,2020,"3",2976149,624,0,689,-65,624,0,-2.18403043664817,-0.0943396226415094
"United States","Mississippi","MS",2020-01-19,2020-01-25,7,2020,"4",2976149,612,0,670,-58,612,0,-1.94882715885529,-0.0865671641791045
"United States","Mississippi","MS",2020-01-26,2020-02-01,7,2020,"5",2976149,608,0,669,-61,608,0,-2.04962856362366,-0.0911808669656203
"United States","Mississippi","MS",2020-02-02,2020-02-08,7,2020,"6",2976149,703,0,678,25,703,0,0.84001170640314,0.0368731563421829
"United States","Mississippi","MS",2020-02-09,2020-02-15,7,2020,"7",2976149,648,0,666,-18,648,0,-0.604808428610261,-0.027027027027027
"United States","Mississippi","MS",2020-02-16,2020-02-22,7,2020,"8",2976149,625,0,659,-34,625,0,-1.14241592070827,-0.0515933232169955
"United States","Mississippi","MS",2020-02-23,2020-02-29,7,2020,"9",2976149,665,0,648,17,665,0,0.571207960354135,0.0262345679012346
"United States","Mississippi","MS",2020-03-01,2020-03-07,7,2020,"10",2976149,663,0,650,13,663,0,0.436806087329633,0.02
"United States","Mississippi","MS",2020-03-08,2020-03-14,7,2020,"11",2976149,623,0,645,-22,623,0,-0.739210301634764,-0.0341085271317829
"United States","Mississippi","MS",2020-03-15,2020-03-21,7,2020,"12",2976149,625,1,638,-13,624,0.0336004682561256,-0.436806087329633,-0.0203761755485894
"United States","Mississippi","MS",2020-03-22,2020-03-28,7,2020,"13",2976149,698,5,629,69,693,0.168002341280628,2.31843230967267,0.109697933227345
"United States","Mississippi","MS",2020-03-29,2020-04-04,7,2020,"14",2976149,707,29,621,86,678,0.974413579427643,2.8896402700268,0.138486312399356
"United States","Mississippi","MS",2020-04-05,2020-04-11,7,2020,"15",2976149,699,57,618,81,642,1.91522669059916,2.72163792874617,0.131067961165048
"United States","Mississippi","MS",2020-04-12,2020-04-18,7,2020,"16",2976149,732,59,610,122,673,1.98242762711141,4.09925712724733,0.2
"United States","Mississippi","MS",2020-04-19,2020-04-25,7,2020,"17",2976149,750,69,607,143,681,2.31843230967267,4.80486696062596,0.235584843492586
"United States","Mississippi","MS",2020-04-26,2020-05-02,7,2020,"18",2976149,751,71,595,156,680,2.38563324618492,5.2416730479556,0.26218487394958
"United States","Mississippi","MS",2020-05-03,2020-05-09,7,2020,"19",2976149,748,128,589,159,620,4.30085993678408,5.34247445272397,0.269949066213922
"United States","Mississippi","MS",2020-05-10,2020-05-16,7,2020,"20",2976149,775,91,586,189,684,3.05764261130743,6.35048850040774,0.322525597269625
"United States","Mississippi","MS",2020-05-17,2020-05-23,7,2020,"21",2976149,725,106,592,133,619,3.56164963514932,4.46886227806471,0.224662162162162
"United States","Mississippi","MS",2020-05-24,2020-05-30,7,2020,"22",2976149,750,107,599,151,643,3.59525010340544,5.07367070667497,0.252086811352254
"United States","Mississippi","MS",2020-05-31,2020-06-06,7,2020,"23",2976149,728,88,598,130,640,2.95684120653905,4.36806087329633,0.217391304347826
"United States","Mississippi","MS",2020-06-07,2020-06-13,7,2020,"24",2976149,702,78,592,110,624,2.6208365239778,3.69605150817382,0.185810810810811
"United States","Mississippi","MS",2020-06-14,2020-06-20,7,2020,"25",2976149,743,49,594,149,694,1.64642294455016,5.00646977016272,0.250841750841751
"United States","Mississippi","MS",2020-06-21,2020-06-27,7,2020,"26",2976149,721,97,593,128,624,3.25924542084418,4.30085993678408,0.215851602023609
"United States","Mississippi","MS",2020-06-28,2020-07-04,7,2020,"27",2976149,711,72,587,124,639,2.41923371444104,4.16645806375958,0.211243611584327
"United States","Mississippi","MS",2020-07-05,2020-07-11,7,2020,"28",2976149,797,123,582,215,674,4.13285759550345,7.22410067506701,0.369415807560137
"United States","Mississippi","MS",2020-07-12,2020-07-18,7,2020,"29",2976149,784,116,573,211,668,3.89765431771057,7.08969880204251,0.368237347294939
"United States","Mississippi","MS",2020-07-19,2020-07-25,7,2020,"30",2976149,886,134,575,311,752,4.50246274632083,10.4497456276551,0.540869565217391
"United States","Mississippi","MS",2020-07-26,2020-08-01,7,2020,"31",2976149,872,212,569,303,660,7.12329927029863,10.1809418816061,0.532513181019332
"United States","Mississippi","MS",2020-08-02,2020-08-08,7,2020,"32",2976149,915,165,568,347,750,5.54407726226073,11.6593624848756,0.610915492957746
"United States","Mississippi","MS",2020-08-09,2020-08-15,7,2020,"33",2976149,860,223,567,293,637,7.49290442111601,9.84493719904481,0.516754850088183
"United States","Mississippi","MS",2020-08-16,2020-08-22,7,2020,"34",2976149,813,155,576,237,658,5.20807257969947,7.96331097670177,0.411458333333333
"United States","Mississippi","MS",2020-08-23,2020-08-29,7,2020,"35",2976149,813,190,575,238,623,6.38408896866387,7.9969114449579,0.413913043478261
"United States","Mississippi","MS",2020-08-30,2020-09-05,7,2020,"36",2976149,736,144,581,155,592,4.83846742888209,5.20807257969947,0.266781411359725
"United States","Mississippi","MS",2020-09-06,2020-09-12,7,2020,"37",2976149,745,112,582,163,633,3.76325244468607,5.47687632574848,0.280068728522337
"United States","Mississippi","MS",2020-09-13,2020-09-19,7,2020,"38",2976149,738,128,585,153,610,4.30085993678408,5.14087164318722,0.261538461538461
"United States","Mississippi","MS",2020-09-20,2020-09-26,7,2020,"39",2976149,723,102,590,133,621,3.42724776212481,4.46886227806471,0.225423728813559
"United States","Mississippi","MS",2020-09-27,2020-10-03,7,2020,"40",2976149,728,104,591,137,624,3.49444869863706,4.60326415108921,0.231810490693739
"United States","Mississippi","MS",2020-10-04,2020-10-10,7,2020,"41",2976149,761,81,594,167,680,2.72163792874617,5.61127819877298,0.281144781144781
"United States","Mississippi","MS",2020-10-11,2020-10-17,7,2020,"42",2976149,680,75,598,82,605,2.52003511920942,2.7552383970023,0.137123745819398
"United States","Mississippi","MS",2020-10-18,2020-10-24,7,2020,"43",2976149,727,84,601,126,643,2.82243933351455,4.23365900027183,0.209650582362729
"United States","Mississippi","MS",2020-10-25,2020-10-31,7,2020,"44",2976149,716,93,606,110,623,3.12484354781968,3.69605150817382,0.181518151815182
"United States","Mississippi","MS",2020-11-01,2020-11-07,7,2020,"45",2976149,750,94,613,137,656,3.15844401607581,4.60326415108921,0.223491027732463
"United States","Mississippi","MS",2020-11-08,2020-11-14,7,2020,"46",2976149,785,98,621,164,687,3.29284588910031,5.5104767940046,0.264090177133655
"United States","Mississippi","MS",2020-11-15,2020-11-21,7,2020,"47",2976149,793,117,635,158,676,3.9312547859667,5.30887398446785,0.248818897637795
"United States","Mississippi","MS",2020-11-22,2020-11-28,7,2020,"48",2976149,820,122,645,175,698,4.09925712724733,5.88008194482198,0.271317829457364
"United States","Mississippi","MS",2020-11-29,2020-12-05,7,2020,"49",2976149,850,170,649,201,680,5.71207960354136,6.75369411948125,0.309707241910632
"United States","Mississippi","MS",2020-12-06,2020-12-12,7,2020,"50",2976149,959,231,660,299,728,7.76170816716502,10.0465400085816,0.453030303030303
"United States","Mississippi","MS",2020-12-13,2020-12-19,7,2020,"51",2976149,923,210,664,259,713,7.05609833378638,8.70252127833654,0.390060240963855
"United States","Mississippi","MS",2020-12-20,2020-12-26,7,2020,"52",2976149,995,175,670,325,820,5.88008194482198,10.9201521832408,0.485074626865672
"United States","Mississippi","MS",2020-12-27,2021-01-02,7,2020,"53",2976149,1068,275,676,392,793,9.24012877043454,13.1713835564012,0.579881656804734
"United States","Mississippi","MS",2021-01-03,2021-01-09,7,2021,"1",2976149,1046,-262,670,376,1308,-8.80332268310491,12.6337760643032,0.561194029850746
"United States","Mississippi","MS",2021-01-10,2021-01-16,7,2021,"2",2976149,1061,903,690,371,158,30.3412228352814,12.4657737230226,0.53768115942029
"United States","Mississippi","MS",2021-01-17,2021-01-23,7,2021,"3",2976149,1022,271,690,332,751,9.10572689741004,11.1553554610337,0.481159420289855
"United States","Mississippi","MS",2021-01-24,2021-01-30,7,2021,"4",2976149,918,267,686,232,651,8.97132502438554,7.79530863542114,0.338192419825073
"United States","Mississippi","MS",2021-01-31,2021-02-06,7,2021,"5",2976149,866,247,676,190,619,8.29931565926303,6.38408896866387,0.281065088757396
"United States","Mississippi","MS",2021-02-07,2021-02-13,7,2021,"6",2976149,790,196,676,114,594,6.58569177820062,3.83045338119832,0.168639053254438
"United States","Mississippi","MS",2021-02-14,2021-02-20,7,2021,"7",2976149,807,92,665,142,715,3.09124307956356,4.77126649236984,0.213533834586466
"United States","Mississippi","MS",2021-02-21,2021-02-27,7,2021,"8",2976149,846,116,658,188,730,3.89765431771057,6.31688803215162,0.285714285714286
"United States","Mississippi","MS",2021-02-28,2021-03-06,7,2021,"9",2976149,721,136,652,69,585,4.56966368283308,2.31843230967267,0.105828220858896
"United States","Mississippi","MS",2021-03-07,2021-03-13,7,2021,"10",2976149,752,91,642,110,661,3.05764261130743,3.69605150817382,0.171339563862928
"United States","Mississippi","MS",2021-03-14,2021-03-20,7,2021,"11",2976149,674,60,633,41,614,2.01602809536754,1.37761919850115,0.0647709320695102
"United States","Mississippi","MS",2021-03-21,2021-03-27,7,2021,"12",2976149,673,45,635,38,628,1.51202107152565,1.27681779373277,0.0598425196850394
"United States","Mississippi","MS",2021-03-28,2021-04-03,7,2021,"13",2976149,646,55,626,20,591,1.84802575408691,0.672009365122512,0.0319488817891374
"United States","Mississippi","MS",2021-04-04,2021-04-10,7,2021,"14",2976149,665,38,624,41,627,1.27681779373277,1.37761919850115,0.0657051282051282
"United States","Mississippi","MS",2021-04-11,2021-04-17,7,2021,"15",2976149,654,58,621,33,596,1.94882715885529,1.10881545245215,0.0531400966183575
"United States","Mississippi","MS",2021-04-18,2021-04-24,7,2021,"16",2976149,666,22,611,55,644,0.739210301634764,1.84802575408691,0.0900163666121112
"United States","Mississippi","MS",2021-04-25,2021-05-01,7,2021,"17",2976149,694,24,606,88,670,0.806411238147015,2.95684120653905,0.145214521452145
"United States","Mississippi","MS",2021-05-02,2021-05-08,7,2021,"18",2976149,636,29,609,27,607,0.974413579427643,0.907212642915392,0.0443349753694582
"United States","Mississippi","MS",2021-05-09,2021-05-15,7,2021,"19",2976149,636,26,607,29,610,0.873612174659266,0.974413579427643,0.0477759472817134
"United States","Mississippi","MS",2021-05-16,2021-05-22,7,2021,"20",2976149,688,25,602,86,663,0.84001170640314,2.8896402700268,0.142857142857143
"United States","Mississippi","MS",2021-05-23,2021-05-29,7,2021,"21",2976149,680,31,598,82,649,1.04161451593989,2.7552383970023,0.137123745819398
"United States","Mississippi","MS",2021-05-30,2021-06-05,7,2021,"22",2976149,602,15,596,6,587,0.504007023841884,0.201602809536754,0.0100671140939597
"United States","Mississippi","MS",2021-06-06,2021-06-12,7,2021,"23",2976149,696,28,595,101,668,0.940813111171517,3.39364729386869,0.169747899159664
"United States","Mississippi","MS",2021-06-13,2021-06-19,7,2021,"24",2976149,618,18,590,28,600,0.604808428610261,0.940813111171517,0.047457627118644
"United States","Mississippi","MS",2021-06-20,2021-06-26,7,2021,"25",2976149,573,24,592,-19,549,0.806411238147015,-0.638408896866387,-0.0320945945945946
"United States","Missouri","MO",2019-12-29,2020-01-04,7,2020,"1",6137428,1327,0,1527,-200,1327,0,-3.25869403274466,-0.130975769482646
"United States","Missouri","MO",2020-01-05,2020-01-11,7,2020,"2",6137428,1333,0,1541,-208,1333,0,-3.38904179405445,-0.134977287475665
"United States","Missouri","MO",2020-01-12,2020-01-18,7,2020,"3",6137428,1334,0,1547,-213,1334,0,-3.47050914487306,-0.137685843568196
"United States","Missouri","MO",2020-01-19,2020-01-25,7,2020,"4",6137428,1352,0,1498,-146,1352,0,-2.3788466439036,-0.0974632843791722
"United States","Missouri","MO",2020-01-26,2020-02-01,7,2020,"5",6137428,1364,0,1474,-110,1364,0,-1.79228171800956,-0.0746268656716418
"United States","Missouri","MO",2020-02-02,2020-02-08,7,2020,"6",6137428,1334,0,1464,-130,1334,0,-2.11815112128403,-0.0887978142076503
"United States","Missouri","MO",2020-02-09,2020-02-15,7,2020,"7",6137428,1348,0,1433,-85,1348,0,-1.38494496391648,-0.0593161200279134
"United States","Missouri","MO",2020-02-16,2020-02-22,7,2020,"8",6137428,1361,0,1411,-50,1361,0,-0.814673508186165,-0.0354358610914245
"United States","Missouri","MO",2020-02-23,2020-02-29,7,2020,"9",6137428,1370,0,1390,-20,1370,0,-0.325869403274466,-0.0143884892086331
"United States","Missouri","MO",2020-03-01,2020-03-07,7,2020,"10",6137428,1394,0,1375,19,1394,0,0.309575933110743,0.0138181818181817
"United States","Missouri","MO",2020-03-08,2020-03-14,7,2020,"11",6137428,1301,0,1372,-71,1301,0,-1.15683638162435,-0.0517492711370262
"United States","Missouri","MO",2020-03-15,2020-03-21,7,2020,"12",6137428,1272,3,1357,-85,1269,0.0488804104911699,-1.38494496391648,-0.0626381724392041
"United States","Missouri","MO",2020-03-22,2020-03-28,7,2020,"13",6137428,1343,7,1345,-2,1336,0.114054291146063,-0.0325869403274466,-0.00148698884758369
"United States","Missouri","MO",2020-03-29,2020-04-04,7,2020,"14",6137428,1301,13,1324,-23,1288,0.211815112128403,-0.374749813765636,-0.0173716012084593
"United States","Missouri","MO",2020-04-05,2020-04-11,7,2020,"15",6137428,1466,87,1308,158,1379,1.41753190424393,2.57436828586828,0.120795107033639
"United States","Missouri","MO",2020-04-12,2020-04-18,7,2020,"16",6137428,1358,67,1295,63,1291,1.09166250096946,1.02648862031457,0.0486486486486486
"United States","Missouri","MO",2020-04-19,2020-04-25,7,2020,"17",6137428,1448,98,1286,162,1350,1.59676007604488,2.63954216652318,0.12597200622084
"United States","Missouri","MO",2020-04-26,2020-05-02,7,2020,"18",6137428,1393,78,1265,128,1315,1.27089067277042,2.08556418095658,0.101185770750988
"United States","Missouri","MO",2020-05-03,2020-05-09,7,2020,"19",6137428,1427,121,1248,179,1306,1.97150988981052,2.91653115930647,0.143429487179487
"United States","Missouri","MO",2020-05-10,2020-05-16,7,2020,"20",6137428,1343,116,1235,108,1227,1.8900425389919,1.75969477768212,0.0874493927125506
"United States","Missouri","MO",2020-05-17,2020-05-23,7,2020,"21",6137428,1304,86,1235,69,1218,1.4012384340802,1.12424944129691,0.0558704453441297
"United States","Missouri","MO",2020-05-24,2020-05-30,7,2020,"22",6137428,1244,94,1230,14,1150,1.53158619538999,0.228108582292126,0.0113821138211383
"United States","Missouri","MO",2020-05-31,2020-06-06,7,2020,"23",6137428,1293,37,1223,70,1256,0.602858396057762,1.14054291146063,0.0572363041700736
"United States","Missouri","MO",2020-06-07,2020-06-13,7,2020,"24",6137428,1263,70,1215,48,1193,1.14054291146063,0.782086567858719,0.0395061728395061
"United States","Missouri","MO",2020-06-14,2020-06-20,7,2020,"25",6137428,1228,78,1220,8,1150,1.27089067277042,0.130347761309786,0.00655737704918025
"United States","Missouri","MO",2020-06-21,2020-06-27,7,2020,"26",6137428,1284,41,1214,70,1243,0.668032276712656,1.14054291146063,0.0576606260296539
"United States","Missouri","MO",2020-06-28,2020-07-04,7,2020,"27",6137428,1284,26,1216,68,1258,0.423630224256806,1.10795597113318,0.055921052631579
"United States","Missouri","MO",2020-07-05,2020-07-11,7,2020,"28",6137428,1295,47,1212,83,1248,0.765793097694995,1.35235802358903,0.0684818481848184
"United States","Missouri","MO",2020-07-12,2020-07-18,7,2020,"29",6137428,1367,61,1197,170,1306,0.993901679987122,2.76988992783296,0.142021720969089
"United States","Missouri","MO",2020-07-19,2020-07-25,7,2020,"30",6137428,1355,52,1188,167,1303,0.847260448513612,2.72100951734179,0.140572390572391
"United States","Missouri","MO",2020-07-26,2020-08-01,7,2020,"31",6137428,1366,71,1199,167,1295,1.15683638162435,2.72100951734179,0.139282735613011
"United States","Missouri","MO",2020-08-02,2020-08-08,7,2020,"32",6137428,1355,48,1185,170,1307,0.782086567858719,2.76988992783296,0.143459915611814
"United States","Missouri","MO",2020-08-09,2020-08-15,7,2020,"33",6137428,1380,45,1179,201,1335,0.733206157367549,3.27498750290838,0.170483460559796
"United States","Missouri","MO",2020-08-16,2020-08-22,7,2020,"34",6137428,1402,79,1173,229,1323,1.28718414293414,3.73120466749264,0.195225916453538
"United States","Missouri","MO",2020-08-23,2020-08-29,7,2020,"35",6137428,1382,71,1173,209,1311,1.15683638162435,3.40533526421817,0.178175618073316
"United States","Missouri","MO",2020-08-30,2020-09-05,7,2020,"36",6137428,1410,143,1163,247,1267,2.32996623341243,4.02448713043966,0.212381771281169
"United States","Missouri","MO",2020-09-06,2020-09-12,7,2020,"37",6137428,1369,65,1162,207,1304,1.05907556064201,3.37274832389072,0.178141135972461
"United States","Missouri","MO",2020-09-13,2020-09-19,7,2020,"38",6137428,1445,89,1161,284,1356,1.45011884457137,4.62734552649742,0.244616709732989
"United States","Missouri","MO",2020-09-20,2020-09-26,7,2020,"39",6137428,1465,270,1162,303,1195,4.39923694420529,4.93692145960816,0.260757314974182
"United States","Missouri","MO",2020-09-27,2020-10-03,7,2020,"40",6137428,1522,107,1165,357,1415,1.74340130751839,5.81676884844922,0.306437768240343
"United States","Missouri","MO",2020-10-04,2020-10-10,7,2020,"41",6137428,1531,253,1173,358,1278,4.122247951422,5.83306231861294,0.305200341005968
"United States","Missouri","MO",2020-10-11,2020-10-17,7,2020,"42",6137428,1519,162,1182,337,1357,2.63954216652318,5.49089944517475,0.285109983079526
"United States","Missouri","MO",2020-10-18,2020-10-24,7,2020,"43",6137428,1577,253,1187,390,1324,4.122247951422,6.35445336385209,0.328559393428812
"United States","Missouri","MO",2020-10-25,2020-10-31,7,2020,"44",6137428,1611,221,1197,414,1390,3.60085690618285,6.74549664778145,0.345864661654135
"United States","Missouri","MO",2020-11-01,2020-11-07,7,2020,"45",6137428,1790,94,1210,580,1696,1.53158619538999,9.45021269495952,0.479338842975207
"United States","Missouri","MO",2020-11-08,2020-11-14,7,2020,"46",6137428,1839,219,1203,636,1620,3.5682699658554,10.362647024128,0.528678304239401
"United States","Missouri","MO",2020-11-15,2020-11-21,7,2020,"47",6137428,1858,180,1200,658,1678,2.9328246294702,10.7211033677299,0.548333333333333
"United States","Missouri","MO",2020-11-22,2020-11-28,7,2020,"48",6137428,1908,269,1212,696,1639,4.38294347404157,11.3402552339514,0.574257425742574
"United States","Missouri","MO",2020-11-29,2020-12-05,7,2020,"49",6137428,1962,360,1231,731,1602,5.86564925894039,11.9105266896817,0.593826157595451
"United States","Missouri","MO",2020-12-06,2020-12-12,7,2020,"50",6137428,2017,329,1249,768,1688,5.36055168386497,12.5133850857395,0.614891913530825
"United States","Missouri","MO",2020-12-13,2020-12-19,7,2020,"51",6137428,1890,427,1276,614,1463,6.95731175990985,10.0041906805261,0.481191222570533
"United States","Missouri","MO",2020-12-20,2020-12-26,7,2020,"52",6137428,1830,357,1302,528,1473,5.81676884844922,8.60295224644591,0.405529953917051
"United States","Missouri","MO",2020-12-27,2021-01-02,7,2020,"53",6137428,1837,249,1323,514,1588,4.0570740707671,8.37484366415378,0.388510959939531
"United States","Missouri","MO",2021-01-03,2021-01-09,7,2021,"1",6137428,1748,401,1343,405,1347,6.53368153565305,6.59885541630794,0.30156366344006
"United States","Missouri","MO",2021-01-10,2021-01-16,7,2021,"2",6137428,1795,306,1372,423,1489,4.98580187009933,6.89213787925496,0.308309037900875
"United States","Missouri","MO",2021-01-17,2021-01-23,7,2021,"3",6137428,1733,291,1408,325,1442,4.74139981764348,5.29537780321007,0.230823863636364
"United States","Missouri","MO",2021-01-24,2021-01-30,7,2021,"4",6137428,1625,207,1387,238,1418,3.37274832389072,3.87784589896615,0.171593366979092
"United States","Missouri","MO",2021-01-31,2021-02-06,7,2021,"5",6137428,1531,394,1398,133,1137,6.41962724450698,2.1670315317752,0.0951359084406296
"United States","Missouri","MO",2021-02-07,2021-02-13,7,2021,"6",6137428,1433,311,1395,38,1122,5.06726922091795,0.619151866221486,0.0272401433691756
"United States","Missouri","MO",2021-02-14,2021-02-20,7,2021,"7",6137428,1523,268,1371,152,1255,4.36665000387785,2.47660746488594,0.110867979576951
"United States","Missouri","MO",2021-02-21,2021-02-27,7,2021,"8",6137428,1410,199,1353,57,1211,3.24240056258094,0.928727799332228,0.042128603104213
"United States","Missouri","MO",2021-02-28,2021-03-06,7,2021,"9",6137428,1377,248,1341,36,1129,4.04078060060338,0.586564925894039,0.0268456375838926
"United States","Missouri","MO",2021-03-07,2021-03-13,7,2021,"10",6137428,1320,149,1339,-19,1171,2.42772705439477,-0.309575933110743,-0.0141896938013443
"United States","Missouri","MO",2021-03-14,2021-03-20,7,2021,"11",6137428,1260,63,1326,-66,1197,1.02648862031457,-1.07536903080574,-0.0497737556561086
"United States","Missouri","MO",2021-03-21,2021-03-27,7,2021,"12",6137428,1400,74,1307,93,1326,1.20571679211552,1.51529272522627,0.0711553175210407
"United States","Missouri","MO",2021-03-28,2021-04-03,7,2021,"13",6137428,1299,61,1274,25,1238,0.993901679987122,0.407336754093083,0.0196232339089482
"United States","Missouri","MO",2021-04-04,2021-04-10,7,2021,"14",6137428,1396,0,1276,120,1396,0,1.9552164196468,0.0940438871473355
"United States","Missouri","MO",2021-04-11,2021-04-17,7,2021,"15",6137428,1307,120,1261,46,1187,1.9552164196468,0.749499627531272,0.0364789849325933
"United States","Missouri","MO",2021-04-18,2021-04-24,7,2021,"16",6137428,1299,60,1255,44,1239,0.977608209823398,0.716912687203825,0.0350597609561754
"United States","Missouri","MO",2021-04-25,2021-05-01,7,2021,"17",6137428,1306,50,1253,53,1256,0.814673508186165,0.863553918677335,0.0422984836392657
"United States","Missouri","MO",2021-05-02,2021-05-08,7,2021,"18",6137428,1230,78,1238,-8,1152,1.27089067277042,-0.130347761309786,-0.00646203554119551
"United States","Missouri","MO",2021-05-09,2021-05-15,7,2021,"19",6137428,1308,36,1221,87,1272,0.586564925894039,1.41753190424393,0.0712530712530712
"United States","Missouri","MO",2021-05-16,2021-05-22,7,2021,"20",6137428,1256,147,1209,47,1109,2.39514011406733,0.765793097694995,0.0388751033912325
"United States","Missouri","MO",2021-05-23,2021-05-29,7,2021,"21",6137428,1210,74,1211,-1,1136,1.20571679211552,-0.0162934701637233,-0.000825763831544202
"United States","Missouri","MO",2021-05-30,2021-06-05,7,2021,"22",6137428,1294,60,1198,96,1234,0.977608209823398,1.56417313571744,0.0801335559265441
"United States","Missouri","MO",2021-06-06,2021-06-12,7,2021,"23",6137428,1283,56,1197,86,1227,0.912434329168505,1.4012384340802,0.0718462823725983
"United States","Missouri","MO",2021-06-13,2021-06-19,7,2021,"24",6137428,1250,34,1202,48,1216,0.553977985566592,0.782086567858719,0.0399334442595674
"United States","Missouri","MO",2021-06-20,2021-06-26,7,2021,"25",6137428,1168,27,1210,-42,1141,0.439923694420529,-0.684325746876379,-0.0347107438016528
"United States","Montana","MT",2019-12-29,2020-01-04,7,2020,"1",1068778,231,0,204,27,231,0,2.52624960468872,0.132352941176471
"United States","Montana","MT",2020-01-05,2020-01-11,7,2020,"2",1068778,211,0,202,9,211,0,0.842083201562906,0.0445544554455446
"United States","Montana","MT",2020-01-12,2020-01-18,7,2020,"3",1068778,202,0,202,0,202,0,0,0
"United States","Montana","MT",2020-01-19,2020-01-25,7,2020,"4",1068778,197,0,202,-5,197,0,-0.467824000868281,-0.0247524752475248
"United States","Montana","MT",2020-01-26,2020-02-01,7,2020,"5",1068778,218,0,201,17,218,0,1.59060160295216,0.0845771144278606
"United States","Montana","MT",2020-02-02,2020-02-08,7,2020,"6",1068778,202,0,203,-1,202,0,-0.0935648001736563,-0.00492610837438423
"United States","Montana","MT",2020-02-09,2020-02-15,7,2020,"7",1068778,198,0,202,-4,198,0,-0.374259200694625,-0.0198019801980198
"United States","Montana","MT",2020-02-16,2020-02-22,7,2020,"8",1068778,217,0,205,12,217,0,1.12277760208388,0.0585365853658537
"United States","Montana","MT",2020-02-23,2020-02-29,7,2020,"9",1068778,236,0,202,34,236,0,3.18120320590431,0.168316831683168
"United States","Montana","MT",2020-03-01,2020-03-07,7,2020,"10",1068778,221,0,197,24,221,0,2.24555520416775,0.121827411167513
"United States","Montana","MT",2020-03-08,2020-03-14,7,2020,"11",1068778,218,0,193,25,218,0,2.33912000434141,0.129533678756477
"United States","Montana","MT",2020-03-15,2020-03-21,7,2020,"12",1068778,229,0,195,34,229,0,3.18120320590431,0.174358974358974
"United States","Montana","MT",2020-03-22,2020-03-28,7,2020,"13",1068778,205,1,191,14,204,0.0935648001736563,1.30990720243119,0.0732984293193717
"United States","Montana","MT",2020-03-29,2020-04-04,7,2020,"14",1068778,177,4,190,-13,173,0.374259200694625,-1.21634240225753,-0.0684210526315789
"United States","Montana","MT",2020-04-05,2020-04-11,7,2020,"15",1068778,216,1,189,27,215,0.0935648001736563,2.52624960468872,0.142857142857143
"United States","Montana","MT",2020-04-12,2020-04-18,7,2020,"16",1068778,191,6,190,1,185,0.561388801041938,0.0935648001736563,0.00526315789473686
"United States","Montana","MT",2020-04-19,2020-04-25,7,2020,"17",1068778,187,4,186,1,183,0.374259200694625,0.0935648001736563,0.0053763440860215
"United States","Montana","MT",2020-04-26,2020-05-02,7,2020,"18",1068778,204,2,185,19,202,0.187129600347313,1.77773120329947,0.102702702702703
"United States","Montana","MT",2020-05-03,2020-05-09,7,2020,"19",1068778,177,0,181,-4,177,0,-0.374259200694625,-0.0220994475138122
"United States","Montana","MT",2020-05-10,2020-05-16,7,2020,"20",1068778,205,0,179,26,205,0,2.43268480451506,0.145251396648045
"United States","Montana","MT",2020-05-17,2020-05-23,7,2020,"21",1068778,181,0,179,2,181,0,0.187129600347313,0.011173184357542
"United States","Montana","MT",2020-05-24,2020-05-30,7,2020,"22",1068778,180,1,183,-3,179,0.0935648001736563,-0.280694400520969,-0.0163934426229508
"United States","Montana","MT",2020-05-31,2020-06-06,7,2020,"23",1068778,178,1,182,-4,177,0.0935648001736563,-0.374259200694625,-0.021978021978022
"United States","Montana","MT",2020-06-07,2020-06-13,7,2020,"24",1068778,223,0,182,41,223,0,3.83615680711991,0.225274725274725
"United States","Montana","MT",2020-06-14,2020-06-20,7,2020,"25",1068778,198,2,179,19,196,0.187129600347313,1.77773120329947,0.106145251396648
"United States","Montana","MT",2020-06-21,2020-06-27,7,2020,"26",1068778,199,2,181,18,197,0.187129600347313,1.68416640312581,0.0994475138121547
"United States","Montana","MT",2020-06-28,2020-07-04,7,2020,"27",1068778,175,1,182,-7,174,0.0935648001736563,-0.654953601215594,-0.0384615384615384
"United States","Montana","MT",2020-07-05,2020-07-11,7,2020,"28",1068778,190,6,185,5,184,0.561388801041938,0.467824000868281,0.027027027027027
"United States","Montana","MT",2020-07-12,2020-07-18,7,2020,"29",1068778,203,8,189,14,195,0.74851840138925,1.30990720243119,0.0740740740740742
"United States","Montana","MT",2020-07-19,2020-07-25,7,2020,"30",1068778,224,9,193,31,215,0.842083201562906,2.90050880538334,0.160621761658031
"United States","Montana","MT",2020-07-26,2020-08-01,7,2020,"31",1068778,216,15,191,25,201,1.40347200260484,2.33912000434141,0.130890052356021
"United States","Montana","MT",2020-08-02,2020-08-08,7,2020,"32",1068778,216,14,193,23,202,1.30990720243119,2.15199040399409,0.119170984455959
"United States","Montana","MT",2020-08-09,2020-08-15,7,2020,"33",1068778,204,7,189,15,197,0.654953601215594,1.40347200260484,0.0793650793650793
"United States","Montana","MT",2020-08-16,2020-08-22,7,2020,"34",1068778,240,8,185,55,232,0.74851840138925,5.14606400955109,0.297297297297297
"United States","Montana","MT",2020-08-23,2020-08-29,7,2020,"35",1068778,195,14,182,13,181,1.30990720243119,1.21634240225753,0.0714285714285714
"United States","Montana","MT",2020-08-30,2020-09-05,7,2020,"36",1068778,233,12,182,51,221,1.12277760208388,4.77180480885647,0.28021978021978
"United States","Montana","MT",2020-09-06,2020-09-12,7,2020,"37",1068778,221,17,178,43,204,1.59060160295216,4.02328640746722,0.241573033707865
"United States","Montana","MT",2020-09-13,2020-09-19,7,2020,"38",1068778,235,23,180,55,212,2.15199040399409,5.14606400955109,0.305555555555556
"United States","Montana","MT",2020-09-20,2020-09-26,7,2020,"39",1068778,236,15,184,52,221,1.40347200260484,4.86536960903013,0.282608695652174
"United States","Montana","MT",2020-09-27,2020-10-03,7,2020,"40",1068778,240,15,184,56,225,1.40347200260484,5.23962880972475,0.304347826086957
"United States","Montana","MT",2020-10-04,2020-10-10,7,2020,"41",1068778,282,23,188,94,259,2.15199040399409,8.79509121632369,0.5
"United States","Montana","MT",2020-10-11,2020-10-17,7,2020,"42",1068778,267,31,190,77,236,2.90050880538334,7.20448961337153,0.405263157894737
"United States","Montana","MT",2020-10-18,2020-10-24,7,2020,"43",1068778,295,54,192,103,241,5.05249920937744,9.63717441788659,0.536458333333333
"United States","Montana","MT",2020-10-25,2020-10-31,7,2020,"44",1068778,317,81,191,126,236,7.57874881406616,11.7891648218807,0.659685863874345
"United States","Montana","MT",2020-11-01,2020-11-07,7,2020,"45",1068778,299,70,191,108,229,6.54953601215594,10.1049984187549,0.56544502617801
"United States","Montana","MT",2020-11-08,2020-11-14,7,2020,"46",1068778,323,66,192,131,257,6.17527681146131,12.256988822749,0.682291666666667
"United States","Montana","MT",2020-11-15,2020-11-21,7,2020,"47",1068778,332,87,193,139,245,8.1401376151081,13.0055072241382,0.72020725388601
"United States","Montana","MT",2020-11-22,2020-11-28,7,2020,"48",1068778,307,71,190,117,236,6.6431008123296,10.9470816203178,0.61578947368421
"United States","Montana","MT",2020-11-29,2020-12-05,7,2020,"49",1068778,270,64,192,78,206,5.988147211114,7.29805441354519,0.40625
"United States","Montana","MT",2020-12-06,2020-12-12,7,2020,"50",1068778,303,83,192,111,220,7.76587841441347,10.3856928192758,0.578125
"United States","Montana","MT",2020-12-13,2020-12-19,7,2020,"51",1068778,271,48,197,74,223,4.4911104083355,6.92379521285056,0.375634517766497
"United States","Montana","MT",2020-12-20,2020-12-26,7,2020,"52",1068778,308,55,200,108,253,5.14606400955109,10.1049984187549,0.54
"United States","Montana","MT",2020-12-27,2021-01-02,7,2020,"53",1068778,274,52,206,68,222,4.86536960903013,6.36240641180863,0.330097087378641
"United States","Montana","MT",2021-01-03,2021-01-09,7,2021,"1",1068778,248,82,208,40,166,7.67231361423981,3.74259200694625,0.192307692307692
"United States","Montana","MT",2021-01-10,2021-01-16,7,2021,"2",1068778,256,35,212,44,221,3.27476800607797,4.11685120764088,0.207547169811321
"United States","Montana","MT",2021-01-17,2021-01-23,7,2021,"3",1068778,250,53,212,38,197,4.95893440920378,3.55546240659894,0.179245283018868
"United States","Montana","MT",2021-01-24,2021-01-30,7,2021,"4",1068778,202,91,215,-13,111,8.51439681580272,-1.21634240225753,-0.0604651162790698
"United States","Montana","MT",2021-01-31,2021-02-06,7,2021,"5",1068778,219,78,218,1,141,7.29805441354519,0.0935648001736563,0.00458715596330284
"United States","Montana","MT",2021-02-07,2021-02-13,7,2021,"6",1068778,225,17,222,3,208,1.59060160295216,0.280694400520969,0.0135135135135136
"United States","Montana","MT",2021-02-14,2021-02-20,7,2021,"7",1068778,213,12,221,-8,201,1.12277760208388,-0.74851840138925,-0.0361990950226244
"United States","Montana","MT",2021-02-21,2021-02-27,7,2021,"8",1068778,227,16,222,5,211,1.4970368027785,0.467824000868281,0.0225225225225225
"United States","Montana","MT",2021-02-28,2021-03-06,7,2021,"9",1068778,191,24,221,-30,167,2.24555520416775,-2.80694400520969,-0.135746606334842
"United States","Montana","MT",2021-03-07,2021-03-13,7,2021,"10",1068778,202,12,217,-15,190,1.12277760208388,-1.40347200260484,-0.0691244239631337
"United States","Montana","MT",2021-03-14,2021-03-20,7,2021,"11",1068778,225,22,213,12,203,2.05842560382044,1.12277760208388,0.056338028169014
"United States","Montana","MT",2021-03-21,2021-03-27,7,2021,"12",1068778,207,22,210,-3,185,2.05842560382044,-0.280694400520969,-0.0142857142857142
"United States","Montana","MT",2021-03-28,2021-04-03,7,2021,"13",1068778,171,29,209,-38,142,2.71337920503603,-3.55546240659894,-0.181818181818182
"United States","Montana","MT",2021-04-04,2021-04-10,7,2021,"14",1068778,207,57,206,1,150,5.33319360989841,0.0935648001736563,0.00485436893203883
"United States","Montana","MT",2021-04-11,2021-04-17,7,2021,"15",1068778,237,22,208,29,215,2.05842560382044,2.71337920503603,0.139423076923077
"United States","Montana","MT",2021-04-18,2021-04-24,7,2021,"16",1068778,209,18,207,2,191,1.68416640312581,0.187129600347313,0.00966183574879231
"United States","Montana","MT",2021-04-25,2021-05-01,7,2021,"17",1068778,227,11,205,22,216,1.02921280191022,2.05842560382044,0.107317073170732
"United States","Montana","MT",2021-05-02,2021-05-08,7,2021,"18",1068778,201,18,201,0,183,1.68416640312581,0,0
"United States","Montana","MT",2021-05-09,2021-05-15,7,2021,"19",1068778,200,6,200,0,194,0.561388801041938,0,0
"United States","Montana","MT",2021-05-16,2021-05-22,7,2021,"20",1068778,227,5,196,31,222,0.467824000868281,2.90050880538334,0.158163265306122
"United States","Montana","MT",2021-05-23,2021-05-29,7,2021,"21",1068778,207,10,198,9,197,0.935648001736563,0.842083201562906,0.0454545454545454
"United States","Montana","MT",2021-05-30,2021-06-05,7,2021,"22",1068778,197,19,196,1,178,1.77773120329947,0.0935648001736563,0.00510204081632648
"United States","Montana","MT",2021-06-06,2021-06-12,7,2021,"23",1068778,222,9,199,23,213,0.842083201562906,2.15199040399409,0.115577889447236
"United States","Montana","MT",2021-06-13,2021-06-19,7,2021,"24",1068778,213,10,200,13,203,0.935648001736563,1.21634240225753,0.0649999999999999
"United States","Montana","MT",2021-06-20,2021-06-26,7,2021,"25",1068778,128,11,203,-75,117,1.02921280191022,-7.01736001302422,-0.369458128078818
"United States","Nebraska","NE",2019-12-29,2020-01-04,7,2020,"1",1934408,346,0,397,-51,346,0,-2.63646552330222,-0.128463476070529
"United States","Nebraska","NE",2020-01-05,2020-01-11,7,2020,"2",1934408,362,0,398,-36,362,0,-1.86103448703686,-0.0904522613065326
"United States","Nebraska","NE",2020-01-12,2020-01-18,7,2020,"3",1934408,333,0,400,-67,333,0,-3.46359196198527,-0.1675
"United States","Nebraska","NE",2020-01-19,2020-01-25,7,2020,"4",1934408,358,0,382,-24,358,0,-1.24068965802457,-0.06282722513089
"United States","Nebraska","NE",2020-01-26,2020-02-01,7,2020,"5",1934408,373,0,376,-3,373,0,-0.155086207253072,-0.00797872340425532
"United States","Nebraska","NE",2020-02-02,2020-02-08,7,2020,"6",1934408,345,0,370,-25,345,0,-1.29238506044226,-0.0675675675675675
"United States","Nebraska","NE",2020-02-09,2020-02-15,7,2020,"7",1934408,327,0,364,-37,327,0,-1.91272988945455,-0.101648351648352
"United States","Nebraska","NE",2020-02-16,2020-02-22,7,2020,"8",1934408,318,0,359,-41,318,0,-2.11951149912531,-0.114206128133705
"United States","Nebraska","NE",2020-02-23,2020-02-29,7,2020,"9",1934408,341,0,360,-19,341,0,-0.982212645936121,-0.0527777777777778
"United States","Nebraska","NE",2020-03-01,2020-03-07,7,2020,"10",1934408,355,0,360,-5,355,0,-0.258477012088453,-0.0138888888888888
"United States","Nebraska","NE",2020-03-08,2020-03-14,7,2020,"11",1934408,343,0,353,-10,343,0,-0.516954024176906,-0.0283286118980169
"United States","Nebraska","NE",2020-03-15,2020-03-21,7,2020,"12",1934408,350,0,356,-6,350,0,-0.310172414506144,-0.0168539325842697
"United States","Nebraska","NE",2020-03-22,2020-03-28,7,2020,"13",1934408,331,2,356,-25,329,0.103390804835381,-1.29238506044226,-0.0702247191011236
"United States","Nebraska","NE",2020-03-29,2020-04-04,7,2020,"14",1934408,310,4,352,-42,306,0.206781609670762,-2.171206901543,-0.119318181818182
"United States","Nebraska","NE",2020-04-05,2020-04-11,7,2020,"15",1934408,343,8,343,0,335,0.413563219341525,0,0
"United States","Nebraska","NE",2020-04-12,2020-04-18,7,2020,"16",1934408,353,0,342,11,353,0,0.568649426594596,0.0321637426900585
"United States","Nebraska","NE",2020-04-19,2020-04-25,7,2020,"17",1934408,353,0,337,16,353,0,0.827126438683049,0.0474777448071217
"United States","Nebraska","NE",2020-04-26,2020-05-02,7,2020,"18",1934408,344,64,333,11,280,3.3085057547322,0.568649426594596,0.0330330330330331
"United States","Nebraska","NE",2020-05-03,2020-05-09,7,2020,"19",1934408,338,18,328,10,320,0.93051724351843,0.516954024176906,0.0304878048780488
"United States","Nebraska","NE",2020-05-10,2020-05-16,7,2020,"20",1934408,352,26,328,24,326,1.34408046285996,1.24068965802457,0.0731707317073171
"United States","Nebraska","NE",2020-05-17,2020-05-23,7,2020,"21",1934408,347,23,325,22,324,1.18899425560688,1.13729885318919,0.0676923076923077
"United States","Nebraska","NE",2020-05-24,2020-05-30,7,2020,"22",1934408,375,21,326,49,354,1.0856034507715,2.53307471846684,0.150306748466258
"United States","Nebraska","NE",2020-05-31,2020-06-06,7,2020,"23",1934408,319,21,323,-4,298,1.0856034507715,-0.206781609670762,-0.0123839009287926
"United States","Nebraska","NE",2020-06-07,2020-06-13,7,2020,"24",1934408,319,29,327,-8,290,1.49916667011303,-0.413563219341525,-0.0244648318042814
"United States","Nebraska","NE",2020-06-14,2020-06-20,7,2020,"25",1934408,371,28,326,45,343,1.44747126769534,2.32629310879608,0.138036809815951
"United States","Nebraska","NE",2020-06-21,2020-06-27,7,2020,"26",1934408,320,23,325,-5,297,1.18899425560688,-0.258477012088453,-0.0153846153846153
"United States","Nebraska","NE",2020-06-28,2020-07-04,7,2020,"27",1934408,308,17,320,-12,291,0.87882184110074,-0.620344829012287,-0.0375
"United States","Nebraska","NE",2020-07-05,2020-07-11,7,2020,"28",1934408,317,1,317,0,316,0.0516954024176906,0,0
"United States","Nebraska","NE",2020-07-12,2020-07-18,7,2020,"29",1934408,325,15,309,16,310,0.775431036265359,0.827126438683049,0.051779935275081
"United States","Nebraska","NE",2020-07-19,2020-07-25,7,2020,"30",1934408,361,17,305,56,344,0.87882184110074,2.89494253539067,0.183606557377049
"United States","Nebraska","NE",2020-07-26,2020-08-01,7,2020,"31",1934408,358,16,302,56,342,0.827126438683049,2.89494253539067,0.185430463576159
"United States","Nebraska","NE",2020-08-02,2020-08-08,7,2020,"32",1934408,381,13,305,76,368,0.672040231429978,3.92885058374448,0.249180327868852
"United States","Nebraska","NE",2020-08-09,2020-08-15,7,2020,"33",1934408,354,16,307,47,338,0.827126438683049,2.42968391363146,0.153094462540717
"United States","Nebraska","NE",2020-08-16,2020-08-22,7,2020,"34",1934408,363,15,309,54,348,0.775431036265359,2.79155173055529,0.174757281553398
"United States","Nebraska","NE",2020-08-23,2020-08-29,7,2020,"35",1934408,323,15,308,15,308,0.775431036265359,0.775431036265359,0.0487012987012987
"United States","Nebraska","NE",2020-08-30,2020-09-05,7,2020,"36",1934408,350,12,314,36,338,0.620344829012287,1.86103448703686,0.114649681528662
"United States","Nebraska","NE",2020-09-06,2020-09-12,7,2020,"37",1934408,339,31,315,24,308,1.60255747494841,1.24068965802457,0.0761904761904761
"United States","Nebraska","NE",2020-09-13,2020-09-19,7,2020,"38",1934408,328,8,314,14,320,0.413563219341525,0.723735633847668,0.0445859872611465
"United States","Nebraska","NE",2020-09-20,2020-09-26,7,2020,"39",1934408,378,27,314,64,351,1.39577586527765,3.3085057547322,0.203821656050955
"United States","Nebraska","NE",2020-09-27,2020-10-03,7,2020,"40",1934408,373,28,312,61,345,1.44747126769534,3.15341954747913,0.19551282051282
"United States","Nebraska","NE",2020-10-04,2020-10-10,7,2020,"41",1934408,406,21,317,89,385,1.0856034507715,4.60089081517446,0.280757097791798
"United States","Nebraska","NE",2020-10-11,2020-10-17,7,2020,"42",1934408,401,29,318,83,372,1.49916667011303,4.29071840066832,0.261006289308176
"United States","Nebraska","NE",2020-10-18,2020-10-24,7,2020,"43",1934408,425,48,322,103,377,2.48137931604915,5.32462644902213,0.319875776397516
"United States","Nebraska","NE",2020-10-25,2020-10-31,7,2020,"44",1934408,442,49,326,116,393,2.53307471846684,5.99666668045211,0.355828220858896
"United States","Nebraska","NE",2020-11-01,2020-11-07,7,2020,"45",1934408,498,56,322,176,442,2.89494253539067,9.09839082551354,0.546583850931677
"United States","Nebraska","NE",2020-11-08,2020-11-14,7,2020,"46",1934408,551,77,320,231,474,3.98054598616217,11.9416379584865,0.721875
"United States","Nebraska","NE",2020-11-15,2020-11-21,7,2020,"47",1934408,574,122,325,249,452,6.30683909495825,12.872155202005,0.766153846153846
"United States","Nebraska","NE",2020-11-22,2020-11-28,7,2020,"48",1934408,565,81,328,237,484,4.18732759583294,12.2518103729927,0.722560975609756
"United States","Nebraska","NE",2020-11-29,2020-12-05,7,2020,"49",1934408,514,211,331,183,303,10.9077299101327,9.46025864243738,0.552870090634441
"United States","Nebraska","NE",2020-12-06,2020-12-12,7,2020,"50",1934408,501,171,339,162,330,8.83991381342509,8.37465519166587,0.47787610619469
"United States","Nebraska","NE",2020-12-13,2020-12-19,7,2020,"51",1934408,460,110,343,117,350,5.68649426594596,6.0483620828698,0.341107871720117
"United States","Nebraska","NE",2020-12-20,2020-12-26,7,2020,"52",1934408,426,81,361,65,345,4.18732759583294,3.36020115714989,0.18005540166205
"United States","Nebraska","NE",2020-12-27,2021-01-02,7,2020,"53",1934408,434,111,367,67,323,5.73818966836365,3.46359196198527,0.182561307901907
"United States","Nebraska","NE",2021-01-03,2021-01-09,7,2021,"1",1934408,447,71,371,76,376,3.67037357165603,3.92885058374448,0.204851752021563
"United States","Nebraska","NE",2021-01-10,2021-01-16,7,2021,"2",1934408,395,87,373,22,308,4.49750001033908,1.13729885318919,0.0589812332439679
"United States","Nebraska","NE",2021-01-17,2021-01-23,7,2021,"3",1934408,412,50,369,43,362,2.58477012088453,2.22290230396069,0.116531165311653
"United States","Nebraska","NE",2021-01-24,2021-01-30,7,2021,"4",1934408,383,40,359,24,343,2.06781609670762,1.24068965802457,0.0668523676880224
"United States","Nebraska","NE",2021-01-31,2021-02-06,7,2021,"5",1934408,369,46,357,12,323,2.37798851121377,0.620344829012287,0.0336134453781514
"United States","Nebraska","NE",2021-02-07,2021-02-13,7,2021,"6",1934408,345,43,355,-10,302,2.22290230396069,-0.516954024176906,-0.028169014084507
"United States","Nebraska","NE",2021-02-14,2021-02-20,7,2021,"7",1934408,332,44,352,-20,288,2.27459770637839,-1.03390804835381,-0.0568181818181818
"United States","Nebraska","NE",2021-02-21,2021-02-27,7,2021,"8",1934408,322,31,353,-31,291,1.60255747494841,-1.60255747494841,-0.0878186968838527
"United States","Nebraska","NE",2021-02-28,2021-03-06,7,2021,"9",1934408,358,31,356,2,327,1.60255747494841,0.103390804835381,0.00561797752808979
"United States","Nebraska","NE",2021-03-07,2021-03-13,7,2021,"10",1934408,322,19,347,-25,303,0.982212645936121,-1.29238506044226,-0.0720461095100865
"United States","Nebraska","NE",2021-03-14,2021-03-20,7,2021,"11",1934408,332,9,347,-15,323,0.465258621759215,-0.775431036265359,-0.0432276657060519
"United States","Nebraska","NE",2021-03-21,2021-03-27,7,2021,"12",1934408,337,38,343,-6,299,1.96442529187224,-0.310172414506144,-0.0174927113702624
"United States","Nebraska","NE",2021-03-28,2021-04-03,7,2021,"13",1934408,333,12,343,-10,321,0.620344829012287,-0.516954024176906,-0.0291545189504373
"United States","Nebraska","NE",2021-04-04,2021-04-10,7,2021,"14",1934408,325,27,337,-12,298,1.39577586527765,-0.620344829012287,-0.0356083086053413
"United States","Nebraska","NE",2021-04-11,2021-04-17,7,2021,"15",1934408,366,-7,332,34,373,-0.361867816923834,1.75764368220148,0.102409638554217
"United States","Nebraska","NE",2021-04-18,2021-04-24,7,2021,"16",1934408,331,29,328,3,302,1.49916667011303,0.155086207253072,0.00914634146341453
"United States","Nebraska","NE",2021-04-25,2021-05-01,7,2021,"17",1934408,372,3,326,46,369,0.155086207253072,2.37798851121377,0.141104294478528
"United States","Nebraska","NE",2021-05-02,2021-05-08,7,2021,"18",1934408,344,7,319,25,337,0.361867816923834,1.29238506044226,0.0783699059561129
"United States","Nebraska","NE",2021-05-09,2021-05-15,7,2021,"19",1934408,375,33,317,58,342,1.70594827978379,2.99833334022605,0.182965299684543
"United States","Nebraska","NE",2021-05-16,2021-05-22,7,2021,"20",1934408,323,-36,316,7,359,-1.86103448703686,0.361867816923834,0.0221518987341771
"United States","Nebraska","NE",2021-05-23,2021-05-29,7,2021,"21",1934408,329,-12,312,17,341,-0.620344829012287,0.87882184110074,0.0544871794871795
"United States","Nebraska","NE",2021-05-30,2021-06-05,7,2021,"22",1934408,304,0,312,-8,304,0,-0.413563219341525,-0.0256410256410257
"United States","Nebraska","NE",2021-06-06,2021-06-12,7,2021,"23",1934408,289,26,313,-24,263,1.34408046285996,-1.24068965802457,-0.0766773162939297
"United States","Nebraska","NE",2021-06-13,2021-06-19,7,2021,"24",1934408,272,3,320,-48,269,0.155086207253072,-2.48137931604915,-0.15
"United States","Nevada","NV",2019-12-29,2020-01-04,7,2020,"1",3080156,521,0,590,-69,521,0,-2.24014627830538,-0.116949152542373
"United States","Nevada","NV",2020-01-05,2020-01-11,7,2020,"2",3080156,556,0,593,-37,556,0,-1.20123785938115,-0.0623946037099494
"United States","Nevada","NV",2020-01-12,2020-01-18,7,2020,"3",3080156,605,0,587,18,605,0,0.584385985644883,0.030664395229983
"United States","Nevada","NV",2020-01-19,2020-01-25,7,2020,"4",3080156,577,0,565,12,577,0,0.389590657096589,0.0212389380530973
"United States","Nevada","NV",2020-01-26,2020-02-01,7,2020,"5",3080156,532,0,558,-26,532,0,-0.844113090375942,-0.046594982078853
"United States","Nevada","NV",2020-02-02,2020-02-08,7,2020,"6",3080156,579,0,550,29,579,0,0.941510754650089,0.0527272727272727
"United States","Nevada","NV",2020-02-09,2020-02-15,7,2020,"7",3080156,530,0,546,-16,530,0,-0.519454209462118,-0.0293040293040293
"United States","Nevada","NV",2020-02-16,2020-02-22,7,2020,"8",3080156,546,0,541,5,546,0,0.162329440456912,0.00924214417744906
"United States","Nevada","NV",2020-02-23,2020-02-29,7,2020,"9",3080156,544,0,548,-4,544,0,-0.12986355236553,-0.00729927007299269
"United States","Nevada","NV",2020-03-01,2020-03-07,7,2020,"10",3080156,535,0,546,-11,535,0,-0.357124769005206,-0.0201465201465202
"United States","Nevada","NV",2020-03-08,2020-03-14,7,2020,"11",3080156,515,0,543,-28,515,0,-0.909044866558707,-0.0515653775322283
"United States","Nevada","NV",2020-03-15,2020-03-21,7,2020,"12",3080156,508,2,538,-30,506,0.0649317761827648,-0.973976642741472,-0.0557620817843866
"United States","Nevada","NV",2020-03-22,2020-03-28,7,2020,"13",3080156,543,12,536,7,531,0.389590657096589,0.227261216639677,0.0130597014925373
"United States","Nevada","NV",2020-03-29,2020-04-04,7,2020,"14",3080156,593,32,525,68,561,1.03890841892424,2.207680390214,0.12952380952381
"United States","Nevada","NV",2020-04-05,2020-04-11,7,2020,"15",3080156,588,56,522,66,532,1.81808973311741,2.14274861403124,0.126436781609195
"United States","Nevada","NV",2020-04-12,2020-04-18,7,2020,"16",3080156,546,66,518,28,480,2.14274861403124,0.909044866558707,0.0540540540540539
"United States","Nevada","NV",2020-04-19,2020-04-25,7,2020,"17",3080156,565,48,510,55,517,1.55836262838635,1.78562384502603,0.107843137254902
"United States","Nevada","NV",2020-04-26,2020-05-02,7,2020,"18",3080156,547,53,507,40,494,1.72069206884327,1.2986355236553,0.0788954635108481
"United States","Nevada","NV",2020-05-03,2020-05-09,7,2020,"19",3080156,544,49,498,46,495,1.59082851647774,1.49343085220359,0.0923694779116466
"United States","Nevada","NV",2020-05-10,2020-05-16,7,2020,"20",3080156,514,44,492,22,470,1.42849907602082,0.714249538010412,0.0447154471544715
"United States","Nevada","NV",2020-05-17,2020-05-23,7,2020,"21",3080156,536,44,494,42,492,1.42849907602082,1.36356729983806,0.0850202429149798
"United States","Nevada","NV",2020-05-24,2020-05-30,7,2020,"22",3080156,543,22,495,48,521,0.714249538010412,1.55836262838635,0.0969696969696969
"United States","Nevada","NV",2020-05-31,2020-06-06,7,2020,"23",3080156,562,25,496,66,537,0.81164720228456,2.14274861403124,0.133064516129032
"United States","Nevada","NV",2020-06-07,2020-06-13,7,2020,"24",3080156,543,9,500,43,534,0.292192992822441,1.39603318792944,0.0860000000000001
"United States","Nevada","NV",2020-06-14,2020-06-20,7,2020,"25",3080156,519,23,503,16,496,0.746715426101795,0.519454209462118,0.0318091451292246
"United States","Nevada","NV",2020-06-21,2020-06-27,7,2020,"26",3080156,557,15,496,61,542,0.486988321370736,1.98041917357433,0.122983870967742
"United States","Nevada","NV",2020-06-28,2020-07-04,7,2020,"27",3080156,528,30,499,29,498,0.973976642741472,0.941510754650089,0.0581162324649298
"United States","Nevada","NV",2020-07-05,2020-07-11,7,2020,"28",3080156,633,59,487,146,574,1.91548739739156,4.74001966134183,0.299794661190965
"United States","Nevada","NV",2020-07-12,2020-07-18,7,2020,"29",3080156,640,57,479,161,583,1.8505556212088,5.22700798271256,0.336116910229645
"United States","Nevada","NV",2020-07-19,2020-07-25,7,2020,"30",3080156,657,86,473,184,571,2.79206637585889,5.97372340881436,0.389006342494715
"United States","Nevada","NV",2020-07-26,2020-08-01,7,2020,"31",3080156,620,100,468,152,520,3.24658880913824,4.93481498989012,0.324786324786325
"United States","Nevada","NV",2020-08-02,2020-08-08,7,2020,"32",3080156,694,117,454,240,577,3.79850890669174,7.79181314193177,0.52863436123348
"United States","Nevada","NV",2020-08-09,2020-08-15,7,2020,"33",3080156,662,120,455,207,542,3.89590657096589,6.72043883491615,0.454945054945055
"United States","Nevada","NV",2020-08-16,2020-08-22,7,2020,"34",3080156,648,128,458,190,520,4.15563367569695,6.16851873736265,0.414847161572052
"United States","Nevada","NV",2020-08-23,2020-08-29,7,2020,"35",3080156,633,105,464,169,528,3.40891824959515,5.48673508744362,0.364224137931034
"United States","Nevada","NV",2020-08-30,2020-09-05,7,2020,"36",3080156,640,86,459,181,554,2.79206637585889,5.87632574454021,0.394335511982571
"United States","Nevada","NV",2020-09-06,2020-09-12,7,2020,"37",3080156,559,61,465,94,498,1.98041917357433,3.05179348058994,0.202150537634409
"United States","Nevada","NV",2020-09-13,2020-09-19,7,2020,"38",3080156,537,79,465,72,458,2.56480515921921,2.33754394257953,0.154838709677419
"United States","Nevada","NV",2020-09-20,2020-09-26,7,2020,"39",3080156,528,54,465,63,474,1.75315795693465,2.04535094975709,0.135483870967742
"United States","Nevada","NV",2020-09-27,2020-10-03,7,2020,"40",3080156,564,38,471,93,526,1.23370374747253,3.01932759249856,0.197452229299363
"United States","Nevada","NV",2020-10-04,2020-10-10,7,2020,"41",3080156,558,39,466,92,519,1.26616963556391,2.98686170440718,0.197424892703863
"United States","Nevada","NV",2020-10-11,2020-10-17,7,2020,"42",3080156,526,48,479,47,478,1.55836262838635,1.52589674029497,0.0981210855949897
"United States","Nevada","NV",2020-10-18,2020-10-24,7,2020,"43",3080156,541,36,479,62,505,1.16877197128977,2.01288506166571,0.129436325678497
"United States","Nevada","NV",2020-10-25,2020-10-31,7,2020,"44",3080156,604,34,470,134,570,1.103840195107,4.35042900424524,0.285106382978723
"United States","Nevada","NV",2020-11-01,2020-11-07,7,2020,"45",3080156,555,71,476,79,484,2.30507805448815,2.56480515921921,0.165966386554622
"United States","Nevada","NV",2020-11-08,2020-11-14,7,2020,"46",3080156,631,57,491,140,574,1.8505556212088,4.54522433279353,0.285132382892057
"United States","Nevada","NV",2020-11-15,2020-11-21,7,2020,"47",3080156,663,102,490,173,561,3.311520585321,5.61659863980915,0.353061224489796
"United States","Nevada","NV",2020-11-22,2020-11-28,7,2020,"48",3080156,744,105,492,252,639,3.40891824959515,8.18140379902836,0.51219512195122
"United States","Nevada","NV",2020-11-29,2020-12-05,7,2020,"49",3080156,773,170,502,271,603,5.51920097553501,8.79825567276463,0.539840637450199
"United States","Nevada","NV",2020-12-06,2020-12-12,7,2020,"50",3080156,908,214,510,398,694,6.94770005155583,12.9214234603702,0.780392156862745
"United States","Nevada","NV",2020-12-13,2020-12-19,7,2020,"51",3080156,845,222,519,326,623,7.20742715628689,10.5838795177907,0.628131021194605
"United States","Nevada","NV",2020-12-20,2020-12-26,7,2020,"52",3080156,867,185,535,332,682,6.00618929690574,10.778674846339,0.620560747663551
"United States","Nevada","NV",2020-12-27,2021-01-02,7,2020,"53",3080156,856,199,558,298,657,6.46071173018509,9.67483465123195,0.53405017921147
"United States","Nevada","NV",2021-01-03,2021-01-09,7,2021,"1",3080156,885,278,561,324,607,9.0255168894043,10.5189477416079,0.577540106951872
"United States","Nevada","NV",2021-01-10,2021-01-16,7,2021,"2",3080156,853,300,568,285,553,9.73976642741471,9.25277810604398,0.501760563380282
"United States","Nevada","NV",2021-01-17,2021-01-23,7,2021,"3",3080156,833,243,568,265,590,7.88921080620592,8.60346034421633,0.466549295774648
"United States","Nevada","NV",2021-01-24,2021-01-30,7,2021,"4",3080156,791,244,553,238,547,7.9216766942973,7.72688136574901,0.430379746835443
"United States","Nevada","NV",2021-01-31,2021-02-06,7,2021,"5",3080156,727,198,540,187,529,6.42824584209371,6.07112107308851,0.346296296296296
"United States","Nevada","NV",2021-02-07,2021-02-13,7,2021,"6",3080156,708,227,545,163,481,7.3697565967438,5.29193975889533,0.29908256880734
"United States","Nevada","NV",2021-02-14,2021-02-20,7,2021,"7",3080156,644,172,534,110,472,5.58413275171777,3.57124769005206,0.205992509363296
"United States","Nevada","NV",2021-02-21,2021-02-27,7,2021,"8",3080156,673,90,527,146,583,2.92192992822441,4.74001966134183,0.277039848197344
"United States","Nevada","NV",2021-02-28,2021-03-06,7,2021,"9",3080156,563,77,539,24,486,2.49987338303644,0.779181314193177,0.0445269016697589
"United States","Nevada","NV",2021-03-07,2021-03-13,7,2021,"10",3080156,612,60,537,75,552,1.94795328548294,2.43494160685368,0.139664804469274
"United States","Nevada","NV",2021-03-14,2021-03-20,7,2021,"11",3080156,600,71,537,63,529,2.30507805448815,2.04535094975709,0.11731843575419
"United States","Nevada","NV",2021-03-21,2021-03-27,7,2021,"12",3080156,556,61,529,27,495,1.98041917357433,0.876578978467324,0.0510396975425331
"United States","Nevada","NV",2021-03-28,2021-04-03,7,2021,"13",3080156,581,38,528,53,543,1.23370374747253,1.72069206884327,0.100378787878788
"United States","Nevada","NV",2021-04-04,2021-04-10,7,2021,"14",3080156,549,171,528,21,378,5.55166686362639,0.68178364991903,0.0397727272727273
"United States","Nevada","NV",2021-04-11,2021-04-17,7,2021,"15",3080156,538,33,528,10,505,1.07137430701562,0.324658880913824,0.018939393939394
"United States","Nevada","NV",2021-04-18,2021-04-24,7,2021,"16",3080156,580,57,525,55,523,1.8505556212088,1.78562384502603,0.104761904761905
"United States","Nevada","NV",2021-04-25,2021-05-01,7,2021,"17",3080156,553,42,516,37,511,1.36356729983806,1.20123785938115,0.0717054263565891
"United States","Nevada","NV",2021-05-02,2021-05-08,7,2021,"18",3080156,583,34,505,78,549,1.103840195107,2.53233927112783,0.154455445544554
"United States","Nevada","NV",2021-05-09,2021-05-15,7,2021,"19",3080156,552,32,503,49,520,1.03890841892424,1.59082851647774,0.0974155069582505
"United States","Nevada","NV",2021-05-16,2021-05-22,7,2021,"20",3080156,507,22,499,8,485,0.714249538010412,0.259727104731059,0.0160320641282565
"United States","Nevada","NV",2021-05-23,2021-05-29,7,2021,"21",3080156,490,34,507,-17,456,1.103840195107,-0.551920097553501,-0.0335305719921104
"United States","Nevada","NV",2021-05-30,2021-06-05,7,2021,"22",3080156,552,14,510,42,538,0.454522433279353,1.36356729983806,0.0823529411764705
"United States","Nevada","NV",2021-06-06,2021-06-12,7,2021,"23",3080156,519,22,515,4,497,0.714249538010412,0.12986355236553,0.00776699029126204
"United States","Nevada","NV",2021-06-13,2021-06-19,7,2021,"24",3080156,511,27,528,-17,484,0.876578978467324,-0.551920097553501,-0.0321969696969697
"United States","Nevada","NV",2021-06-20,2021-06-26,7,2021,"25",3080156,376,18,525,-149,358,0.584385985644883,-4.83741732561598,-0.283809523809524
"United States","New Hampshire","NH",2019-12-29,2020-01-04,7,2020,"1",1359711,260,0,268,-8,260,0,-0.588360320685793,-0.0298507462686567
"United States","New Hampshire","NH",2020-01-05,2020-01-11,7,2020,"2",1359711,263,0,268,-5,263,0,-0.367725200428621,-0.0186567164179104
"United States","New Hampshire","NH",2020-01-12,2020-01-18,7,2020,"3",1359711,245,0,270,-25,245,0,-1.8386260021431,-0.0925925925925926
"United States","New Hampshire","NH",2020-01-19,2020-01-25,7,2020,"4",1359711,241,0,271,-30,241,0,-2.20635120257172,-0.11070110701107
"United States","New Hampshire","NH",2020-01-26,2020-02-01,7,2020,"5",1359711,240,0,270,-30,240,0,-2.20635120257172,-0.111111111111111
"United States","New Hampshire","NH",2020-02-02,2020-02-08,7,2020,"6",1359711,256,0,275,-19,256,0,-1.39735576162876,-0.0690909090909091
"United States","New Hampshire","NH",2020-02-09,2020-02-15,7,2020,"7",1359711,236,0,271,-35,236,0,-2.57407640300034,-0.129151291512915
"United States","New Hampshire","NH",2020-02-16,2020-02-22,7,2020,"8",1359711,277,0,269,8,277,0,0.588360320685793,0.029739776951673
"United States","New Hampshire","NH",2020-02-23,2020-02-29,7,2020,"9",1359711,228,0,262,-34,228,0,-2.50053136291462,-0.129770992366412
"United States","New Hampshire","NH",2020-03-01,2020-03-07,7,2020,"10",1359711,266,0,255,11,266,0,0.808995440942965,0.0431372549019609
"United States","New Hampshire","NH",2020-03-08,2020-03-14,7,2020,"11",1359711,240,0,247,-7,240,0,-0.514815280600069,-0.02834008097166
"United States","New Hampshire","NH",2020-03-15,2020-03-21,7,2020,"12",1359711,252,0,247,5,252,0,0.367725200428621,0.0202429149797572
"United States","New Hampshire","NH",2020-03-22,2020-03-28,7,2020,"13",1359711,258,3,245,13,255,0.220635120257172,0.956085521114413,0.0530612244897959
"United States","New Hampshire","NH",2020-03-29,2020-04-04,7,2020,"14",1359711,248,6,247,1,242,0.441270240514345,0.0735450400857241,0.00404858299595134
"United States","New Hampshire","NH",2020-04-05,2020-04-11,7,2020,"15",1359711,270,14,253,17,256,1.02963056120014,1.25026568145731,0.0671936758893281
"United States","New Hampshire","NH",2020-04-12,2020-04-18,7,2020,"16",1359711,242,15,254,-12,227,1.10317560128586,-0.882540481028689,-0.047244094488189
"United States","New Hampshire","NH",2020-04-19,2020-04-25,7,2020,"17",1359711,274,22,254,20,252,1.61799088188593,1.47090080171448,0.078740157480315
"United States","New Hampshire","NH",2020-04-26,2020-05-02,7,2020,"18",1359711,266,24,254,12,242,1.76508096205738,0.882540481028689,0.0472440944881889
"United States","New Hampshire","NH",2020-05-03,2020-05-09,7,2020,"19",1359711,292,47,251,41,245,3.45661688402903,3.01534664351469,0.163346613545817
"United States","New Hampshire","NH",2020-05-10,2020-05-16,7,2020,"20",1359711,285,40,242,43,245,2.94180160342896,3.16243672368614,0.177685950413223
"United States","New Hampshire","NH",2020-05-17,2020-05-23,7,2020,"21",1359711,268,37,238,30,231,2.72116648317179,2.20635120257172,0.126050420168067
"United States","New Hampshire","NH",2020-05-24,2020-05-30,7,2020,"22",1359711,250,34,235,15,216,2.50053136291462,1.10317560128586,0.0638297872340425
"United States","New Hampshire","NH",2020-05-31,2020-06-06,7,2020,"23",1359711,259,41,232,27,218,3.01534664351469,1.98571608231455,0.116379310344828
"United States","New Hampshire","NH",2020-06-07,2020-06-13,7,2020,"24",1359711,302,35,230,72,267,2.57407640300034,5.29524288617214,0.31304347826087
"United States","New Hampshire","NH",2020-06-14,2020-06-20,7,2020,"25",1359711,238,21,233,5,217,1.54444584180021,0.367725200428621,0.0214592274678111
"United States","New Hampshire","NH",2020-06-21,2020-06-27,7,2020,"26",1359711,250,28,237,13,222,2.05926112240028,0.956085521114413,0.0548523206751055
"United States","New Hampshire","NH",2020-06-28,2020-07-04,7,2020,"27",1359711,247,9,234,13,238,0.661905360771517,0.956085521114413,0.0555555555555556
"United States","New Hampshire","NH",2020-07-05,2020-07-11,7,2020,"28",1359711,249,15,237,12,234,1.10317560128586,0.882540481028689,0.0506329113924051
"United States","New Hampshire","NH",2020-07-12,2020-07-18,7,2020,"29",1359711,231,5,239,-8,226,0.367725200428621,-0.588360320685793,-0.0334728033472803
"United States","New Hampshire","NH",2020-07-19,2020-07-25,7,2020,"30",1359711,266,13,237,29,253,0.956085521114413,2.132806162486,0.122362869198312
"United States","New Hampshire","NH",2020-07-26,2020-08-01,7,2020,"31",1359711,248,7,238,10,241,0.514815280600069,0.735450400857241,0.0420168067226891
"United States","New Hampshire","NH",2020-08-02,2020-08-08,7,2020,"32",1359711,233,3,239,-6,230,0.220635120257172,-0.441270240514345,-0.0251046025104602
"United States","New Hampshire","NH",2020-08-09,2020-08-15,7,2020,"33",1359711,230,4,239,-9,226,0.294180160342896,-0.661905360771517,-0.0376569037656904
"United States","New Hampshire","NH",2020-08-16,2020-08-22,7,2020,"34",1359711,250,6,235,15,244,0.441270240514345,1.10317560128586,0.0638297872340425
"United States","New Hampshire","NH",2020-08-23,2020-08-29,7,2020,"35",1359711,231,3,239,-8,228,0.220635120257172,-0.588360320685793,-0.0334728033472803
"United States","New Hampshire","NH",2020-08-30,2020-09-05,7,2020,"36",1359711,234,0,241,-7,234,0,-0.514815280600069,-0.029045643153527
"United States","New Hampshire","NH",2020-09-06,2020-09-12,7,2020,"37",1359711,228,3,239,-11,225,0.220635120257172,-0.808995440942965,-0.0460251046025104
"United States","New Hampshire","NH",2020-09-13,2020-09-19,7,2020,"38",1359711,226,3,240,-14,223,0.220635120257172,-1.02963056120014,-0.0583333333333333
"United States","New Hampshire","NH",2020-09-20,2020-09-26,7,2020,"39",1359711,273,1,245,28,272,0.0735450400857241,2.05926112240028,0.114285714285714
"United States","New Hampshire","NH",2020-09-27,2020-10-03,7,2020,"40",1359711,222,3,245,-23,219,0.220635120257172,-1.69153592197165,-0.0938775510204082
"United States","New Hampshire","NH",2020-10-04,2020-10-10,7,2020,"41",1359711,255,13,244,11,242,0.956085521114413,0.808995440942965,0.0450819672131149
"United States","New Hampshire","NH",2020-10-11,2020-10-17,7,2020,"42",1359711,253,11,249,4,242,0.808995440942965,0.294180160342896,0.0160642570281124
"United States","New Hampshire","NH",2020-10-18,2020-10-24,7,2020,"43",1359711,234,7,249,-15,227,0.514815280600069,-1.10317560128586,-0.0602409638554217
"United States","New Hampshire","NH",2020-10-25,2020-10-31,7,2020,"44",1359711,257,10,243,14,247,0.735450400857241,1.02963056120014,0.0576131687242798
"United States","New Hampshire","NH",2020-11-01,2020-11-07,7,2020,"45",1359711,263,6,238,25,257,0.441270240514345,1.8386260021431,0.105042016806723
"United States","New Hampshire","NH",2020-11-08,2020-11-14,7,2020,"46",1359711,285,10,240,45,275,0.735450400857241,3.30952680385758,0.1875
"United States","New Hampshire","NH",2020-11-15,2020-11-21,7,2020,"47",1359711,259,9,240,19,250,0.661905360771517,1.39735576162876,0.0791666666666666
"United States","New Hampshire","NH",2020-11-22,2020-11-28,7,2020,"48",1359711,284,6,240,44,278,0.441270240514345,3.23598176377186,0.183333333333333
"United States","New Hampshire","NH",2020-11-29,2020-12-05,7,2020,"49",1359711,313,45,242,71,268,3.30952680385758,5.22169784608641,0.293388429752066
"United States","New Hampshire","NH",2020-12-06,2020-12-12,7,2020,"50",1359711,312,41,250,62,271,3.01534664351469,4.55979248531489,0.248
"United States","New Hampshire","NH",2020-12-13,2020-12-19,7,2020,"51",1359711,288,50,249,39,238,3.6772520042862,2.86825656334324,0.156626506024096
"United States","New Hampshire","NH",2020-12-20,2020-12-26,7,2020,"52",1359711,357,6,248,109,351,0.441270240514345,8.01640936934393,0.439516129032258
"United States","New Hampshire","NH",2020-12-27,2021-01-02,7,2020,"53",1359711,305,113,255,50,192,8.31058952968682,3.6772520042862,0.196078431372549
"United States","New Hampshire","NH",2021-01-03,2021-01-09,7,2021,"1",1359711,323,77,257,66,246,5.66296808660076,4.85397264565779,0.256809338521401
"United States","New Hampshire","NH",2021-01-10,2021-01-16,7,2021,"2",1359711,362,81,256,106,281,5.95714824694365,7.79577424908675,0.4140625
"United States","New Hampshire","NH",2021-01-17,2021-01-23,7,2021,"3",1359711,300,44,259,41,256,3.23598176377186,3.01534664351469,0.158301158301158
"United States","New Hampshire","NH",2021-01-24,2021-01-30,7,2021,"4",1359711,276,71,262,14,205,5.22169784608641,1.02963056120014,0.0534351145038168
"United States","New Hampshire","NH",2021-01-31,2021-02-06,7,2021,"5",1359711,293,56,262,31,237,4.11852224480055,2.27989624265745,0.118320610687023
"United States","New Hampshire","NH",2021-02-07,2021-02-13,7,2021,"6",1359711,261,32,263,-2,229,2.35344128274317,-0.147090080171448,-0.00760456273764254
"United States","New Hampshire","NH",2021-02-14,2021-02-20,7,2021,"7",1359711,268,23,256,12,245,1.69153592197165,0.882540481028689,0.046875
"United States","New Hampshire","NH",2021-02-21,2021-02-27,7,2021,"8",1359711,248,17,258,-10,231,1.25026568145731,-0.735450400857241,-0.0387596899224806
"United States","New Hampshire","NH",2021-02-28,2021-03-06,7,2021,"9",1359711,250,11,250,0,239,0.808995440942965,0,0
"United States","New Hampshire","NH",2021-03-07,2021-03-13,7,2021,"10",1359711,240,14,243,-3,226,1.02963056120014,-0.220635120257172,-0.0123456790123457
"United States","New Hampshire","NH",2021-03-14,2021-03-20,7,2021,"11",1359711,234,22,239,-5,212,1.61799088188593,-0.367725200428621,-0.0209205020920502
"United States","New Hampshire","NH",2021-03-21,2021-03-27,7,2021,"12",1359711,249,14,240,9,235,1.02963056120014,0.661905360771517,0.0375000000000001
"United States","New Hampshire","NH",2021-03-28,2021-04-03,7,2021,"13",1359711,217,16,231,-14,201,1.17672064137159,-1.02963056120014,-0.0606060606060606
"United States","New Hampshire","NH",2021-04-04,2021-04-10,7,2021,"14",1359711,234,9,234,0,225,0.661905360771517,0,0
"United States","New Hampshire","NH",2021-04-11,2021-04-17,7,2021,"15",1359711,228,10,238,-10,218,0.735450400857241,-0.735450400857241,-0.042016806722689
"United States","New Hampshire","NH",2021-04-18,2021-04-24,7,2021,"16",1359711,257,16,235,22,241,1.17672064137159,1.61799088188593,0.0936170212765957
"United States","New Hampshire","NH",2021-04-25,2021-05-01,7,2021,"17",1359711,249,22,235,14,227,1.61799088188593,1.02963056120014,0.0595744680851065
"United States","New Hampshire","NH",2021-05-02,2021-05-08,7,2021,"18",1359711,248,10,236,12,238,0.735450400857241,0.882540481028689,0.0508474576271187
"United States","New Hampshire","NH",2021-05-09,2021-05-15,7,2021,"19",1359711,235,20,229,6,215,1.47090080171448,0.441270240514345,0.0262008733624455
"United States","New Hampshire","NH",2021-05-16,2021-05-22,7,2021,"20",1359711,276,13,223,53,263,0.956085521114413,3.89788712454338,0.237668161434978
"United States","New Hampshire","NH",2021-05-23,2021-05-29,7,2021,"21",1359711,233,8,217,16,225,0.588360320685793,1.17672064137159,0.0737327188940091
"United States","New Hampshire","NH",2021-05-30,2021-06-05,7,2021,"22",1359711,250,3,221,29,247,0.220635120257172,2.132806162486,0.131221719457014
"United States","New Hampshire","NH",2021-06-06,2021-06-12,7,2021,"23",1359711,261,5,219,42,256,0.367725200428621,3.08889168360041,0.191780821917808
"United States","New Hampshire","NH",2021-06-13,2021-06-19,7,2021,"24",1359711,239,7,218,21,232,0.514815280600069,1.54444584180021,0.0963302752293578
"United States","New Hampshire","NH",2021-06-20,2021-06-26,7,2021,"25",1359711,228,4,221,7,224,0.294180160342896,0.514815280600069,0.0316742081447965
"United States","New Jersey","NJ",2019-12-29,2020-01-04,7,2020,"1",8882190,1628,0,1621,7,1628,0,0.0788093927285951,0.0043183220234424
"United States","New Jersey","NJ",2020-01-05,2020-01-11,7,2020,"2",8882190,1588,0,1648,-60,1588,0,-0.675509080530815,-0.0364077669902912
"United States","New Jersey","NJ",2020-01-12,2020-01-18,7,2020,"3",8882190,1490,0,1656,-166,1490,0,-1.86890845613525,-0.10024154589372
"United States","New Jersey","NJ",2020-01-19,2020-01-25,7,2020,"4",8882190,1579,0,1656,-77,1579,0,-0.866903320014546,-0.0464975845410628
"United States","New Jersey","NJ",2020-01-26,2020-02-01,7,2020,"5",8882190,1517,0,1642,-125,1517,0,-1.4073105844392,-0.0761266747868453
"United States","New Jersey","NJ",2020-02-02,2020-02-08,7,2020,"6",8882190,1495,0,1628,-133,1495,0,-1.49737846184331,-0.0816953316953317
"United States","New Jersey","NJ",2020-02-09,2020-02-15,7,2020,"7",8882190,1488,0,1606,-118,1488,0,-1.3285011917106,-0.0734744707347447
"United States","New Jersey","NJ",2020-02-16,2020-02-22,7,2020,"8",8882190,1494,0,1591,-97,1494,0,-1.09207301352482,-0.0609679446888749
"United States","New Jersey","NJ",2020-02-23,2020-02-29,7,2020,"9",8882190,1571,0,1559,12,1571,0,0.135101816106163,0.00769724182168052
"United States","New Jersey","NJ",2020-03-01,2020-03-07,7,2020,"10",8882190,1509,0,1553,-44,1509,0,-0.495373325722598,-0.0283322601416613
"United States","New Jersey","NJ",2020-03-08,2020-03-14,7,2020,"11",8882190,1477,1,1546,-69,1476,0.0112584846755136,-0.776835442610437,-0.0446313065976714
"United States","New Jersey","NJ",2020-03-15,2020-03-21,7,2020,"12",8882190,1600,15,1526,74,1585,0.168877270132704,0.833127865988005,0.0484927916120577
"United States","New Jersey","NJ",2020-03-22,2020-03-28,7,2020,"13",8882190,2124,124,1522,602,2000,1.39605209976368,6.77760777465918,0.395532194480946
"United States","New Jersey","NJ",2020-03-29,2020-04-04,7,2020,"14",8882190,3484,697,1503,1981,2787,7.84716381883297,22.3030581421924,1.31803060545576
"United States","New Jersey","NJ",2020-04-05,2020-04-11,7,2020,"15",8882190,4774,1346,1480,3294,3428,15.1539203732413,37.0854485211417,2.22567567567568
"United States","New Jersey","NJ",2020-04-12,2020-04-18,7,2020,"16",8882190,4733,1888,1474,3259,2845,21.2560190673696,36.6914015574988,2.21099050203528
"United States","New Jersey","NJ",2020-04-19,2020-04-25,7,2020,"17",8882190,3979,1795,1450,2529,2184,20.2089799925469,28.4727077443739,1.74413793103448
"United States","New Jersey","NJ",2020-04-26,2020-05-02,7,2020,"18",8882190,3181,1876,1429,1752,1305,21.1209172512635,19.7248651514998,1.2260321903429
"United States","New Jersey","NJ",2020-05-03,2020-05-09,7,2020,"19",8882190,2603,1373,1415,1188,1230,15.4578994594802,13.3750797945101,0.839575971731449
"United States","New Jersey","NJ",2020-05-10,2020-05-16,7,2020,"20",8882190,2287,1134,1400,887,1153,12.7671216220324,9.98627590718055,0.633571428571429
"United States","New Jersey","NJ",2020-05-17,2020-05-23,7,2020,"21",8882190,1937,831,1384,553,1106,9.35580076535179,6.22594202555901,0.399566473988439
"United States","New Jersey","NJ",2020-05-24,2020-05-30,7,2020,"22",8882190,1746,553,1387,359,1193,6.22594202555901,4.04179599850938,0.258832011535689
"United States","New Jersey","NJ",2020-05-31,2020-06-06,7,2020,"23",8882190,1587,472,1392,195,1115,5.31400476684241,2.19540451172515,0.140086206896552
"United States","New Jersey","NJ",2020-06-07,2020-06-13,7,2020,"24",8882190,1486,482,1381,105,1004,5.42658961359755,1.18214089092893,0.0760318609703114
"United States","New Jersey","NJ",2020-06-14,2020-06-20,7,2020,"25",8882190,1411,269,1388,23,1142,3.02853237771315,0.258945147536812,0.0165706051873198
"United States","New Jersey","NJ",2020-06-21,2020-06-27,7,2020,"26",8882190,1445,2092,1382,63,-647,23.5527499411744,0.709284534557356,0.0455861070911723
"United States","New Jersey","NJ",2020-06-28,2020-07-04,7,2020,"27",8882190,1407,241,1377,30,1166,2.71329480679877,0.337754540265408,0.0217864923747277
"United States","New Jersey","NJ",2020-07-05,2020-07-11,7,2020,"28",8882190,1389,336,1373,16,1053,3.78285085097256,0.180135754808217,0.0116533139111434
"United States","New Jersey","NJ",2020-07-12,2020-07-18,7,2020,"29",8882190,1324,174,1365,-41,1150,1.95897633353936,-0.461597871696057,-0.03003663003663
"United States","New Jersey","NJ",2020-07-19,2020-07-25,7,2020,"30",8882190,1370,77,1351,19,1293,0.866903320014546,0.213911208834758,0.0140636565507031
"United States","New Jersey","NJ",2020-07-26,2020-08-01,7,2020,"31",8882190,1391,54,1353,38,1337,0.607958172477734,0.427822417669516,0.0280857354028086
"United States","New Jersey","NJ",2020-08-02,2020-08-08,7,2020,"32",8882190,1344,39,1338,6,1305,0.43908090234503,0.0675509080530815,0.00448430493273544
"United States","New Jersey","NJ",2020-08-09,2020-08-15,7,2020,"33",8882190,1308,41,1343,-35,1267,0.461597871696057,-0.394046963642975,-0.0260610573343262
"United States","New Jersey","NJ",2020-08-16,2020-08-22,7,2020,"34",8882190,1341,33,1352,-11,1308,0.371529994291948,-0.123843331430649,-0.00813609467455623
"United States","New Jersey","NJ",2020-08-23,2020-08-29,7,2020,"35",8882190,1335,-10,1347,-12,1345,-0.112584846755136,-0.135101816106163,-0.00890868596881955
"United States","New Jersey","NJ",2020-08-30,2020-09-05,7,2020,"36",8882190,1397,52,1351,46,1345,0.585441203126706,0.517890295073625,0.0340488527017024
"United States","New Jersey","NJ",2020-09-06,2020-09-12,7,2020,"37",8882190,1389,42,1343,46,1347,0.472856356371571,0.517890295073625,0.0342516753536857
"United States","New Jersey","NJ",2020-09-13,2020-09-19,7,2020,"38",8882190,1378,37,1341,37,1341,0.416563932994003,0.416563932994003,0.0275913497390008
"United States","New Jersey","NJ",2020-09-20,2020-09-26,7,2020,"39",8882190,1395,39,1335,60,1356,0.43908090234503,0.675509080530815,0.0449438202247192
"United States","New Jersey","NJ",2020-09-27,2020-10-03,7,2020,"40",8882190,1330,32,1339,-9,1298,0.360271509616435,-0.101326362079622,-0.00672143390589997
"United States","New Jersey","NJ",2020-10-04,2020-10-10,7,2020,"41",8882190,1401,36,1355,46,1365,0.405305448318489,0.517890295073625,0.0339483394833948
"United States","New Jersey","NJ",2020-10-11,2020-10-17,7,2020,"42",8882190,1341,33,1367,-26,1308,0.371529994291948,-0.292720601563353,-0.0190197512801755
"United States","New Jersey","NJ",2020-10-18,2020-10-24,7,2020,"43",8882190,1470,77,1363,107,1393,0.866903320014546,1.20465786027995,0.0785033015407191
"United States","New Jersey","NJ",2020-10-25,2020-10-31,7,2020,"44",8882190,1434,67,1372,62,1367,0.75431847325941,0.698026049881842,0.0451895043731778
"United States","New Jersey","NJ",2020-11-01,2020-11-07,7,2020,"45",8882190,1567,77,1393,174,1490,0.866903320014546,1.95897633353936,0.124910265613783
"United States","New Jersey","NJ",2020-11-08,2020-11-14,7,2020,"46",8882190,1632,123,1408,224,1509,1.38479361508817,2.52190056731504,0.159090909090909
"United States","New Jersey","NJ",2020-11-15,2020-11-21,7,2020,"47",8882190,1676,198,1421,255,1478,2.22917996575169,2.87091359225596,0.17945109078114
"United States","New Jersey","NJ",2020-11-22,2020-11-28,7,2020,"48",8882190,1697,219,1440,257,1478,2.46560814393747,2.89343056160699,0.178472222222222
"United States","New Jersey","NJ",2020-11-29,2020-12-05,7,2020,"49",8882190,1904,339,1456,448,1565,3.8166263049991,5.04380113463009,0.307692307692308
"United States","New Jersey","NJ",2020-12-06,2020-12-12,7,2020,"50",8882190,2026,427,1469,557,1599,4.8073729564443,6.27097596426107,0.379169503063308
"United States","New Jersey","NJ",2020-12-13,2020-12-19,7,2020,"51",8882190,2094,442,1488,606,1652,4.976250226577,6.82264171336123,0.407258064516129
"United States","New Jersey","NJ",2020-12-20,2020-12-26,7,2020,"52",8882190,2064,438,1500,564,1626,4.93121628787495,6.34978535698966,0.376
"United States","New Jersey","NJ",2020-12-27,2021-01-02,7,2020,"53",8882190,2215,576,1523,692,1639,6.48488717309582,7.7908713954554,0.454366382140512
"United States","New Jersey","NJ",2021-01-03,2021-01-09,7,2021,"1",8882190,2054,667,1547,507,1387,7.50940927856756,5.70805173048539,0.327731092436975
"United States","New Jersey","NJ",2021-01-10,2021-01-16,7,2021,"2",8882190,2174,560,1568,606,1614,6.30475141828761,6.82264171336123,0.386479591836735
"United States","New Jersey","NJ",2021-01-17,2021-01-23,7,2021,"3",8882190,2003,520,1588,415,1483,5.85441203126706,4.67227114033814,0.261335012594458
"United States","New Jersey","NJ",2021-01-24,2021-01-30,7,2021,"4",8882190,2019,521,1593,426,1498,5.86567051594258,4.79611447176879,0.267419962335216
"United States","New Jersey","NJ",2021-01-31,2021-02-06,7,2021,"5",8882190,2042,509,1592,450,1533,5.73056869983641,5.06631810398111,0.282663316582915
"United States","New Jersey","NJ",2021-02-07,2021-02-13,7,2021,"6",8882190,1876,476,1587,289,1400,5.35903870554447,3.25370207122343,0.182104599873976
"United States","New Jersey","NJ",2021-02-14,2021-02-20,7,2021,"7",8882190,1832,395,1565,267,1437,4.44710144682787,3.00601540836213,0.170607028753994
"United States","New Jersey","NJ",2021-02-21,2021-02-27,7,2021,"8",8882190,1807,404,1543,264,1403,4.54842780890749,2.97223995433559,0.171095268956578
"United States","New Jersey","NJ",2021-02-28,2021-03-06,7,2021,"9",8882190,1724,318,1525,199,1406,3.58019812681332,2.2404384504272,0.130491803278689
"United States","New Jersey","NJ",2021-03-07,2021-03-13,7,2021,"10",8882190,1595,331,1498,97,1264,3.726558427595,1.09207301352482,0.0647530040053406
"United States","New Jersey","NJ",2021-03-14,2021-03-20,7,2021,"11",8882190,1683,246,1476,207,1437,2.76958723017634,2.33050632783131,0.140243902439024
"United States","New Jersey","NJ",2021-03-21,2021-03-27,7,2021,"12",8882190,1630,248,1465,165,1382,2.79210419952737,1.85764997145974,0.112627986348123
"United States","New Jersey","NJ",2021-03-28,2021-04-03,7,2021,"13",8882190,1597,255,1455,142,1342,2.87091359225596,1.59870482392293,0.0975945017182132
"United States","New Jersey","NJ",2021-04-04,2021-04-10,7,2021,"14",8882190,1682,222,1442,240,1460,2.49938359796402,2.70203632212326,0.166435506241331
"United States","New Jersey","NJ",2021-04-11,2021-04-17,7,2021,"15",8882190,1590,275,1423,167,1315,3.09608328576624,1.88016694081077,0.117357695010541
"United States","New Jersey","NJ",2021-04-18,2021-04-24,7,2021,"16",8882190,1667,233,1409,258,1434,2.62322692939467,2.9046890462825,0.183108587650816
"United States","New Jersey","NJ",2021-04-25,2021-05-01,7,2021,"17",8882190,1650,221,1394,256,1429,2.4881251132885,2.88217207693148,0.18364418938307
"United States","New Jersey","NJ",2021-05-02,2021-05-08,7,2021,"18",8882190,1480,203,1385,95,1277,2.28547238912926,1.06955604417379,0.0685920577617329
"United States","New Jersey","NJ",2021-05-09,2021-05-15,7,2021,"19",8882190,1494,161,1382,112,1333,1.81261603275769,1.26095028365752,0.081041968162084
"United States","New Jersey","NJ",2021-05-16,2021-05-22,7,2021,"20",8882190,1494,132,1377,117,1362,1.48611997716779,1.31724270703509,0.0849673202614378
"United States","New Jersey","NJ",2021-05-23,2021-05-29,7,2021,"21",8882190,1353,75,1371,-18,1278,0.844386350663519,-0.202652724159244,-0.013129102844639
"United States","New Jersey","NJ",2021-05-30,2021-06-05,7,2021,"22",8882190,1427,0,1367,60,1427,0,0.675509080530815,0.0438917337234821
"United States","New Jersey","NJ",2021-06-06,2021-06-12,7,2021,"23",8882190,1319,0,1368,-49,1319,0,-0.551665749100166,-0.0358187134502924
"United States","New Jersey","NJ",2021-06-13,2021-06-19,7,2021,"24",8882190,1389,198,1371,18,1191,2.22917996575169,0.202652724159244,0.013129102844639
"United States","New Jersey","NJ",2021-06-20,2021-06-26,7,2021,"25",8882190,1296,53,1380,-84,1243,0.59669968780222,-0.945712712743141,-0.0608695652173913
"United States","New Mexico","NM",2019-12-29,2020-01-04,7,2020,"1",2096829,408,0,393,15,408,0,0.715365916820113,0.0381679389312977
"United States","New Mexico","NM",2020-01-05,2020-01-11,7,2020,"2",2096829,410,0,393,17,410,0,0.810748039062794,0.0432569974554708
"United States","New Mexico","NM",2020-01-12,2020-01-18,7,2020,"3",2096829,388,0,394,-6,388,0,-0.286146366728045,-0.0152284263959391
"United States","New Mexico","NM",2020-01-19,2020-01-25,7,2020,"4",2096829,404,0,397,7,404,0,0.333837427849386,0.0176322418136021
"United States","New Mexico","NM",2020-01-26,2020-02-01,7,2020,"5",2096829,370,0,392,-22,370,0,-1.0492033446695,-0.0561224489795918
"United States","New Mexico","NM",2020-02-02,2020-02-08,7,2020,"6",2096829,377,0,397,-20,377,0,-0.953821222426817,-0.0503778337531486
"United States","New Mexico","NM",2020-02-09,2020-02-15,7,2020,"7",2096829,382,0,394,-12,382,0,-0.57229273345609,-0.0304568527918782
"United States","New Mexico","NM",2020-02-16,2020-02-22,7,2020,"8",2096829,391,0,400,-9,391,0,-0.429219550092068,-0.0225
"United States","New Mexico","NM",2020-02-23,2020-02-29,7,2020,"9",2096829,396,0,396,0,396,0,0,0
"United States","New Mexico","NM",2020-03-01,2020-03-07,7,2020,"10",2096829,400,0,399,1,400,0,0.0476910611213408,0.00250626566416035
"United States","New Mexico","NM",2020-03-08,2020-03-14,7,2020,"11",2096829,342,0,394,-52,342,0,-2.47993517830972,-0.131979695431472
"United States","New Mexico","NM",2020-03-15,2020-03-21,7,2020,"12",2096829,390,0,388,2,390,0,0.0953821222426817,0.00515463917525771
"United States","New Mexico","NM",2020-03-22,2020-03-28,7,2020,"13",2096829,365,2,392,-27,363,0.0953821222426817,-1.2876586502762,-0.0688775510204082
"United States","New Mexico","NM",2020-03-29,2020-04-04,7,2020,"14",2096829,399,9,387,12,390,0.429219550092068,0.57229273345609,0.0310077519379846
"United States","New Mexico","NM",2020-04-05,2020-04-11,7,2020,"15",2096829,411,9,380,31,402,0.429219550092068,1.47842289476157,0.081578947368421
"United States","New Mexico","NM",2020-04-12,2020-04-18,7,2020,"16",2096829,422,33,378,44,389,1.57380501700425,2.098406689339,0.116402116402117
"United States","New Mexico","NM",2020-04-19,2020-04-25,7,2020,"17",2096829,407,40,382,25,367,1.90764244485363,1.19227652803352,0.0654450261780104
"United States","New Mexico","NM",2020-04-26,2020-05-02,7,2020,"18",2096829,420,45,371,49,375,2.14609775046034,2.3368619949457,0.132075471698113
"United States","New Mexico","NM",2020-05-03,2020-05-09,7,2020,"19",2096829,442,53,368,74,389,2.52762623943106,3.52913852297922,0.201086956521739
"United States","New Mexico","NM",2020-05-10,2020-05-16,7,2020,"20",2096829,474,62,362,112,412,2.95684578952313,5.34139884559017,0.30939226519337
"United States","New Mexico","NM",2020-05-17,2020-05-23,7,2020,"21",2096829,396,55,366,30,341,2.62300836167375,1.43073183364023,0.0819672131147542
"United States","New Mexico","NM",2020-05-24,2020-05-30,7,2020,"22",2096829,433,43,361,72,390,2.05071562821766,3.43375640073654,0.199445983379501
"United States","New Mexico","NM",2020-05-31,2020-06-06,7,2020,"23",2096829,448,41,358,90,407,1.95533350597497,4.29219550092068,0.251396648044693
"United States","New Mexico","NM",2020-06-07,2020-06-13,7,2020,"24",2096829,445,39,354,91,406,1.85995138373229,4.33988656204202,0.257062146892655
"United States","New Mexico","NM",2020-06-14,2020-06-20,7,2020,"25",2096829,417,35,356,61,382,1.66918713924693,2.90915472840179,0.171348314606742
"United States","New Mexico","NM",2020-06-21,2020-06-27,7,2020,"26",2096829,399,25,347,52,374,1.19227652803352,2.47993517830972,0.14985590778098
"United States","New Mexico","NM",2020-06-28,2020-07-04,7,2020,"27",2096829,448,22,345,103,426,1.0492033446695,4.91217929549811,0.298550724637681
"United States","New Mexico","NM",2020-07-05,2020-07-11,7,2020,"28",2096829,408,30,345,63,378,1.43073183364023,3.00453685064447,0.182608695652174
"United States","New Mexico","NM",2020-07-12,2020-07-18,7,2020,"29",2096829,402,26,342,60,376,1.23996758915486,2.86146366728045,0.175438596491228
"United States","New Mexico","NM",2020-07-19,2020-07-25,7,2020,"30",2096829,435,38,343,92,397,1.81226032261095,4.38757762316336,0.268221574344023
"United States","New Mexico","NM",2020-07-26,2020-08-01,7,2020,"31",2096829,407,44,344,63,363,2.098406689339,3.00453685064447,0.183139534883721
"United States","New Mexico","NM",2020-08-02,2020-08-08,7,2020,"32",2096829,433,30,343,90,403,1.43073183364023,4.29219550092068,0.262390670553936
"United States","New Mexico","NM",2020-08-09,2020-08-15,7,2020,"33",2096829,394,30,340,54,364,1.43073183364023,2.57531730055241,0.158823529411765
"United States","New Mexico","NM",2020-08-16,2020-08-22,7,2020,"34",2096829,411,32,348,63,379,1.52611395588291,3.00453685064447,0.181034482758621
"United States","New Mexico","NM",2020-08-23,2020-08-29,7,2020,"35",2096829,397,26,344,53,371,1.23996758915486,2.52762623943106,0.154069767441861
"United States","New Mexico","NM",2020-08-30,2020-09-05,7,2020,"36",2096829,376,31,352,24,345,1.47842289476157,1.14458546691218,0.0681818181818181
"United States","New Mexico","NM",2020-09-06,2020-09-12,7,2020,"37",2096829,400,21,347,53,379,1.00151228354816,2.52762623943106,0.152737752161383
"United States","New Mexico","NM",2020-09-13,2020-09-19,7,2020,"38",2096829,398,26,348,50,372,1.23996758915486,2.38455305606704,0.14367816091954
"United States","New Mexico","NM",2020-09-20,2020-09-26,7,2020,"39",2096829,399,23,347,52,376,1.09689440579084,2.47993517830972,0.14985590778098
"United States","New Mexico","NM",2020-09-27,2020-10-03,7,2020,"40",2096829,388,20,346,42,368,0.953821222426817,2.00302456709632,0.121387283236994
"United States","New Mexico","NM",2020-10-04,2020-10-10,7,2020,"41",2096829,389,17,351,38,372,0.810748039062794,1.81226032261095,0.108262108262108
"United States","New Mexico","NM",2020-10-11,2020-10-17,7,2020,"42",2096829,406,22,361,45,384,1.0492033446695,2.14609775046034,0.124653739612188
"United States","New Mexico","NM",2020-10-18,2020-10-24,7,2020,"43",2096829,434,36,362,72,398,1.71687820036827,3.43375640073654,0.198895027624309
"United States","New Mexico","NM",2020-10-25,2020-10-31,7,2020,"44",2096829,460,53,362,98,407,2.52762623943106,4.6737239898914,0.270718232044199
"United States","New Mexico","NM",2020-11-01,2020-11-07,7,2020,"45",2096829,519,86,360,159,433,4.10143125643531,7.58287871829319,0.441666666666667
"United States","New Mexico","NM",2020-11-08,2020-11-14,7,2020,"46",2096829,577,104,353,224,473,4.95987035661945,10.6827976911803,0.634560906515581
"United States","New Mexico","NM",2020-11-15,2020-11-21,7,2020,"47",2096829,587,142,355,232,445,6.7721306792304,11.0643261801511,0.653521126760563
"United States","New Mexico","NM",2020-11-22,2020-11-28,7,2020,"48",2096829,601,177,364,237,424,8.44131781847733,11.3027814857578,0.651098901098901
"United States","New Mexico","NM",2020-11-29,2020-12-05,7,2020,"49",2096829,662,211,358,304,451,10.0628138966029,14.4980825808876,0.849162011173184
"United States","New Mexico","NM",2020-12-06,2020-12-12,7,2020,"50",2096829,687,175,369,318,512,8.34593569623465,15.1657574365864,0.861788617886179
"United States","New Mexico","NM",2020-12-13,2020-12-19,7,2020,"51",2096829,662,242,379,283,420,11.5412367913645,13.4965702973395,0.746701846965699
"United States","New Mexico","NM",2020-12-20,2020-12-26,7,2020,"52",2096829,625,161,380,245,464,7.67826084053588,11.6843099747285,0.644736842105263
"United States","New Mexico","NM",2020-12-27,2021-01-02,7,2020,"53",2096829,606,218,388,218,388,10.3966513244523,10.3966513244523,0.561855670103093
"United States","New Mexico","NM",2021-01-03,2021-01-09,7,2021,"1",2096829,582,198,409,173,384,9.44283010202549,8.25055357399197,0.422982885085575
"United States","New Mexico","NM",2021-01-10,2021-01-16,7,2021,"2",2096829,540,177,409,131,363,8.44131781847733,6.24752900689565,0.320293398533007
"United States","New Mexico","NM",2021-01-17,2021-01-23,7,2021,"3",2096829,539,206,408,131,333,9.82435859099621,6.24752900689565,0.321078431372549
"United States","New Mexico","NM",2021-01-24,2021-01-30,7,2021,"4",2096829,490,150,404,86,340,7.15365916820113,4.10143125643531,0.212871287128713
"United States","New Mexico","NM",2021-01-31,2021-02-06,7,2021,"5",2096829,473,121,400,73,352,5.77061839568224,3.48144746185788,0.1825
"United States","New Mexico","NM",2021-02-07,2021-02-13,7,2021,"6",2096829,474,130,403,71,344,6.19983794577431,3.3860653396152,0.176178660049628
"United States","New Mexico","NM",2021-02-14,2021-02-20,7,2021,"7",2096829,443,94,399,44,349,4.48295974540604,2.098406689339,0.110275689223058
"United States","New Mexico","NM",2021-02-21,2021-02-27,7,2021,"8",2096829,467,90,405,62,377,4.29219550092068,2.95684578952313,0.153086419753086
"United States","New Mexico","NM",2021-02-28,2021-03-06,7,2021,"9",2096829,454,97,403,51,357,4.62603292877006,2.43224411718838,0.126550868486352
"United States","New Mexico","NM",2021-03-07,2021-03-13,7,2021,"10",2096829,411,54,403,8,357,2.57531730055241,0.381528488970727,0.0198511166253101
"United States","New Mexico","NM",2021-03-14,2021-03-20,7,2021,"11",2096829,453,38,396,57,415,1.81226032261095,2.71839048391643,0.143939393939394
"United States","New Mexico","NM",2021-03-21,2021-03-27,7,2021,"12",2096829,444,36,395,49,408,1.71687820036827,2.3368619949457,0.124050632911392
"United States","New Mexico","NM",2021-03-28,2021-04-03,7,2021,"13",2096829,439,24,390,49,415,1.14458546691218,2.3368619949457,0.125641025641026
"United States","New Mexico","NM",2021-04-04,2021-04-10,7,2021,"14",2096829,422,27,385,37,395,1.2876586502762,1.76456926148961,0.096103896103896
"United States","New Mexico","NM",2021-04-11,2021-04-17,7,2021,"15",2096829,434,25,385,49,409,1.19227652803352,2.3368619949457,0.127272727272727
"United States","New Mexico","NM",2021-04-18,2021-04-24,7,2021,"16",2096829,412,23,387,25,389,1.09689440579084,1.19227652803352,0.0645994832041343
"United States","New Mexico","NM",2021-04-25,2021-05-01,7,2021,"17",2096829,386,43,383,3,343,2.05071562821766,0.143073183364023,0.00783289817232369
"United States","New Mexico","NM",2021-05-02,2021-05-08,7,2021,"18",2096829,411,31,377,34,380,1.47842289476157,1.62149607812559,0.090185676392573
"United States","New Mexico","NM",2021-05-09,2021-05-15,7,2021,"19",2096829,437,15,369,68,422,0.715365916820113,3.24299215625118,0.184281842818428
"United States","New Mexico","NM",2021-05-16,2021-05-22,7,2021,"20",2096829,411,18,368,43,393,0.858439100184135,2.05071562821766,0.116847826086957
"United States","New Mexico","NM",2021-05-23,2021-05-29,7,2021,"21",2096829,407,132,368,39,275,6.29522006801699,1.85995138373229,0.105978260869565
"United States","New Mexico","NM",2021-05-30,2021-06-05,7,2021,"22",2096829,393,17,367,26,376,0.810748039062794,1.23996758915486,0.0708446866485013
"United States","New Mexico","NM",2021-06-06,2021-06-12,7,2021,"23",2096829,338,17,368,-30,321,0.810748039062794,-1.43073183364023,-0.0815217391304348
"United States","New Mexico","NM",2021-06-13,2021-06-19,7,2021,"24",2096829,348,19,371,-23,329,0.906130161305476,-1.09689440579084,-0.0619946091644205
"United States","New Mexico","NM",2021-06-20,2021-06-26,7,2021,"25",2096829,253,19,374,-121,234,0.906130161305476,-5.77061839568224,-0.323529411764706
"United States","New York","NY",2019-12-29,2020-01-04,7,2020,"1",19453561,3319,0,3380,-61,3319,0,-0.313567269252144,-0.0180473372781065
"United States","New York","NY",2020-01-05,2020-01-11,7,2020,"2",19453561,3229,0,3405,-176,3229,0,-0.904718678497988,-0.0516886930983848
"United States","New York","NY",2020-01-12,2020-01-18,7,2020,"3",19453561,3298,0,3417,-119,3298,0,-0.611713197393526,-0.0348258706467661
"United States","New York","NY",2020-01-19,2020-01-25,7,2020,"4",19453561,3205,0,3400,-195,3205,0,-1.00238717219948,-0.0573529411764706
"United States","New York","NY",2020-01-26,2020-02-01,7,2020,"5",19453561,3202,0,3362,-160,3202,0,-0.822471525907262,-0.0475907198096371
"United States","New York","NY",2020-02-02,2020-02-08,7,2020,"6",19453561,3231,0,3308,-77,3231,0,-0.39581442184287,-0.0232769044740024
"United States","New York","NY",2020-02-09,2020-02-15,7,2020,"7",19453561,3120,0,3258,-138,3120,0,-0.709381691095013,-0.0423572744014733
"United States","New York","NY",2020-02-16,2020-02-22,7,2020,"8",19453561,3129,0,3239,-110,3129,0,-0.565449174061243,-0.0339610991046619
"United States","New York","NY",2020-02-23,2020-02-29,7,2020,"9",19453561,3271,0,3186,85,3271,0,0.436937998138233,0.0266792215944758
"United States","New York","NY",2020-03-01,2020-03-07,7,2020,"10",19453561,3185,0,3160,25,3185,0,0.12851117592301,0.00791139240506333
"United States","New York","NY",2020-03-08,2020-03-14,7,2020,"11",19453561,3117,3,3131,-14,3114,0.0154213411107612,-0.0719662585168854,-0.00447141488342384
"United States","New York","NY",2020-03-15,2020-03-21,7,2020,"12",19453561,3535,75,3089,446,3460,0.385533527769029,2.29263937846649,0.144383295564908
"United States","New York","NY",2020-03-22,2020-03-28,7,2020,"13",19453561,5350,914,3066,2284,4436,4.69836859174523,11.7407810323262,0.744944553163731
"United States","New York","NY",2020-03-29,2020-04-04,7,2020,"14",19453561,10070,3532,3055,7015,6538,18.1560589344028,36.0602359639965,2.2962356792144
"United States","New York","NY",2020-04-05,2020-04-11,7,2020,"15",19453561,12529,6588,3032,9497,5941,33.8652650792315,48.8188255096329,3.13225593667546
"United States","New York","NY",2020-04-12,2020-04-18,7,2020,"16",19453561,10365,5117,3013,7352,5248,26.3036674879216,37.7925666154387,2.44009293063392
"United States","New York","NY",2020-04-19,2020-04-25,7,2020,"17",19453561,7794,5242,2985,4809,2552,26.9462233675367,24.7204098005501,1.61105527638191
"United States","New York","NY",2020-04-26,2020-05-02,7,2020,"18",19453561,5976,2513,2951,3025,3463,12.9179434037809,15.5498522866842,1.02507624534056
"United States","New York","NY",2020-05-03,2020-05-09,7,2020,"19",19453561,4851,2737,2909,1942,2114,14.0694035400511,9.98274814569939,0.667583361980062
"United States","New York","NY",2020-05-10,2020-05-16,7,2020,"20",19453561,4111,1246,2904,1207,2865,6.4049970080028,6.20451957356291,0.415633608815427
"United States","New York","NY",2020-05-17,2020-05-23,7,2020,"21",19453561,3556,920,2859,697,2636,4.72921127396676,3.58289158473351,0.243791535501924
"United States","New York","NY",2020-05-24,2020-05-30,7,2020,"22",19453561,3281,671,2840,441,2610,3.44923996177358,2.26693714328189,0.155281690140845
"United States","New York","NY",2020-05-31,2020-06-06,7,2020,"23",19453561,3088,550,2875,213,2538,2.82724587030621,1.09491521886404,0.074086956521739
"United States","New York","NY",2020-06-07,2020-06-13,7,2020,"24",19453561,2996,428,2850,146,2568,2.20011133180193,0.750505267390376,0.0512280701754386
"United States","New York","NY",2020-06-14,2020-06-20,7,2020,"25",19453561,2891,303,2853,38,2588,1.55755545218688,0.195336987402975,0.0133193130038556
"United States","New York","NY",2020-06-21,2020-06-27,7,2020,"26",19453561,3004,266,2870,134,2738,1.36735891182082,0.688819902947332,0.0466898954703834
"United States","New York","NY",2020-06-28,2020-07-04,7,2020,"27",19453561,2883,751,2851,32,2132,3.86047572472721,0.164494305181452,0.0112241318835495
"United States","New York","NY",2020-07-05,2020-07-11,7,2020,"28",19453561,2920,153,2816,104,2767,0.786488396648819,0.53460649183972,0.0369318181818181
"United States","New York","NY",2020-07-12,2020-07-18,7,2020,"29",19453561,2818,157,2799,19,2661,0.807050184796501,0.0976684937014873,0.00678813862093608
"United States","New York","NY",2020-07-19,2020-07-25,7,2020,"30",19453561,2834,129,2779,55,2705,0.66311766776273,0.282724587030621,0.0197912918315941
"United States","New York","NY",2020-07-26,2020-08-01,7,2020,"31",19453561,2871,95,2756,115,2776,0.488342468507437,0.591151409245844,0.0417271407837445
"United States","New York","NY",2020-08-02,2020-08-08,7,2020,"32",19453561,2841,60,2769,72,2781,0.308426822215223,0.370112186658268,0.0260021668472372
"United States","New York","NY",2020-08-09,2020-08-15,7,2020,"33",19453561,2811,67,2760,51,2744,0.344409951473666,0.26216279888294,0.0184782608695653
"United States","New York","NY",2020-08-16,2020-08-22,7,2020,"34",19453561,2841,53,2763,78,2788,0.272443692956781,0.40095486887979,0.0282301845819761
"United States","New York","NY",2020-08-23,2020-08-29,7,2020,"35",19453561,2810,58,2761,49,2752,0.298145928141382,0.251881904809099,0.0177471930459978
"United States","New York","NY",2020-08-30,2020-09-05,7,2020,"36",19453561,2768,57,2763,5,2711,0.293005481104462,0.0257022351846019,0.00180962721679334
"United States","New York","NY",2020-09-06,2020-09-12,7,2020,"37",19453561,2757,46,2764,-7,2711,0.236460563698338,-0.0359831292584427,-0.00253256150506509
"United States","New York","NY",2020-09-13,2020-09-19,7,2020,"38",19453561,2886,54,2792,94,2832,0.277584139993701,0.483202021470516,0.0336676217765044
"United States","New York","NY",2020-09-20,2020-09-26,7,2020,"39",19453561,3080,34,2825,255,3046,0.174775199255293,1.3108139944147,0.0902654867256638
"United States","New York","NY",2020-09-27,2020-10-03,7,2020,"40",19453561,2951,80,2859,92,2871,0.411235762953631,0.472921127396676,0.0321790835956628
"United States","New York","NY",2020-10-04,2020-10-10,7,2020,"41",19453561,3108,83,2903,205,3025,0.426657104064392,1.05379164256868,0.0706166035136067
"United States","New York","NY",2020-10-11,2020-10-17,7,2020,"42",19453561,2985,85,2927,58,2900,0.436937998138233,0.298145928141382,0.0198155107618723
"United States","New York","NY",2020-10-18,2020-10-24,7,2020,"43",19453561,2939,81,2952,-13,2858,0.416376209990551,-0.066825811479965,-0.00440379403794033
"United States","New York","NY",2020-10-25,2020-10-31,7,2020,"44",19453561,3076,116,2962,114,2960,0.596291856282765,0.586010962208924,0.0384875084402432
"United States","New York","NY",2020-11-01,2020-11-07,7,2020,"45",19453561,3317,134,2978,339,3183,0.688819902947332,1.74261154551601,0.113834788448623
"United States","New York","NY",2020-11-08,2020-11-14,7,2020,"46",19453561,3158,192,2986,172,2966,0.986965831088714,0.884156890350307,0.057602143335566
"United States","New York","NY",2020-11-15,2020-11-21,7,2020,"47",19453561,3288,230,3009,279,3058,1.18230281849169,1.43418472330079,0.0927218344965104
"United States","New York","NY",2020-11-22,2020-11-28,7,2020,"48",19453561,3375,338,3029,346,3037,1.73747109847909,1.77859467477445,0.114229118520964
"United States","New York","NY",2020-11-29,2020-12-05,7,2020,"49",19453561,3569,461,3069,500,3108,2.3697460840203,2.57022351846019,0.162919517758227
"United States","New York","NY",2020-12-06,2020-12-12,7,2020,"50",19453561,3872,591,3090,782,3281,3.03800419881995,4.01982958287174,0.253074433656958
"United States","New York","NY",2020-12-13,2020-12-19,7,2020,"51",19453561,4118,827,3143,975,3291,4.25114969953316,5.01193586099738,0.31021317212854
"United States","New York","NY",2020-12-20,2020-12-26,7,2020,"52",19453561,4358,657,3173,1185,3701,3.37727370325669,6.09142973875066,0.373463599117554
"United States","New York","NY",2020-12-27,2021-01-02,7,2020,"53",19453561,4339,1315,3237,1102,3024,6.75968785355031,5.66477263468627,0.340438677788075
"United States","New York","NY",2021-01-03,2021-01-09,7,2021,"1",19453561,4549,1190,3281,1268,3359,6.11713197393526,6.51808684281505,0.386467540384029
"United States","New York","NY",2021-01-10,2021-01-16,7,2021,"2",19453561,4692,1341,3303,1389,3351,6.89333947651024,7.14008093428242,0.420526793823797
"United States","New York","NY",2021-01-17,2021-01-23,7,2021,"3",19453561,4565,1322,3297,1268,3243,6.79567098280875,6.51808684281505,0.384592053381862
"United States","New York","NY",2021-01-24,2021-01-30,7,2021,"4",19453561,4468,1311,3306,1162,3157,6.73912606540263,5.97319945690149,0.351482153660012
"United States","New York","NY",2021-01-31,2021-02-06,7,2021,"5",19453561,4417,1217,3286,1131,3200,6.25592404393211,5.81384559875696,0.34418746195983
"United States","New York","NY",2021-02-07,2021-02-13,7,2021,"6",19453561,4153,1090,3238,915,3063,5.60308727024322,4.70350903878215,0.282581840642372
"United States","New York","NY",2021-02-14,2021-02-20,7,2021,"7",19453561,4037,942,3233,804,3095,4.842301108779,4.13291941768399,0.248685431487782
"United States","New York","NY",2021-02-21,2021-02-27,7,2021,"8",19453561,3927,832,3204,723,3095,4.27685193471776,3.71654320769344,0.225655430711611
"United States","New York","NY",2021-02-28,2021-03-06,7,2021,"9",19453561,3664,646,3167,497,3018,3.32072878585057,2.55480217734943,0.156930849384275
"United States","New York","NY",2021-03-07,2021-03-13,7,2021,"10",19453561,3620,679,3132,488,2941,3.49036353806894,2.50853815401715,0.15581098339719
"United States","New York","NY",2021-03-14,2021-03-20,7,2021,"11",19453561,3504,469,3096,408,3035,2.41086966031566,2.09730239106352,0.131782945736434
"United States","New York","NY",2021-03-21,2021-03-27,7,2021,"12",19453561,3587,675,3041,546,2912,3.46980174992126,2.80668408215853,0.179546201907267
"United States","New York","NY",2021-03-28,2021-04-03,7,2021,"13",19453561,3405,468,3016,389,2937,2.40572921327874,1.99963389736203,0.128978779840849
"United States","New York","NY",2021-04-04,2021-04-10,7,2021,"14",19453561,3470,479,3001,469,2991,2.46227413068487,2.41086966031566,0.156281239586804
"United States","New York","NY",2021-04-11,2021-04-17,7,2021,"15",19453561,3221,535,2972,249,2686,2.75013916475241,1.27997131219318,0.0837819650067295
"United States","New York","NY",2021-04-18,2021-04-24,7,2021,"16",19453561,3328,346,2951,377,2982,1.77859467477445,1.93794853291899,0.127753303964758
"United States","New York","NY",2021-04-25,2021-05-01,7,2021,"17",19453561,3226,314,2918,308,2912,1.614100369593,1.58325768737148,0.105551747772447
"United States","New York","NY",2021-05-02,2021-05-08,7,2021,"18",19453561,3125,131,2894,231,2994,0.673398561836571,1.18744326552861,0.0798203178991015
"United States","New York","NY",2021-05-09,2021-05-15,7,2021,"19",19453561,3132,503,2863,269,2629,2.58564485957095,1.38278025293158,0.0939573873559203
"United States","New York","NY",2021-05-16,2021-05-22,7,2021,"20",19453561,3230,200,2833,397,3030,1.02808940738408,2.04075747365739,0.140134133427462
"United States","New York","NY",2021-05-23,2021-05-29,7,2021,"21",19453561,2969,178,2824,145,2791,0.914999572571829,0.745364820353456,0.0513456090651558
"United States","New York","NY",2021-05-30,2021-06-05,7,2021,"22",19453561,3067,137,2827,240,2930,0.704241244058093,1.23370728886089,0.0848956490979837
"United States","New York","NY",2021-06-06,2021-06-12,7,2021,"23",19453561,2882,107,2829,53,2775,0.550027832950481,0.272443692956781,0.0187345351714387
"United States","New York","NY",2021-06-13,2021-06-19,7,2021,"24",19453561,2903,78,2850,53,2825,0.40095486887979,0.272443692956781,0.0185964912280703
"United States","New York","NY",2021-06-20,2021-06-26,7,2021,"25",19453561,2762,39,2856,-94,2723,0.200477434439895,-0.483202021470516,-0.0329131652661064
"United States","North Carolina","NC",2019-12-29,2020-01-04,7,2020,"1",10488084,2003,0,2071,-68,2003,0,-0.64835483773776,-0.0328343795267987
"United States","North Carolina","NC",2020-01-05,2020-01-11,7,2020,"2",10488084,1984,0,2096,-112,1984,0,-1.06787855627396,-0.0534351145038168
"United States","North Carolina","NC",2020-01-12,2020-01-18,7,2020,"3",10488084,1902,0,2099,-197,1902,0,-1.87832210344616,-0.0938542162934731
"United States","North Carolina","NC",2020-01-19,2020-01-25,7,2020,"4",10488084,1994,0,2083,-89,1994,0,-0.848582067039127,-0.042726836293807
"United States","North Carolina","NC",2020-01-26,2020-02-01,7,2020,"5",10488084,1983,0,2074,-91,1983,0,-0.867651326972591,-0.0438765670202508
"United States","North Carolina","NC",2020-02-02,2020-02-08,7,2020,"6",10488084,2053,0,2063,-10,2053,0,-0.0953462996673177,-0.00484730974309255
"United States","North Carolina","NC",2020-02-09,2020-02-15,7,2020,"7",10488084,2060,0,2043,17,2060,0,0.16208870943444,0.00832109642682322
"United States","North Carolina","NC",2020-02-16,2020-02-22,7,2020,"8",10488084,1925,0,2038,-113,1925,0,-1.07741318624069,-0.0554465161923454
"United States","North Carolina","NC",2020-02-23,2020-02-29,7,2020,"9",10488084,1972,0,2013,-41,1972,0,-0.390919828636002,-0.020367610531545
"United States","North Carolina","NC",2020-03-01,2020-03-07,7,2020,"10",10488084,2032,0,1985,47,2032,0,0.448127608436393,0.0236775818639798
"United States","North Carolina","NC",2020-03-08,2020-03-14,7,2020,"11",10488084,2025,0,1989,36,2025,0,0.343246678802344,0.0180995475113122
"United States","North Carolina","NC",2020-03-15,2020-03-21,7,2020,"12",10488084,2052,0,1988,64,2052,0,0.610216317870833,0.0321931589537223
"United States","North Carolina","NC",2020-03-22,2020-03-28,7,2020,"13",10488084,1877,4,1963,-86,1873,0.0381385198669271,-0.819978177138932,-0.04381049414162
"United States","North Carolina","NC",2020-03-29,2020-04-04,7,2020,"14",10488084,2024,20,1921,103,2004,0.190692599334635,0.982066886573372,0.0536179073399272
"United States","North Carolina","NC",2020-04-05,2020-04-11,7,2020,"15",10488084,2016,55,1889,127,1961,0.524404648170247,1.21089800577493,0.0672313393329804
"United States","North Carolina","NC",2020-04-12,2020-04-18,7,2020,"16",10488084,2029,84,1869,160,1945,0.800908917205469,1.52554079467708,0.0856072766185125
"United States","North Carolina","NC",2020-04-19,2020-04-25,7,2020,"17",10488084,2104,125,1848,256,1979,1.19182874584147,2.44086527148333,0.138528138528139
"United States","North Carolina","NC",2020-04-26,2020-05-02,7,2020,"18",10488084,1948,131,1822,126,1817,1.24903652564186,1.2013633758082,0.0691547749725576
"United States","North Carolina","NC",2020-05-03,2020-05-09,7,2020,"19",10488084,2059,123,1804,255,1936,1.17275948590801,2.4313306415166,0.141352549889135
"United States","North Carolina","NC",2020-05-10,2020-05-16,7,2020,"20",10488084,2039,105,1810,229,1934,1.00113614650684,2.18343026238158,0.126519337016575
"United States","North Carolina","NC",2020-05-17,2020-05-23,7,2020,"21",10488084,2061,84,1805,256,1977,0.800908917205469,2.44086527148333,0.141828254847645
"United States","North Carolina","NC",2020-05-24,2020-05-30,7,2020,"22",10488084,1990,144,1797,193,1846,1.37298671520937,1.84018358357923,0.10740122426266
"United States","North Carolina","NC",2020-05-31,2020-06-06,7,2020,"23",10488084,1967,115,1798,169,1852,1.09648244617415,1.61135246437767,0.0939933259176864
"United States","North Carolina","NC",2020-06-07,2020-06-13,7,2020,"24",10488084,1878,114,1780,98,1764,1.08694781620742,0.934393736739713,0.0550561797752809
"United States","North Carolina","NC",2020-06-14,2020-06-20,7,2020,"25",10488084,1938,108,1791,147,1830,1.02974003640703,1.40159060510957,0.0820770519262981
"United States","North Carolina","NC",2020-06-21,2020-06-27,7,2020,"26",10488084,1946,106,1788,158,1840,1.01067077647357,1.50647153474362,0.0883668903803132
"United States","North Carolina","NC",2020-06-28,2020-07-04,7,2020,"27",10488084,2001,77,1771,230,1924,0.734166507438346,2.19296489234831,0.12987012987013
"United States","North Carolina","NC",2020-07-05,2020-07-11,7,2020,"28",10488084,1979,98,1763,216,1881,0.934393736739713,2.05948007281406,0.122518434486671
"United States","North Carolina","NC",2020-07-12,2020-07-18,7,2020,"29",10488084,2027,136,1748,279,1891,1.29670967547552,2.66016176071816,0.159610983981693
"United States","North Carolina","NC",2020-07-19,2020-07-25,7,2020,"30",10488084,2147,149,1729,418,1998,1.42065986504303,3.98547532609388,0.241758241758242
"United States","North Carolina","NC",2020-07-26,2020-08-01,7,2020,"31",10488084,2085,186,1707,378,1899,1.77344117381211,3.60409012742461,0.221441124780316
"United States","North Carolina","NC",2020-08-02,2020-08-08,7,2020,"32",10488084,2061,196,1705,356,1865,1.86878747347943,3.39432826815651,0.208797653958944
"United States","North Carolina","NC",2020-08-09,2020-08-15,7,2020,"33",10488084,2160,183,1703,457,1977,1.74483728391191,4.35732589479642,0.268349970640047
"United States","North Carolina","NC",2020-08-16,2020-08-22,7,2020,"34",10488084,2123,178,1719,404,1945,1.69716413407825,3.85199050655963,0.235020360674811
"United States","North Carolina","NC",2020-08-23,2020-08-29,7,2020,"35",10488084,2070,162,1725,345,1908,1.54461005461055,3.28944733852246,0.2
"United States","North Carolina","NC",2020-08-30,2020-09-05,7,2020,"36",10488084,2167,206,1722,445,1961,1.96413377314674,4.24291033519564,0.258420441347271
"United States","North Carolina","NC",2020-09-06,2020-09-12,7,2020,"37",10488084,2124,158,1732,392,1966,1.50647153474362,3.73757494695885,0.226327944572748
"United States","North Carolina","NC",2020-09-13,2020-09-19,7,2020,"38",10488084,2261,188,1740,521,2073,1.79251043374557,4.96754221266725,0.299425287356322
"United States","North Carolina","NC",2020-09-20,2020-09-26,7,2020,"39",10488084,2072,205,1739,333,1867,1.95459914318001,3.17503177892168,0.191489361702128
"United States","North Carolina","NC",2020-09-27,2020-10-03,7,2020,"40",10488084,2036,189,1767,269,1847,1.8020450637123,2.56481546105085,0.152235427277872
"United States","North Carolina","NC",2020-10-04,2020-10-10,7,2020,"41",10488084,2115,136,1767,348,1979,1.29670967547552,3.31805122842266,0.196943972835314
"United States","North Carolina","NC",2020-10-11,2020-10-17,7,2020,"42",10488084,2130,164,1783,347,1966,1.56367931454401,3.30851659845592,0.194615816040381
"United States","North Carolina","NC",2020-10-18,2020-10-24,7,2020,"43",10488084,2130,63,1802,328,2067,0.600681687904101,3.12735862908802,0.182019977802442
"United States","North Carolina","NC",2020-10-25,2020-10-31,7,2020,"44",10488084,2159,175,1812,347,1984,1.66856024417806,3.30851659845592,0.191501103752759
"United States","North Carolina","NC",2020-11-01,2020-11-07,7,2020,"45",10488084,2381,381,1832,549,2000,3.6326940173248,5.23451185173574,0.299672489082969
"United States","North Carolina","NC",2020-11-08,2020-11-14,7,2020,"46",10488084,2230,171,1847,383,2059,1.63042172431113,3.65176327725827,0.20736329182458
"United States","North Carolina","NC",2020-11-15,2020-11-21,7,2020,"47",10488084,2170,286,1859,311,1884,2.72690417048529,2.96526991965358,0.167294244217321
"United States","North Carolina","NC",2020-11-22,2020-11-28,7,2020,"48",10488084,2316,133,1874,442,2183,1.26810578557533,4.21430644529544,0.235859124866596
"United States","North Carolina","NC",2020-11-29,2020-12-05,7,2020,"49",10488084,2376,377,1910,466,1999,3.59455549745788,4.443137564497,0.243979057591623
"United States","North Carolina","NC",2020-12-06,2020-12-12,7,2020,"50",10488084,2458,278,1933,525,2180,2.65062713075143,5.00568073253418,0.271598551474392
"United States","North Carolina","NC",2020-12-13,2020-12-19,7,2020,"51",10488084,2587,389,1961,626,2198,3.70897105705866,5.96867835917409,0.319224885262621
"United States","North Carolina","NC",2020-12-20,2020-12-26,7,2020,"52",10488084,2670,42,1991,679,2628,0.400454458602734,6.47401374741087,0.341034655951783
"United States","North Carolina","NC",2020-12-27,2021-01-02,7,2020,"53",10488084,2831,667,2022,809,2164,6.35959818781009,7.713515643086,0.400098911968348
"United States","North Carolina","NC",2021-01-03,2021-01-09,7,2021,"1",10488084,2904,534,2027,877,2370,5.09149240223476,8.36187048082376,0.432659102121362
"United States","North Carolina","NC",2021-01-10,2021-01-16,7,2021,"2",10488084,2928,590,2047,881,2338,5.62543168037174,8.40000900069069,0.43038593063019
"United States","North Carolina","NC",2021-01-17,2021-01-23,7,2021,"3",10488084,2809,570,2064,745,2239,5.43473908103711,7.10329932521517,0.360949612403101
"United States","North Carolina","NC",2021-01-24,2021-01-30,7,2021,"4",10488084,2790,702,2061,729,2088,6.6933102366457,6.95074524574746,0.353711790393013
"United States","North Dakota","ND",2019-12-29,2020-01-04,7,2020,"1",762062,149,0,145,4,149,0,0.524891675480473,0.0275862068965518
"United States","North Dakota","ND",2020-01-05,2020-01-11,7,2020,"2",762062,151,0,148,3,151,0,0.393668756610355,0.0202702702702702
"United States","North Dakota","ND",2020-01-12,2020-01-18,7,2020,"3",762062,171,0,151,20,171,0,2.62445837740236,0.132450331125828
"United States","North Dakota","ND",2020-01-19,2020-01-25,7,2020,"4",762062,147,0,149,-2,147,0,-0.262445837740236,-0.0134228187919463
"United States","North Dakota","ND",2020-01-26,2020-02-01,7,2020,"5",762062,130,0,146,-16,130,0,-2.09956670192189,-0.10958904109589
"United States","North Dakota","ND",2020-02-02,2020-02-08,7,2020,"6",762062,138,0,147,-9,138,0,-1.18100626983106,-0.0612244897959183
"United States","North Dakota","ND",2020-02-09,2020-02-15,7,2020,"7",762062,148,0,144,4,148,0,0.524891675480473,0.0277777777777777
"United States","North Dakota","ND",2020-02-16,2020-02-22,7,2020,"8",762062,176,0,146,30,176,0,3.93668756610354,0.205479452054794
"United States","North Dakota","ND",2020-02-23,2020-02-29,7,2020,"9",762062,152,0,147,5,152,0,0.656114594350591,0.0340136054421769
"United States","North Dakota","ND",2020-03-01,2020-03-07,7,2020,"10",762062,171,0,148,23,171,0,3.01812713401272,0.155405405405405
"United States","North Dakota","ND",2020-03-08,2020-03-14,7,2020,"11",762062,148,0,143,5,148,0,0.656114594350591,0.034965034965035
"United States","North Dakota","ND",2020-03-15,2020-03-21,7,2020,"12",762062,150,0,143,7,150,0,0.918560432090827,0.048951048951049
"United States","North Dakota","ND",2020-03-22,2020-03-28,7,2020,"13",762062,119,1,141,-22,118,0.131222918870118,-2.8869042151426,-0.156028368794326
"United States","North Dakota","ND",2020-03-29,2020-04-04,7,2020,"14",762062,140,2,141,-1,138,0.262445837740236,-0.131222918870118,-0.00709219858156029
"United States","North Dakota","ND",2020-04-05,2020-04-11,7,2020,"15",762062,158,4,141,17,154,0.524891675480473,2.23078962079201,0.120567375886525
"United States","North Dakota","ND",2020-04-12,2020-04-18,7,2020,"16",762062,157,2,137,20,155,0.262445837740236,2.62445837740236,0.145985401459854
"United States","North Dakota","ND",2020-04-19,2020-04-25,7,2020,"17",762062,158,7,135,23,151,0.918560432090827,3.01812713401272,0.17037037037037
"United States","North Dakota","ND",2020-04-26,2020-05-02,7,2020,"18",762062,148,8,135,13,140,1.04978335096095,1.70589794531154,0.0962962962962963
"United States","North Dakota","ND",2020-05-03,2020-05-09,7,2020,"19",762062,141,10,133,8,131,1.31222918870118,1.04978335096095,0.0601503759398496
"United States","North Dakota","ND",2020-05-10,2020-05-16,7,2020,"20",762062,153,8,132,21,145,1.04978335096095,2.75568129627248,0.159090909090909
"United States","North Dakota","ND",2020-05-17,2020-05-23,7,2020,"21",762062,140,10,131,9,130,1.31222918870118,1.18100626983106,0.0687022900763359
"United States","North Dakota","ND",2020-05-24,2020-05-30,7,2020,"22",762062,143,7,133,10,136,0.918560432090827,1.31222918870118,0.0751879699248121
"United States","North Dakota","ND",2020-05-31,2020-06-06,7,2020,"23",762062,161,13,132,29,148,1.70589794531154,3.80546464723343,0.21969696969697
"United States","North Dakota","ND",2020-06-07,2020-06-13,7,2020,"24",762062,143,2,131,12,141,0.262445837740236,1.57467502644142,0.0916030534351144
"United States","North Dakota","ND",2020-06-14,2020-06-20,7,2020,"25",762062,142,2,130,12,140,0.262445837740236,1.57467502644142,0.0923076923076922
"United States","North Dakota","ND",2020-06-21,2020-06-27,7,2020,"26",762062,131,2,130,1,129,0.262445837740236,0.131222918870118,0.00769230769230766
"United States","North Dakota","ND",2020-06-28,2020-07-04,7,2020,"27",762062,117,2,126,-9,115,0.262445837740236,-1.18100626983106,-0.0714285714285714
"United States","North Dakota","ND",2020-07-05,2020-07-11,7,2020,"28",762062,135,7,127,8,128,0.918560432090827,1.04978335096095,0.0629921259842521
"United States","North Dakota","ND",2020-07-12,2020-07-18,7,2020,"29",762062,134,3,127,7,131,0.393668756610355,0.918560432090827,0.0551181102362204
"United States","North Dakota","ND",2020-07-19,2020-07-25,7,2020,"30",762062,132,9,125,7,123,1.18100626983106,0.918560432090827,0.056
"United States","North Dakota","ND",2020-07-26,2020-08-01,7,2020,"31",762062,139,4,125,14,135,0.524891675480473,1.83712086418165,0.112
"United States","North Dakota","ND",2020-08-02,2020-08-08,7,2020,"32",762062,154,9,126,28,145,1.18100626983106,3.67424172836331,0.222222222222222
"United States","North Dakota","ND",2020-08-09,2020-08-15,7,2020,"33",762062,136,9,121,15,127,1.18100626983106,1.96834378305177,0.12396694214876
"United States","North Dakota","ND",2020-08-16,2020-08-22,7,2020,"34",762062,132,14,119,13,118,1.83712086418165,1.70589794531154,0.109243697478992
"United States","North Dakota","ND",2020-08-23,2020-08-29,7,2020,"35",762062,141,6,123,18,135,0.787337513220709,2.36201253966213,0.146341463414634
"United States","North Dakota","ND",2020-08-30,2020-09-05,7,2020,"36",762062,163,14,127,36,149,1.83712086418165,4.72402507932425,0.283464566929134
"United States","North Dakota","ND",2020-09-06,2020-09-12,7,2020,"37",762062,143,12,127,16,131,1.57467502644142,2.09956670192189,0.125984251968504
"United States","North Dakota","ND",2020-09-13,2020-09-19,7,2020,"38",762062,165,25,128,37,140,3.28057297175295,4.85524799819437,0.2890625
"United States","North Dakota","ND",2020-09-20,2020-09-26,7,2020,"39",762062,178,19,133,45,159,2.49323545853225,5.90503134915532,0.338345864661654
"United States","North Dakota","ND",2020-09-27,2020-10-03,7,2020,"40",762062,197,60,135,62,137,7.87337513220709,8.13582096994733,0.459259259259259
"United States","North Dakota","ND",2020-10-04,2020-10-10,7,2020,"41",762062,239,65,136,103,174,8.52948972655768,13.5159606436222,0.757352941176471
"United States","North Dakota","ND",2020-10-11,2020-10-17,7,2020,"42",762062,223,63,140,83,160,8.26704388881745,10.8915022662198,0.592857142857143
"United States","North Dakota","ND",2020-10-18,2020-10-24,7,2020,"43",762062,195,49,145,50,146,6.42992302463579,6.56114594350591,0.344827586206897
"United States","North Dakota","ND",2020-10-25,2020-10-31,7,2020,"44",762062,246,76,141,105,170,9.97294183412898,13.7784064813624,0.74468085106383
"United States","North Dakota","ND",2020-11-01,2020-11-07,7,2020,"45",762062,269,104,144,125,165,13.6471835624923,16.4028648587648,0.868055555555556
"United States","North Dakota","ND",2020-11-08,2020-11-14,7,2020,"46",762062,255,98,144,111,157,12.8598460492716,14.5657439945831,0.770833333333333
"United States","North Dakota","ND",2020-11-15,2020-11-21,7,2020,"47",762062,273,108,142,131,165,14.1720752379728,17.1902023719855,0.922535211267606
"United States","North Dakota","ND",2020-11-22,2020-11-28,7,2020,"48",762062,248,81,140,108,167,10.6290564284796,14.1720752379728,0.771428571428571
"United States","North Dakota","ND",2020-11-29,2020-12-05,7,2020,"49",762062,283,92,143,140,191,12.0725085360509,18.3712086418165,0.979020979020979
"United States","North Dakota","ND",2020-12-06,2020-12-12,7,2020,"50",762062,231,57,142,89,174,7.47970637559674,11.6788397794405,0.626760563380282
"United States","North Dakota","ND",2020-12-13,2020-12-19,7,2020,"51",762062,200,140,142,58,60,18.3712086418165,7.61092929446685,0.408450704225352
"United States","North Dakota","ND",2020-12-20,2020-12-26,7,2020,"52",762062,200,60,144,56,140,7.87337513220709,7.34848345672662,0.388888888888889
"United States","North Dakota","ND",2020-12-27,2021-01-02,7,2020,"53",762062,163,46,148,15,117,6.03625426802544,1.96834378305177,0.101351351351351
"United States","North Dakota","ND",2021-01-03,2021-01-09,7,2021,"1",762062,156,42,149,7,114,5.51136259254496,0.918560432090827,0.0469798657718121
"United States","North Dakota","ND",2021-01-10,2021-01-16,7,2021,"2",762062,155,29,150,5,126,3.80546464723343,0.656114594350591,0.0333333333333334
"United States","North Dakota","ND",2021-01-17,2021-01-23,7,2021,"3",762062,142,30,149,-7,112,3.93668756610354,-0.918560432090827,-0.0469798657718121
"United States","North Dakota","ND",2021-01-24,2021-01-30,7,2021,"4",762062,149,11,148,1,138,1.4434521075713,0.131222918870118,0.0067567567567568
"United States","North Dakota","ND",2021-01-31,2021-02-06,7,2021,"5",762062,159,6,146,13,153,0.787337513220709,1.70589794531154,0.0890410958904109
"United States","North Dakota","ND",2021-02-07,2021-02-13,7,2021,"6",762062,121,4,147,-26,117,0.524891675480473,-3.41179589062307,-0.17687074829932
"United States","North Dakota","ND",2021-02-14,2021-02-20,7,2021,"7",762062,133,6,146,-13,127,0.787337513220709,-1.70589794531154,-0.089041095890411
"United States","North Dakota","ND",2021-02-21,2021-02-27,7,2021,"8",762062,165,8,145,20,157,1.04978335096095,2.62445837740236,0.137931034482759
"United States","North Dakota","ND",2021-02-28,2021-03-06,7,2021,"9",762062,157,4,145,12,153,0.524891675480473,1.57467502644142,0.0827586206896551
"United States","North Dakota","ND",2021-03-07,2021-03-13,7,2021,"10",762062,137,9,144,-7,128,1.18100626983106,-0.918560432090827,-0.0486111111111112
"United States","North Dakota","ND",2021-03-14,2021-03-20,7,2021,"11",762062,143,3,144,-1,140,0.393668756610355,-0.131222918870118,-0.00694444444444442
"United States","North Dakota","ND",2021-03-21,2021-03-27,7,2021,"12",762062,146,6,153,-7,140,0.787337513220709,-0.918560432090827,-0.0457516339869281
"United States","North Dakota","ND",2021-03-28,2021-04-03,7,2021,"13",762062,141,0,153,-12,141,0,-1.57467502644142,-0.0784313725490197
"United States","North Dakota","ND",2021-04-04,2021-04-10,7,2021,"14",762062,137,3,155,-18,134,0.393668756610355,-2.36201253966213,-0.116129032258064
"United States","North Dakota","ND",2021-04-11,2021-04-17,7,2021,"15",762062,147,8,156,-9,139,1.04978335096095,-1.18100626983106,-0.0576923076923077
"United States","North Dakota","ND",2021-04-18,2021-04-24,7,2021,"16",762062,126,7,149,-23,119,0.918560432090827,-3.01812713401272,-0.154362416107383
"United States","North Dakota","ND",2021-04-25,2021-05-01,7,2021,"17",762062,148,8,150,-2,140,1.04978335096095,-0.262445837740236,-0.0133333333333333
"United States","North Dakota","ND",2021-05-02,2021-05-08,7,2021,"18",762062,145,5,148,-3,140,0.656114594350591,-0.393668756610355,-0.0202702702702703
"United States","North Dakota","ND",2021-05-09,2021-05-15,7,2021,"19",762062,137,5,149,-12,132,0.656114594350591,-1.57467502644142,-0.0805369127516778
"United States","North Dakota","ND",2021-05-16,2021-05-22,7,2021,"20",762062,156,3,145,11,153,0.393668756610355,1.4434521075713,0.0758620689655172
"United States","North Dakota","ND",2021-05-23,2021-05-29,7,2021,"21",762062,123,5,148,-25,118,0.656114594350591,-3.28057297175295,-0.168918918918919
"United States","North Dakota","ND",2021-05-30,2021-06-05,7,2021,"22",762062,146,4,144,2,142,0.524891675480473,0.262445837740236,0.0138888888888888
"United States","North Dakota","ND",2021-06-06,2021-06-12,7,2021,"23",762062,139,4,144,-5,135,0.524891675480473,-0.656114594350591,-0.0347222222222222
"United States","North Dakota","ND",2021-06-13,2021-06-19,7,2021,"24",762062,125,3,142,-17,122,0.393668756610355,-2.23078962079201,-0.119718309859155
"United States","North Dakota","ND",2021-06-20,2021-06-26,7,2021,"25",762062,87,5,141,-54,82,0.656114594350591,-7.08603761898638,-0.382978723404255
"United States","Ohio","OH",2019-12-29,2020-01-04,7,2020,"1",11689100,2542,0,2769,-227,2542,0,-1.94198013533976,-0.0819790538100397
"United States","Ohio","OH",2020-01-05,2020-01-11,7,2020,"2",11689100,2615,0,2831,-216,2615,0,-1.8478753710722,-0.0762981278700106
"United States","Ohio","OH",2020-01-12,2020-01-18,7,2020,"3",11689100,2477,0,2808,-331,2477,0,-2.83169790659674,-0.117877492877493
"United States","Ohio","OH",2020-01-19,2020-01-25,7,2020,"4",11689100,2564,0,2755,-191,2564,0,-1.63400090682773,-0.0693284936479129
"United States","Ohio","OH",2020-01-26,2020-02-01,7,2020,"5",11689100,2494,0,2692,-198,2494,0,-1.69388575681618,-0.0735512630014858
"United States","Ohio","OH",2020-02-02,2020-02-08,7,2020,"6",11689100,2533,0,2664,-131,2533,0,-1.12070219264101,-0.0491741741741741
"United States","Ohio","OH",2020-02-09,2020-02-15,7,2020,"7",11689100,2495,0,2651,-156,2495,0,-1.33457665688547,-0.0588457185967559
"United States","Ohio","OH",2020-02-16,2020-02-22,7,2020,"8",11689100,2527,0,2620,-93,2527,0,-0.795613006989417,-0.0354961832061069
"United States","Ohio","OH",2020-02-23,2020-02-29,7,2020,"9",11689100,2461,0,2570,-109,2461,0,-0.932492664105876,-0.0424124513618677
"United States","Ohio","OH",2020-03-01,2020-03-07,7,2020,"10",11689100,2510,0,2568,-58,2510,0,-0.496188757047164,-0.0225856697819314
"United States","Ohio","OH",2020-03-08,2020-03-14,7,2020,"11",11689100,2555,0,2559,-4,2555,0,-0.0342199142791147,-0.0015631105900743
"United States","Ohio","OH",2020-03-15,2020-03-21,7,2020,"12",11689100,2521,3,2561,-40,2518,0.025664935709336,-0.342199142791147,-0.0156188988676298
"United States","Ohio","OH",2020-03-22,2020-03-28,7,2020,"13",11689100,2511,22,2557,-46,2489,0.188209528535131,-0.393529014209819,-0.0179898318341807
"United States","Ohio","OH",2020-03-29,2020-04-04,7,2020,"14",11689100,2572,77,2560,12,2495,0.658733349872959,0.102659742837344,0.00468749999999996
"United States","Ohio","OH",2020-04-05,2020-04-11,7,2020,"15",11689100,2632,145,2529,103,2487,1.24047189261791,0.881162792687204,0.0407275603005139
"United States","Ohio","OH",2020-04-12,2020-04-18,7,2020,"16",11689100,2657,204,2521,136,2453,1.74521562823485,1.1634770854899,0.0539468464894883
"United States","Ohio","OH",2020-04-19,2020-04-25,7,2020,"17",11689100,2835,258,2473,362,2577,2.2071844710029,3.09690224225988,0.146380913869794
"United States","Ohio","OH",2020-04-26,2020-05-02,7,2020,"18",11689100,2737,312,2425,312,2425,2.66915331377095,2.66915331377095,0.128659793814433
"United States","Ohio","OH",2020-05-03,2020-05-09,7,2020,"19",11689100,2616,310,2381,235,2306,2.65204335663139,2.01041996389799,0.0986980260394792
"United States","Ohio","OH",2020-05-10,2020-05-16,7,2020,"20",11689100,2685,279,2351,334,2406,2.38683902096825,2.85736284230608,0.142067205444492
"United States","Ohio","OH",2020-05-17,2020-05-23,7,2020,"21",11689100,2664,341,2339,325,2323,2.91724769229453,2.78036803517807,0.138948268490808
"United States","Ohio","OH",2020-05-24,2020-05-30,7,2020,"22",11689100,2530,195,2329,201,2335,1.66822082110684,1.71955069252552,0.0863031343924432
"United States","Ohio","OH",2020-05-31,2020-06-06,7,2020,"23",11689100,2597,224,2314,283,2373,1.91631519963042,2.42105893524737,0.122299049265341
"United States","Ohio","OH",2020-06-07,2020-06-13,7,2020,"24",11689100,2421,184,2309,112,2237,1.57411605683928,0.958157599815212,0.0485058466868775
"United States","Ohio","OH",2020-06-14,2020-06-20,7,2020,"25",11689100,2404,143,2306,98,2261,1.22336193547835,0.838387899838311,0.0424978317432785
"United States","Ohio","OH",2020-06-21,2020-06-27,7,2020,"26",11689100,2429,107,2316,113,2322,0.915382706966319,0.966712578384991,0.048791018998273
"United States","Ohio","OH",2020-06-28,2020-07-04,7,2020,"27",11689100,2529,103,2315,214,2426,0.881162792687204,1.83076541393264,0.09244060475162
"United States","Ohio","OH",2020-07-05,2020-07-11,7,2020,"28",11689100,2515,129,2277,238,2386,1.10359223550145,2.03608489960733,0.104523495827844
"United States","Ohio","OH",2020-07-12,2020-07-18,7,2020,"29",11689100,2537,96,2256,281,2441,0.821277942698753,2.40394897810781,0.124556737588652
"United States","Ohio","OH",2020-07-19,2020-07-25,7,2020,"30",11689100,2504,165,2250,254,2339,1.41157146401348,2.17296455672379,0.112888888888889
"United States","Ohio","OH",2020-07-26,2020-08-01,7,2020,"31",11689100,2621,218,2237,384,2403,1.86498532821175,3.28511177079501,0.171658471166741
"United States","Ohio","OH",2020-08-02,2020-08-08,7,2020,"32",11689100,2584,153,2218,366,2431,1.30891172117614,3.131122156539,0.165013525698828
"United States","Ohio","OH",2020-08-09,2020-08-15,7,2020,"33",11689100,2588,156,2217,371,2432,1.33457665688547,3.17389704938789,0.167343256653135
"United States","Ohio","OH",2020-08-16,2020-08-22,7,2020,"34",11689100,2592,151,2222,370,2441,1.29180176403658,3.16534207081811,0.166516651665167
"United States","Ohio","OH",2020-08-23,2020-08-29,7,2020,"35",11689100,2650,286,2218,432,2364,2.4467238709567,3.69575074214439,0.194770063119928
"United States","Ohio","OH",2020-08-30,2020-09-05,7,2020,"36",11689100,2426,-5,2231,195,2431,-0.0427748928488934,1.66822082110684,0.087404751232631
"United States","Ohio","OH",2020-09-06,2020-09-12,7,2020,"37",11689100,2557,155,2241,316,2402,1.3260216783157,2.70337322805006,0.141008478357876
"United States","Ohio","OH",2020-09-13,2020-09-19,7,2020,"38",11689100,2485,201,2262,223,2284,1.71955069252552,1.90776022106065,0.0985853227232538
"United States","Ohio","OH",2020-09-20,2020-09-26,7,2020,"39",11689100,2630,128,2266,364,2502,1.09503725693167,3.11401219939944,0.160635481023831
"United States","Ohio","OH",2020-09-27,2020-10-03,7,2020,"40",11689100,2602,185,2265,337,2417,1.58267103540906,2.88302777801542,0.14878587196468
"United States","Ohio","OH",2020-10-04,2020-10-10,7,2020,"41",11689100,2665,72,2253,412,2593,0.615958457024065,3.52465117074882,0.182867288060364
"United States","Ohio","OH",2020-10-11,2020-10-17,7,2020,"42",11689100,2650,70,2276,374,2580,0.598848499884508,3.19956198509723,0.164323374340949
"United States","Ohio","OH",2020-10-18,2020-10-24,7,2020,"43",11689100,2691,139,2289,402,2552,1.18914202119924,3.43910138505103,0.17562254259502
"United States","Ohio","OH",2020-10-25,2020-10-31,7,2020,"44",11689100,2763,95,2298,465,2668,0.812722964128975,3.97806503494709,0.202349869451697
"United States","Ohio","OH",2020-11-01,2020-11-07,7,2020,"45",11689100,3028,205,2316,712,2823,1.75377060680463,6.09114474168242,0.307426597582038
"United States","Ohio","OH",2020-11-08,2020-11-14,7,2020,"46",11689100,3070,208,2345,725,2862,1.77943554251397,6.20235946308954,0.309168443496802
"United States","Ohio","OH",2020-11-15,2020-11-21,7,2020,"47",11689100,3256,28,2367,889,3228,0.239539399953803,7.60537594853325,0.375580904098014
"United States","Ohio","OH",2020-11-22,2020-11-28,7,2020,"48",11689100,3568,657,2377,1191,2911,5.62062092034459,10.1889794766064,0.501051745898191
"United States","Ohio","OH",2020-11-29,2020-12-05,7,2020,"49",11689100,3910,544,2405,1505,3366,4.6539083419596,12.8752427475169,0.625779625779626
"United States","Ohio","OH",2020-12-06,2020-12-12,7,2020,"50",11689100,4230,530,2427,1803,3700,4.5341386419827,15.424626361311,0.742892459826947
"United States","Ohio","OH",2020-12-13,2020-12-19,7,2020,"51",11689100,4066,550,2436,1630,3516,4.70523821337828,13.9446150687393,0.669129720853859
"United States","Ohio","OH",2020-12-20,2020-12-26,7,2020,"52",11689100,3913,453,2482,1431,3460,3.87540529210974,12.2421743333533,0.576551168412571
"United States","Ohio","OH",2020-12-27,2021-01-02,7,2020,"53",11689100,3910,541,2526,1384,3369,4.62824340625027,11.8400903405737,0.547901821060966
"United States","Ohio","OH",2021-01-03,2021-01-09,7,2021,"1",11689100,3676,582,2575,1101,3094,4.97899752761119,9.41903140532633,0.427572815533981
"United States","Ohio","OH",2021-01-10,2021-01-16,7,2021,"2",11689100,3592,535,2615,977,3057,4.5769135348316,8.35821406267377,0.373613766730402
"United States","Ohio","OH",2021-01-17,2021-01-23,7,2021,"3",11689100,3293,546,2588,705,2747,4.67101829909916,6.03125989169397,0.27241112828439
"United States","Ohio","OH",2021-01-24,2021-01-30,7,2021,"4",11689100,3137,441,2580,557,2696,3.7727455492724,4.76512306336673,0.215891472868217
"United States","Ohio","OH",2021-01-31,2021-02-06,7,2021,"5",11689100,3116,532,2537,579,2584,4.55124859912226,4.95333259190186,0.228222309814742
"United States","Ohio","OH",2021-02-07,2021-02-13,7,2021,"6",11689100,2959,4687,2516,443,-1728,40.0971845565527,3.78985550641196,0.176073131955485
"United States","Ohio","OH",2021-02-14,2021-02-20,7,2021,"7",11689100,2857,422,2494,363,2435,3.6102009564466,3.10545722082966,0.145549318364074
"United States","Ohio","OH",2021-02-21,2021-02-27,7,2021,"8",11689100,2781,484,2511,270,2297,4.14060962777288,2.30984421384024,0.10752688172043
"United States","Ohio","OH",2021-02-28,2021-03-06,7,2021,"9",11689100,2578,637,2494,84,1941,5.44952134894902,0.718618199861409,0.0336808340016039
"United States","Ohio","OH",2021-03-07,2021-03-13,7,2021,"10",11689100,2553,565,2512,41,1988,4.83356289192496,0.350754121360926,0.0163216560509554
"United States","Ohio","OH",2021-03-14,2021-03-20,7,2021,"11",11689100,2411,338,2489,-78,2073,2.89158275658519,-0.667288328442737,-0.0313378867014865
"United States","Ohio","OH",2021-03-21,2021-03-27,7,2021,"12",11689100,2491,127,2461,30,2364,1.08648227836189,0.256649357093361,0.0121901665989435
"United States","Ohio","OH",2021-03-28,2021-04-03,7,2021,"13",11689100,2400,-270,2459,-59,2670,-2.30984421384024,-0.504743735616942,-0.0239934932899553
"United States","Ohio","OH",2021-04-04,2021-04-10,7,2021,"14",11689100,2561,184,2444,117,2377,1.57411605683928,1.00093249266411,0.0478723404255319
"United States","Ohio","OH",2021-04-11,2021-04-17,7,2021,"15",11689100,2427,164,2413,14,2263,1.4030164854437,0.119769699976902,0.00580190634065469
"United States","Ohio","OH",2021-04-18,2021-04-24,7,2021,"16",11689100,2583,131,2398,185,2452,1.12070219264101,1.58267103540906,0.0771476230191825
"United States","Ohio","OH",2021-04-25,2021-05-01,7,2021,"17",11689100,2481,162,2360,121,2319,1.38590652830415,1.03515240694322,0.0512711864406781
"United States","Ohio","OH",2021-05-02,2021-05-08,7,2021,"18",11689100,2415,144,2339,76,2271,1.23191691404813,0.65017837130318,0.0324925181701581
"United States","Ohio","OH",2021-05-09,2021-05-15,7,2021,"19",11689100,2420,100,2311,109,2320,0.855497856977868,0.932492664105876,0.0471657291215923
"United States","Ohio","OH",2021-05-16,2021-05-22,7,2021,"20",11689100,2560,181,2314,246,2379,1.54845112112994,2.10452472816556,0.106309420916163
"United States","Ohio","OH",2021-05-23,2021-05-29,7,2021,"21",11689100,2427,152,2288,139,2275,1.30035674260636,1.18914202119924,0.0607517482517483
"United States","Ohio","OH",2021-05-30,2021-06-05,7,2021,"22",11689100,2422,119,2270,152,2303,1.01804244980366,1.30035674260636,0.0669603524229074
"United States","Ohio","OH",2021-06-06,2021-06-12,7,2021,"23",11689100,2268,111,2278,-10,2157,0.949602621245434,-0.0855497856977868,-0.00438981562774365
"United States","Ohio","OH",2021-06-13,2021-06-19,7,2021,"24",11689100,2335,75,2276,59,2260,0.641623392733401,0.504743735616942,0.0259226713532512
"United States","Ohio","OH",2021-06-20,2021-06-26,7,2021,"25",11689100,2203,115,2294,-91,2088,0.983822535524548,-0.77850304984986,-0.0396687009590235
"United States","Oklahoma","OK",2019-12-29,2020-01-04,7,2020,"1",3956971,901,0,925,-24,901,0,-0.606524536065592,-0.0259459459459459
"United States","Oklahoma","OK",2020-01-05,2020-01-11,7,2020,"2",3956971,823,0,928,-105,823,0,-2.65354484528696,-0.113146551724138
"United States","Oklahoma","OK",2020-01-12,2020-01-18,7,2020,"3",3956971,850,0,938,-88,850,0,-2.22392329890717,-0.093816631130064
"United States","Oklahoma","OK",2020-01-19,2020-01-25,7,2020,"4",3956971,803,0,921,-118,803,0,-2.98207896898916,-0.128121606948968
"United States","Oklahoma","OK",2020-01-26,2020-02-01,7,2020,"5",3956971,833,0,906,-73,833,0,-1.84484546386617,-0.0805739514348786
"United States","Oklahoma","OK",2020-02-02,2020-02-08,7,2020,"6",3956971,816,0,894,-78,816,0,-1.97120474221317,-0.087248322147651
"United States","Oklahoma","OK",2020-02-09,2020-02-15,7,2020,"7",3956971,806,0,883,-77,806,0,-1.94593288654377,-0.087202718006795
"United States","Oklahoma","OK",2020-02-16,2020-02-22,7,2020,"8",3956971,818,0,869,-51,818,0,-1.28886463913938,-0.0586881472957422
"United States","Oklahoma","OK",2020-02-23,2020-02-29,7,2020,"9",3956971,829,0,854,-25,829,0,-0.631796391734991,-0.0292740046838408
"United States","Oklahoma","OK",2020-03-01,2020-03-07,7,2020,"10",3956971,799,0,845,-46,799,0,-1.16250536079238,-0.0544378698224852
"United States","Oklahoma","OK",2020-03-08,2020-03-14,7,2020,"11",3956971,792,0,838,-46,792,0,-1.16250536079238,-0.0548926014319809
"United States","Oklahoma","OK",2020-03-15,2020-03-21,7,2020,"12",3956971,827,1,817,10,826,0.0252718556693996,0.252718556693996,0.0122399020807833
"United States","Oklahoma","OK",2020-03-22,2020-03-28,7,2020,"13",3956971,856,14,795,61,842,0.353805979371595,1.54158319583338,0.0767295597484277
"United States","Oklahoma","OK",2020-03-29,2020-04-04,7,2020,"14",3956971,784,27,780,4,757,0.68234010307379,0.101087422677599,0.00512820512820511
"United States","Oklahoma","OK",2020-04-05,2020-04-11,7,2020,"15",3956971,857,52,770,87,805,1.31413649480878,2.19865144323777,0.112987012987013
"United States","Oklahoma","OK",2020-04-12,2020-04-18,7,2020,"16",3956971,799,37,778,21,762,0.935058659767787,0.530708969057393,0.0269922879177378
"United States","Oklahoma","OK",2020-04-19,2020-04-25,7,2020,"17",3956971,780,63,776,4,717,1.59212690717218,0.101087422677599,0.00515463917525771
"United States","Oklahoma","OK",2020-04-26,2020-05-02,7,2020,"18",3956971,759,44,771,-12,715,1.11196164945358,-0.303262268032796,-0.0155642023346303
"United States","Oklahoma","OK",2020-05-03,2020-05-09,7,2020,"19",3956971,776,32,769,7,744,0.808699381420789,0.176902989685798,0.00910273081924573
"United States","Oklahoma","OK",2020-05-10,2020-05-16,7,2020,"20",3956971,733,18,763,-30,715,0.454893402049194,-0.758155670081989,-0.0393184796854522
"United States","Oklahoma","OK",2020-05-17,2020-05-23,7,2020,"21",3956971,815,23,757,58,792,0.581252680396192,1.46576762882518,0.0766182298546896
"United States","Oklahoma","OK",2020-05-24,2020-05-30,7,2020,"22",3956971,740,22,747,-7,718,0.555980824726792,-0.176902989685798,-0.00937081659973227
"United States","Oklahoma","OK",2020-05-31,2020-06-06,7,2020,"23",3956971,789,14,748,41,775,0.353805979371595,1.03614608244539,0.054812834224599
"United States","Oklahoma","OK",2020-06-07,2020-06-13,7,2020,"24",3956971,770,12,733,37,758,0.303262268032796,0.935058659767787,0.0504774897680764
"United States","Oklahoma","OK",2020-06-14,2020-06-20,7,2020,"25",3956971,741,9,731,10,732,0.227446701024597,0.252718556693996,0.0136798905608755
"United States","Oklahoma","OK",2020-06-21,2020-06-27,7,2020,"26",3956971,765,16,730,35,749,0.404349690710394,0.884514948428988,0.047945205479452
"United States","Oklahoma","OK",2020-06-28,2020-07-04,7,2020,"27",3956971,781,14,730,51,767,0.353805979371595,1.28886463913938,0.0698630136986302
"United States","Oklahoma","OK",2020-07-05,2020-07-11,7,2020,"28",3956971,768,23,729,39,745,0.581252680396192,0.985602371106586,0.0534979423868314
"United States","Oklahoma","OK",2020-07-12,2020-07-18,7,2020,"29",3956971,794,30,725,69,764,0.758155670081989,1.74375804118858,0.0951724137931034
"United States","Oklahoma","OK",2020-07-19,2020-07-25,7,2020,"30",3956971,904,45,732,172,859,1.13723350512298,4.34675917513674,0.234972677595628
"United States","Oklahoma","OK",2020-07-26,2020-08-01,7,2020,"31",3956971,881,53,728,153,828,1.33940835047818,3.86659391741815,0.210164835164835
"United States","Oklahoma","OK",2020-08-02,2020-08-08,7,2020,"32",3956971,814,54,719,95,760,1.36468020614758,2.40082628859297,0.132127955493741
"United States","Oklahoma","OK",2020-08-09,2020-08-15,7,2020,"33",3956971,860,54,715,145,806,1.36468020614758,3.66441907206295,0.202797202797203
"United States","Oklahoma","OK",2020-08-16,2020-08-22,7,2020,"34",3956971,877,68,713,164,809,1.71848618551918,4.14458432978154,0.230014025245442
"United States","Oklahoma","OK",2020-08-23,2020-08-29,7,2020,"35",3956971,814,72,708,106,742,1.81957360819677,2.67881670095636,0.149717514124294
"United States","Oklahoma","OK",2020-08-30,2020-09-05,7,2020,"36",3956971,828,53,713,115,775,1.33940835047818,2.90626340198096,0.161290322580645
"United States","Oklahoma","OK",2020-09-06,2020-09-12,7,2020,"37",3956971,802,49,713,89,753,1.23832092780058,2.24919515457657,0.124824684431978
"United States","Oklahoma","OK",2020-09-13,2020-09-19,7,2020,"38",3956971,793,44,713,80,749,1.11196164945358,2.02174845355197,0.112201963534362
"United States","Oklahoma","OK",2020-09-20,2020-09-26,7,2020,"39",3956971,909,61,720,189,848,1.54158319583338,4.77638072151653,0.2625
"United States","Oklahoma","OK",2020-09-27,2020-10-03,7,2020,"40",3956971,851,47,730,121,804,1.18777721646178,3.05789453599736,0.165753424657534
"United States","Oklahoma","OK",2020-10-04,2020-10-10,7,2020,"41",3956971,970,44,725,245,926,1.11196164945358,6.19160463900291,0.337931034482759
"United States","Oklahoma","OK",2020-10-11,2020-10-17,7,2020,"42",3956971,862,73,731,131,789,1.84484546386617,3.31061309269135,0.179206566347469
"United States","Oklahoma","OK",2020-10-18,2020-10-24,7,2020,"43",3956971,945,77,733,212,868,1.94593288654377,5.35763340191273,0.289222373806276
"United States","Oklahoma","OK",2020-10-25,2020-10-31,7,2020,"44",3956971,1025,92,745,280,933,2.32501072158477,7.0761195874319,0.375838926174497
"United States","Oklahoma","OK",2020-11-01,2020-11-07,7,2020,"45",3956971,1028,92,748,280,936,2.32501072158477,7.0761195874319,0.374331550802139
"United States","Oklahoma","OK",2020-11-08,2020-11-14,7,2020,"46",3956971,1065,87,757,308,978,2.19865144323777,7.78373154617509,0.406869220607662
"United States","Oklahoma","OK",2020-11-15,2020-11-21,7,2020,"47",3956971,1148,87,770,378,1061,2.19865144323777,9.55276144303307,0.490909090909091
"United States","Oklahoma","OK",2020-11-22,2020-11-28,7,2020,"48",3956971,1148,114,779,369,1034,2.88099154631156,9.32531474200847,0.473684210526316
"United States","Oklahoma","OK",2020-11-29,2020-12-05,7,2020,"49",3956971,1321,157,774,547,1164,3.96768134009574,13.8237050511616,0.70671834625323
"United States","Oklahoma","OK",2020-12-06,2020-12-12,7,2020,"50",3956971,1212,168,781,431,1044,4.24567175245914,10.8921697935112,0.551856594110115
"United States","Oklahoma","OK",2020-12-13,2020-12-19,7,2020,"51",3956971,1281,147,788,493,1134,3.71496278340175,12.459024845014,0.625634517766497
"United States","Oklahoma","OK",2020-12-20,2020-12-26,7,2020,"52",3956971,1272,168,790,482,1104,4.24567175245914,12.1810344326506,0.610126582278481
"United States","Oklahoma","OK",2020-12-27,2021-01-02,7,2020,"53",3956971,1337,170,806,531,1167,4.29621546379794,13.4193553604512,0.658808933002481
"United States","Oklahoma","OK",2021-01-03,2021-01-09,7,2021,"1",3956971,1257,211,828,429,1046,5.33236154624333,10.8416260821724,0.518115942028986
"United States","Oklahoma","OK",2021-01-10,2021-01-16,7,2021,"2",3956971,1310,214,847,463,1096,5.40817711325152,11.700869174932,0.546635182998819
"United States","Oklahoma","OK",2021-01-17,2021-01-23,7,2021,"3",3956971,1314,279,867,447,1035,7.0508477317625,11.2965194842216,0.515570934256055
"United States","Oklahoma","OK",2021-01-24,2021-01-30,7,2021,"4",3956971,1178,273,870,308,905,6.8992165977461,7.78373154617509,0.354022988505747
"United States","Oklahoma","OK",2021-01-31,2021-02-06,7,2021,"5",3956971,1061,257,865,196,804,6.49486690703571,4.95328371120233,0.226589595375723
"United States","Oklahoma","OK",2021-02-07,2021-02-13,7,2021,"6",3956971,992,233,845,147,759,5.88834237097012,3.71496278340175,0.17396449704142
"United States","Oklahoma","OK",2021-02-14,2021-02-20,7,2021,"7",3956971,1018,161,840,178,857,4.06876876277334,4.49839030915314,0.211904761904762
"United States","Oklahoma","OK",2021-02-21,2021-02-27,7,2021,"8",3956971,924,224,829,95,700,5.66089566994552,2.40082628859297,0.1145958986731
"United States","Oklahoma","OK",2021-02-28,2021-03-06,7,2021,"9",3956971,884,156,824,60,728,3.94240948442635,1.51631134016398,0.0728155339805825
"United States","Oklahoma","OK",2021-03-07,2021-03-13,7,2021,"10",3956971,845,167,815,30,678,4.22039989678974,0.758155670081989,0.0368098159509203
"United States","Oklahoma","OK",2021-03-14,2021-03-20,7,2021,"11",3956971,773,86,801,-28,687,2.17337958756837,-0.70761195874319,-0.0349563046192259
"United States","Oklahoma","OK",2021-03-21,2021-03-27,7,2021,"12",3956971,832,62,783,49,770,1.56685505150278,1.23832092780058,0.0625798212005109
"United States","Oklahoma","OK",2021-03-28,2021-04-03,7,2021,"13",3956971,781,103,759,22,678,2.60300113394816,0.555980824726792,0.0289855072463767
"United States","Oklahoma","OK",2021-04-04,2021-04-10,7,2021,"14",3956971,825,1716,752,73,-891,43.3665043286898,1.84484546386617,0.0970744680851063
"United States","Oklahoma","OK",2021-04-11,2021-04-17,7,2021,"15",3956971,777,28,742,35,749,0.70761195874319,0.884514948428988,0.0471698113207548
"United States","Oklahoma","OK",2021-04-18,2021-04-24,7,2021,"16",3956971,775,19,745,30,756,0.480165257718593,0.758155670081989,0.0402684563758389
"United States","Oklahoma","OK",2021-04-25,2021-05-01,7,2021,"17",3956971,721,72,745,-24,649,1.81957360819677,-0.606524536065592,-0.0322147651006711
"United States","Oklahoma","OK",2021-05-02,2021-05-08,7,2021,"18",3956971,812,44,740,72,768,1.11196164945358,1.81957360819677,0.0972972972972972
"United States","Oklahoma","OK",2021-05-09,2021-05-15,7,2021,"19",3956971,752,46,740,12,706,1.16250536079238,0.303262268032796,0.0162162162162163
"United States","Oklahoma","OK",2021-05-16,2021-05-22,7,2021,"20",3956971,761,40,736,25,721,1.01087422677599,0.631796391734991,0.0339673913043479
"United States","Oklahoma","OK",2021-05-23,2021-05-29,7,2021,"21",3956971,732,373,724,8,359,9.42640216468607,0.202174845355197,0.011049723756906
"United States","Oklahoma","OK",2021-05-30,2021-06-05,7,2021,"22",3956971,720,25,720,0,695,0.631796391734991,0,0
"United States","Oklahoma","OK",2021-06-06,2021-06-12,7,2021,"23",3956971,759,9,713,46,750,0.227446701024597,1.16250536079238,0.064516129032258
"United States","Oklahoma","OK",2021-06-13,2021-06-19,7,2021,"24",3956971,694,29,711,-17,665,0.73288381441259,-0.429621546379794,-0.0239099859353024
"United States","Oklahoma","OK",2021-06-20,2021-06-26,7,2021,"25",3956971,522,30,719,-197,492,0.758155670081989,-4.97855556687173,-0.273991655076495
"United States","Oregon","OR",2019-12-29,2020-01-04,7,2020,"1",4217737,737,0,807,-70,737,0,-1.65965777382516,-0.0867410161090458
"United States","Oregon","OR",2020-01-05,2020-01-11,7,2020,"2",4217737,764,0,805,-41,764,0,-0.972085267526164,-0.0509316770186335
"United States","Oregon","OR",2020-01-12,2020-01-18,7,2020,"3",4217737,769,0,786,-17,769,0,-0.403059745071824,-0.0216284987277354
"United States","Oregon","OR",2020-01-19,2020-01-25,7,2020,"4",4217737,745,0,769,-24,745,0,-0.56902552245434,-0.0312093628088427
"United States","Oregon","OR",2020-01-26,2020-02-01,7,2020,"5",4217737,728,0,743,-15,728,0,-0.355640951533962,-0.0201884253028264
"United States","Oregon","OR",2020-02-02,2020-02-08,7,2020,"6",4217737,727,0,720,7,727,0,0.165965777382516,0.00972222222222219
"United States","Oregon","OR",2020-02-09,2020-02-15,7,2020,"7",4217737,783,0,715,68,783,0,1.6122389802873,0.0951048951048952
"United States","Oregon","OR",2020-02-16,2020-02-22,7,2020,"8",4217737,733,0,721,12,733,0,0.28451276122717,0.0166435506241331
"United States","Oregon","OR",2020-02-23,2020-02-29,7,2020,"9",4217737,735,0,726,9,735,0,0.213384570920377,0.0123966942148761
"United States","Oregon","OR",2020-03-01,2020-03-07,7,2020,"10",4217737,788,0,734,54,788,0,1.28030742552226,0.0735694822888284
"United States","Oregon","OR",2020-03-08,2020-03-14,7,2020,"11",4217737,746,1,726,20,745,0.0237093967689308,0.474187935378617,0.0275482093663912
"United States","Oregon","OR",2020-03-15,2020-03-21,7,2020,"12",4217737,775,3,718,57,772,0.0711281903067925,1.35143561582906,0.0793871866295264
"United States","Oregon","OR",2020-03-22,2020-03-28,7,2020,"13",4217737,768,9,711,57,759,0.213384570920377,1.35143561582906,0.0801687763713079
"United States","Oregon","OR",2020-03-29,2020-04-04,7,2020,"14",4217737,778,13,696,82,765,0.308222157996101,1.94417053505233,0.117816091954023
"United States","Oregon","OR",2020-04-05,2020-04-11,7,2020,"15",4217737,769,25,703,66,744,0.592734919223271,1.56482018674943,0.0938833570412518
"United States","Oregon","OR",2020-04-12,2020-04-18,7,2020,"16",4217737,765,21,692,73,744,0.497897332147547,1.73078596413195,0.105491329479769
"United States","Oregon","OR",2020-04-19,2020-04-25,7,2020,"17",4217737,770,15,681,89,755,0.355640951533962,2.11013631243484,0.130690161527166
"United States","Oregon","OR",2020-04-26,2020-05-02,7,2020,"18",4217737,714,22,679,35,692,0.521606728916478,0.829828886912579,0.0515463917525774
"United States","Oregon","OR",2020-05-03,2020-05-09,7,2020,"19",4217737,703,18,676,27,685,0.426769141840755,0.640153712761132,0.0399408284023668
"United States","Oregon","OR",2020-05-10,2020-05-16,7,2020,"20",4217737,716,10,670,46,706,0.237093967689308,1.09063225137082,0.0686567164179104
"United States","Oregon","OR",2020-05-17,2020-05-23,7,2020,"21",4217737,744,10,663,81,734,0.237093967689308,1.9204611382834,0.122171945701357
"United States","Oregon","OR",2020-05-24,2020-05-30,7,2020,"22",4217737,748,6,659,89,742,0.142256380613585,2.11013631243484,0.1350531107739
"United States","Oregon","OR",2020-05-31,2020-06-06,7,2020,"23",4217737,683,8,655,28,675,0.189675174151447,0.663863109530063,0.0427480916030534
"United States","Oregon","OR",2020-06-07,2020-06-13,7,2020,"24",4217737,727,13,653,74,714,0.308222157996101,1.75449536090088,0.113323124042879
"United States","Oregon","OR",2020-06-14,2020-06-20,7,2020,"25",4217737,731,15,661,70,716,0.355640951533962,1.65965777382516,0.10590015128593
"United States","Oregon","OR",2020-06-21,2020-06-27,7,2020,"26",4217737,689,14,657,32,675,0.331931554765032,0.758700696605786,0.0487062404870624
"United States","Oregon","OR",2020-06-28,2020-07-04,7,2020,"27",4217737,760,10,646,114,750,0.237093967689308,2.70287123165811,0.176470588235294
"United States","Oregon","OR",2020-07-05,2020-07-11,7,2020,"28",4217737,713,19,642,71,694,0.450478538609686,1.68336717059409,0.110591900311527
"United States","Oregon","OR",2020-07-12,2020-07-18,7,2020,"29",4217737,759,25,645,114,734,0.592734919223271,2.70287123165811,0.176744186046512
"United States","Oregon","OR",2020-07-19,2020-07-25,7,2020,"30",4217737,740,29,647,93,711,0.687572506298994,2.20497389951057,0.143740340030912
"United States","Oregon","OR",2020-07-26,2020-08-01,7,2020,"31",4217737,719,39,641,78,680,0.924666473988302,1.8493329479766,0.121684867394696
"United States","Oregon","OR",2020-08-02,2020-08-08,7,2020,"32",4217737,768,30,637,131,738,0.711281903067925,3.10593097672994,0.205651491365777
"United States","Oregon","OR",2020-08-09,2020-08-15,7,2020,"33",4217737,777,31,632,145,746,0.734991299836856,3.43786253149497,0.229430379746835
"United States","Oregon","OR",2020-08-16,2020-08-22,7,2020,"34",4217737,789,31,627,162,758,0.734991299836856,3.84092227656679,0.258373205741627
"United States","Oregon","OR",2020-08-23,2020-08-29,7,2020,"35",4217737,749,38,631,118,711,0.900957077219371,2.79770881873384,0.187004754358162
"United States","Oregon","OR",2020-08-30,2020-09-05,7,2020,"36",4217737,707,25,619,88,682,0.592734919223271,2.08642691566591,0.142164781906301
"United States","Oregon","OR",2020-09-06,2020-09-12,7,2020,"37",4217737,737,25,621,116,712,0.592734919223271,2.75029002519598,0.186795491143317
"United States","Oregon","OR",2020-09-13,2020-09-19,7,2020,"38",4217737,790,19,625,165,771,0.450478538609686,3.91205046687359,0.264
"United States","Oregon","OR",2020-09-20,2020-09-26,7,2020,"39",4217737,730,19,638,92,711,0.450478538609686,2.18126450274164,0.144200626959248
"United States","Oregon","OR",2020-09-27,2020-10-03,7,2020,"40",4217737,733,20,656,77,713,0.474187935378617,1.82562355120767,0.117378048780488
"United States","Oregon","OR",2020-10-04,2020-10-10,7,2020,"41",4217737,761,34,672,89,727,0.806119490143648,2.11013631243484,0.132440476190476
"United States","Oregon","OR",2020-10-11,2020-10-17,7,2020,"42",4217737,713,23,665,48,690,0.545316125685409,1.13805104490868,0.0721804511278195
"United States","Oregon","OR",2020-10-18,2020-10-24,7,2020,"43",4217737,763,33,674,89,730,0.782410093374717,2.11013631243484,0.132047477744807
"United States","Oregon","OR",2020-10-25,2020-10-31,7,2020,"44",4217737,782,35,677,105,747,0.829828886912579,2.48948666073774,0.155096011816839
"United States","Oregon","OR",2020-11-01,2020-11-07,7,2020,"45",4217737,835,41,679,156,794,0.972085267526164,3.69866589595321,0.229749631811488
"United States","Oregon","OR",2020-11-08,2020-11-14,7,2020,"46",4217737,838,30,683,155,808,0.711281903067925,3.67495649918428,0.226939970717423
"United States","Oregon","OR",2020-11-15,2020-11-21,7,2020,"47",4217737,835,60,697,138,775,1.42256380613585,3.27189675411245,0.197991391678623
"United States","Oregon","OR",2020-11-22,2020-11-28,7,2020,"48",4217737,880,77,686,194,803,1.82562355120767,4.59962297317258,0.282798833819242
"United States","Oregon","OR",2020-11-29,2020-12-05,7,2020,"49",4217737,936,131,695,241,805,3.10593097672994,5.71396462131233,0.346762589928058
"United States","Oregon","OR",2020-12-06,2020-12-12,7,2020,"50",4217737,941,110,702,239,831,2.60803364458239,5.66654582777447,0.34045584045584
"United States","Oregon","OR",2020-12-13,2020-12-19,7,2020,"51",4217737,979,165,724,255,814,3.91205046687359,6.04589617607736,0.352209944751381
"United States","Oregon","OR",2020-12-20,2020-12-26,7,2020,"52",4217737,878,113,748,130,765,2.67916183488918,3.08222157996101,0.17379679144385
"United States","Oregon","OR",2020-12-27,2021-01-02,7,2020,"53",4217737,904,62,779,125,842,1.46998259967371,2.96367459611635,0.160462130937099
"United States","Oregon","OR",2021-01-03,2021-01-09,7,2021,"1",4217737,885,98,788,97,787,2.32352088335522,2.29981148658629,0.123096446700508
"United States","Oregon","OR",2021-01-10,2021-01-16,7,2021,"2",4217737,896,183,786,110,713,4.33881960871434,2.60803364458239,0.139949109414758
"United States","Oregon","OR",2021-01-17,2021-01-23,7,2021,"3",4217737,860,107,783,77,753,2.5369054542756,1.82562355120767,0.0983397190293742
"United States","Oregon","OR",2021-01-24,2021-01-30,7,2021,"4",4217737,842,73,770,72,769,1.73078596413195,1.70707656736302,0.0935064935064935
"United States","Oregon","OR",2021-01-31,2021-02-06,7,2021,"5",4217737,843,64,756,87,779,1.51740139321157,2.06271751889698,0.115079365079365
"United States","Oregon","OR",2021-02-07,2021-02-13,7,2021,"6",4217737,798,92,749,49,706,2.18126450274164,1.16176044167761,0.0654205607476634
"United States","Oregon","OR",2021-02-14,2021-02-20,7,2021,"7",4217737,820,55,757,63,765,1.3040168222912,1.49369199644264,0.0832232496697489
"United States","Oregon","OR",2021-02-21,2021-02-27,7,2021,"8",4217737,807,57,765,42,750,1.35143561582906,0.995794664295095,0.0549019607843138
"United States","Oregon","OR",2021-02-28,2021-03-06,7,2021,"9",4217737,799,87,774,25,712,2.06271751889698,0.592734919223271,0.0322997416020672
"United States","Oregon","OR",2021-03-07,2021-03-13,7,2021,"10",4217737,785,26,774,11,759,0.616444315992202,0.260803364458239,0.0142118863049097
"United States","Oregon","OR",2021-03-14,2021-03-20,7,2021,"11",4217737,831,38,773,58,793,0.900957077219371,1.37514501259799,0.0750323415265199
"United States","Oregon","OR",2021-03-21,2021-03-27,7,2021,"12",4217737,807,16,770,37,791,0.379350348302893,0.877247680450441,0.0480519480519481
"United States","Oregon","OR",2021-03-28,2021-04-03,7,2021,"13",4217737,817,12,768,49,805,0.28451276122717,1.16176044167761,0.0638020833333333
"United States","Oregon","OR",2021-04-04,2021-04-10,7,2021,"14",4217737,787,55,752,35,732,1.3040168222912,0.829828886912579,0.0465425531914894
"United States","Oregon","OR",2021-04-11,2021-04-17,7,2021,"15",4217737,744,17,746,-2,727,0.403059745071824,-0.0474187935378617,-0.00268096514745308
"United States","Oregon","OR",2021-04-18,2021-04-24,7,2021,"16",4217737,794,19,736,58,775,0.450478538609686,1.37514501259799,0.0788043478260869
"United States","Oregon","OR",2021-04-25,2021-05-01,7,2021,"17",4217737,775,19,731,44,756,0.450478538609686,1.04321345783296,0.0601915184678523
"United States","Oregon","OR",2021-05-02,2021-05-08,7,2021,"18",4217737,773,27,731,42,746,0.640153712761132,0.995794664295095,0.0574555403556771
"United States","Oregon","OR",2021-05-09,2021-05-15,7,2021,"19",4217737,805,60,729,76,745,1.42256380613585,1.80191415443874,0.104252400548697
"United States","Oregon","OR",2021-05-16,2021-05-22,7,2021,"20",4217737,805,31,727,78,774,0.734991299836856,1.8493329479766,0.107290233837689
"United States","Oregon","OR",2021-05-23,2021-05-29,7,2021,"21",4217737,749,52,723,26,697,1.2328886319844,0.616444315992202,0.0359612724757954
"United States","Oregon","OR",2021-05-30,2021-06-05,7,2021,"22",4217737,753,21,729,24,732,0.497897332147547,0.56902552245434,0.0329218106995885
"United States","Oregon","OR",2021-06-06,2021-06-12,7,2021,"23",4217737,744,40,724,20,704,0.948375870757233,0.474187935378617,0.0276243093922652
"United States","Oregon","OR",2021-06-13,2021-06-19,7,2021,"24",4217737,682,24,721,-39,658,0.56902552245434,-0.924666473988302,-0.0540915395284327
"United States","Oregon","OR",2021-06-20,2021-06-26,7,2021,"25",4217737,566,11,720,-154,555,0.260803364458239,-3.65124710241535,-0.213888888888889
"United States","Pennsylvania","PA",2019-12-29,2020-01-04,7,2020,"1",12801989,2785,0,2970,-185,2785,0,-1.44508794688075,-0.0622895622895623
"United States","Pennsylvania","PA",2020-01-05,2020-01-11,7,2020,"2",12801989,2849,0,3021,-172,2849,0,-1.34354122628913,-0.0569347898047005
"United States","Pennsylvania","PA",2020-01-12,2020-01-18,7,2020,"3",12801989,2862,0,3002,-140,2862,0,-1.09358006790976,-0.0466355762824784
"United States","Pennsylvania","PA",2020-01-19,2020-01-25,7,2020,"4",12801989,2795,0,2982,-187,2795,0,-1.46071051927947,-0.0627095908786049
"United States","Pennsylvania","PA",2020-01-26,2020-02-01,7,2020,"5",12801989,2810,0,2964,-154,2810,0,-1.20293807470074,-0.0519568151147098
"United States","Pennsylvania","PA",2020-02-02,2020-02-08,7,2020,"6",12801989,2787,0,2935,-148,2787,0,-1.1560703575046,-0.0504258943781942
"United States","Pennsylvania","PA",2020-02-09,2020-02-15,7,2020,"7",12801989,2811,0,2903,-92,2811,0,-0.718638330340699,-0.0316913537719601
"United States","Pennsylvania","PA",2020-02-16,2020-02-22,7,2020,"8",12801989,2704,0,2880,-176,2704,0,-1.37478637108656,-0.0611111111111111
"United States","Pennsylvania","PA",2020-02-23,2020-02-29,7,2020,"9",12801989,2774,0,2826,-52,2774,0,-0.406186882366482,-0.0184005661712668
"United States","Pennsylvania","PA",2020-03-01,2020-03-07,7,2020,"10",12801989,2787,0,2818,-31,2787,0,-0.242149872180018,-0.011000709723208
"United States","Pennsylvania","PA",2020-03-08,2020-03-14,7,2020,"11",12801989,2833,0,2794,39,2833,0,0.304640161774862,0.0139584824624195
"United States","Pennsylvania","PA",2020-03-15,2020-03-21,7,2020,"12",12801989,2603,2,2773,-170,2601,0.0156225723987109,-1.32791865389042,-0.0613054453660296
"United States","Pennsylvania","PA",2020-03-22,2020-03-28,7,2020,"13",12801989,2735,32,2743,-8,2703,0.249961158379374,-0.0624902895948434,-0.00291651476485599
"United States","Pennsylvania","PA",2020-03-29,2020-04-04,7,2020,"14",12801989,3004,102,2727,277,2902,0.796751192334254,2.16372627722145,0.101576824349102
"United States","Pennsylvania","PA",2020-04-05,2020-04-11,7,2020,"15",12801989,3453,355,2685,768,3098,2.77300660077118,5.99906780110497,0.286033519553073
"United States","Pennsylvania","PA",2020-04-12,2020-04-18,7,2020,"16",12801989,3743,345,2656,1087,3398,2.69489373877762,8.49086809869935,0.409262048192771
"United States","Pennsylvania","PA",2020-04-19,2020-04-25,7,2020,"17",12801989,3823,700,2604,1219,3123,5.4679003395488,9.52195787701427,0.468125960061444
"United States","Pennsylvania","PA",2020-04-26,2020-05-02,7,2020,"18",12801989,3564,881,2556,1008,2683,6.88174314163213,7.87377648895027,0.394366197183099
"United States","Pennsylvania","PA",2020-05-03,2020-05-09,7,2020,"19",12801989,3439,1252,2525,914,2187,9.779730321593,7.13951558621086,0.361980198019802
"United States","Pennsylvania","PA",2020-05-10,2020-05-16,7,2020,"20",12801989,3284,534,2482,802,2750,4.1712268304558,6.26465153188305,0.323126510878324
"United States","Pennsylvania","PA",2020-05-17,2020-05-23,7,2020,"21",12801989,2977,893,2449,528,2084,6.9754785760244,4.12435911325967,0.215598203348305
"United States","Pennsylvania","PA",2020-05-24,2020-05-30,7,2020,"22",12801989,2792,440,2450,342,2352,3.43696592771639,2.67145988017956,0.139591836734694
"United States","Pennsylvania","PA",2020-05-31,2020-06-06,7,2020,"23",12801989,2730,394,2462,268,2336,3.07764676254604,2.09342470142725,0.108854589764419
"United States","Pennsylvania","PA",2020-06-07,2020-06-13,7,2020,"24",12801989,2573,280,2444,129,2293,2.18716013581952,1.00765591971685,0.0527823240589198
"United States","Pennsylvania","PA",2020-06-14,2020-06-20,7,2020,"25",12801989,2624,209,2447,177,2415,1.63255881566528,1.38259765728591,0.0723334695545566
"United States","Pennsylvania","PA",2020-06-21,2020-06-27,7,2020,"26",12801989,2561,183,2417,144,2378,1.42946537448204,1.12482521270718,0.0595779892428629
"United States","Pennsylvania","PA",2020-06-28,2020-07-04,7,2020,"27",12801989,2595,147,2393,202,2448,1.14825907130525,1.5778798122698,0.0844128708733807
"United States","Pennsylvania","PA",2020-07-05,2020-07-11,7,2020,"28",12801989,2677,148,2372,305,2529,1.1560703575046,2.38244229080341,0.12858347386172
"United States","Pennsylvania","PA",2020-07-12,2020-07-18,7,2020,"29",12801989,2560,110,2336,224,2450,0.859241481929097,1.74972810865562,0.095890410958904
"United States","Pennsylvania","PA",2020-07-19,2020-07-25,7,2020,"30",12801989,2535,107,2326,209,2428,0.835807623331031,1.63255881566528,0.089853826311264
"United States","Pennsylvania","PA",2020-07-26,2020-08-01,7,2020,"31",12801989,2645,90,2324,321,2555,0.703015757941989,2.50742286999309,0.138123924268503
"United States","Pennsylvania","PA",2020-08-02,2020-08-08,7,2020,"32",12801989,2540,109,2319,221,2431,0.851430195729742,1.72629425005755,0.0952996981457526
"United States","Pennsylvania","PA",2020-08-09,2020-08-15,7,2020,"33",12801989,2661,152,2310,351,2509,1.18731550230203,2.74176145597376,0.151948051948052
"United States","Pennsylvania","PA",2020-08-16,2020-08-22,7,2020,"34",12801989,2634,111,2323,311,2523,0.867052768128453,2.42931000799954,0.133878605251829
"United States","Pennsylvania","PA",2020-08-23,2020-08-29,7,2020,"35",12801989,2589,95,2321,268,2494,0.742072188938766,2.09342470142725,0.115467470917708
"United States","Pennsylvania","PA",2020-08-30,2020-09-05,7,2020,"36",12801989,2604,89,2348,256,2515,0.695204471742633,1.99968926703499,0.109028960817717
"United States","Pennsylvania","PA",2020-09-06,2020-09-12,7,2020,"37",12801989,2619,77,2339,280,2542,0.601469037350368,2.18716013581952,0.119709277469004
"United States","Pennsylvania","PA",2020-09-13,2020-09-19,7,2020,"38",12801989,2618,119,2343,275,2499,0.929543057723296,2.14810370482274,0.117370892018779
"United States","Pennsylvania","PA",2020-09-20,2020-09-26,7,2020,"39",12801989,2678,147,2362,316,2531,1.14825907130525,2.46836643899632,0.133784928027096
"United States","Pennsylvania","PA",2020-09-27,2020-10-03,7,2020,"40",12801989,2681,96,2393,288,2585,0.749883475138121,2.24965042541436,0.120351023819473
"United States","Pennsylvania","PA",2020-10-04,2020-10-10,7,2020,"41",12801989,2769,73,2408,361,2696,0.570223892552946,2.81987431796731,0.149916943521595
"United States","Pennsylvania","PA",2020-10-11,2020-10-17,7,2020,"42",12801989,2669,194,2453,216,2475,1.51538952267495,1.68723781906077,0.088055442315532
"United States","Pennsylvania","PA",2020-10-18,2020-10-24,7,2020,"43",12801989,2766,188,2455,311,2578,1.46852180547882,2.42931000799954,0.126680244399185
"United States","Pennsylvania","PA",2020-10-25,2020-10-31,7,2020,"44",12801989,2758,158,2460,298,2600,1.23418321949816,2.32776328740792,0.121138211382114
"United States","Pennsylvania","PA",2020-11-01,2020-11-07,7,2020,"45",12801989,2984,203,2473,511,2781,1.58569109846915,3.99156724787062,0.206631621512333
"United States","Pennsylvania","PA",2020-11-08,2020-11-14,7,2020,"46",12801989,3123,259,2480,643,2864,2.02312312563306,5.02265702618554,0.259274193548387
"United States","Pennsylvania","PA",2020-11-15,2020-11-21,7,2020,"47",12801989,3355,415,2510,845,2940,3.2416837727325,6.60053683845534,0.336653386454183
"United States","Pennsylvania","PA",2020-11-22,2020-11-28,7,2020,"48",12801989,3659,586,2549,1110,3073,4.57741371282228,8.67052768128453,0.435464888191448
"United States","Pennsylvania","PA",2020-11-29,2020-12-05,7,2020,"49",12801989,3903,987,2584,1319,2916,7.70973947876381,10.3030864969498,0.510448916408669
"United States","Pennsylvania","PA",2020-12-06,2020-12-12,7,2020,"50",12801989,4355,1174,2597,1758,3181,9.17044999804327,13.7322411384668,0.676934924913362
"United States","Pennsylvania","PA",2020-12-13,2020-12-19,7,2020,"51",12801989,4456,1389,2630,1826,3067,10.8498765309047,14.263408600023,0.694296577946768
"United States","Pennsylvania","PA",2020-12-20,2020-12-26,7,2020,"52",12801989,4490,1054,2665,1825,3436,8.23309565412062,14.2555973138237,0.684803001876173
"United States","Pennsylvania","PA",2020-12-27,2021-01-02,7,2020,"53",12801989,4423,1360,2687,1736,3063,10.6233492311234,13.560392842081,0.646073688128024
"United States","Pennsylvania","PA",2021-01-03,2021-01-09,7,2021,"1",12801989,4002,1428,2740,1262,2574,11.1545166926796,9.85784318358655,0.460583941605839
"United States","Pennsylvania","PA",2021-01-10,2021-01-16,7,2021,"2",12801989,3899,1521,2795,1104,2378,11.8809663092196,8.62365996408839,0.394991055456172
"United States","Pennsylvania","PA",2021-01-17,2021-01-23,7,2021,"3",12801989,3859,1338,2805,1054,2521,10.4515009347376,8.23309565412062,0.375757575757576
"United States","Pennsylvania","PA",2021-01-24,2021-01-30,7,2021,"4",12801989,3597,1076,2803,794,2521,8.40494395050644,6.20216124228821,0.283267927220835
"United States","Pennsylvania","PA",2021-01-31,2021-02-06,7,2021,"5",12801989,3405,794,2803,602,2611,6.20216124228821,4.70239429201197,0.21476988940421
"United States","Pennsylvania","PA",2021-02-07,2021-02-13,7,2021,"6",12801989,3241,564,2765,476,2677,4.40556541643646,3.71817223089318,0.172151898734177
"United States","Pennsylvania","PA",2021-02-14,2021-02-20,7,2021,"7",12801989,3125,611,2750,375,2514,4.77269586780617,2.92923232475829,0.136363636363636
"United States","Pennsylvania","PA",2021-02-21,2021-02-27,7,2021,"8",12801989,2898,370,2746,152,2528,2.89017589376151,1.18731550230203,0.0553532410779316
"United States","Pennsylvania","PA",2021-02-28,2021-03-06,7,2021,"9",12801989,2768,381,2727,41,2387,2.97610004195442,0.320262734173573,0.015034836817015
"United States","Pennsylvania","PA",2021-03-07,2021-03-13,7,2021,"10",12801989,2705,253,2699,6,2452,1.97625540843692,0.0468677171961326,0.00222304557243413
"United States","Pennsylvania","PA",2021-03-14,2021-03-20,7,2021,"11",12801989,2805,207,2680,125,2598,1.61693624326657,0.976410774919429,0.0466417910447761
"United States","Pennsylvania","PA",2021-03-21,2021-03-27,7,2021,"12",12801989,2693,207,2665,28,2486,1.61693624326657,0.218716013581952,0.0105065666041275
"United States","Pennsylvania","PA",2021-03-28,2021-04-03,7,2021,"13",12801989,2616,201,2650,-34,2415,1.57006852607044,-0.265583730778085,-0.0128301886792452
"United States","Pennsylvania","PA",2021-04-04,2021-04-10,7,2021,"14",12801989,2770,172,2620,150,2598,1.34354122628913,1.17169292990331,0.0572519083969465
"United States","Pennsylvania","PA",2021-04-11,2021-04-17,7,2021,"15",12801989,2837,299,2582,255,2538,2.33557457360727,1.99187798083563,0.0987606506584044
"United States","Pennsylvania","PA",2021-04-18,2021-04-24,7,2021,"16",12801989,2778,277,2554,224,2501,2.16372627722145,1.74972810865562,0.0877055599060297
"United States","Pennsylvania","PA",2021-04-25,2021-05-01,7,2021,"17",12801989,2676,315,2512,164,2361,2.46055515279696,1.28105093669429,0.0652866242038217
"United States","Pennsylvania","PA",2021-05-02,2021-05-08,7,2021,"18",12801989,2719,279,2477,242,2440,2.17934884962016,1.89033126024401,0.0976988292289058
"United States","Pennsylvania","PA",2021-05-09,2021-05-15,7,2021,"19",12801989,2693,192,2468,225,2501,1.49976695027624,1.75753939485497,0.0911669367909238
"United States","Pennsylvania","PA",2021-05-16,2021-05-22,7,2021,"20",12801989,2685,305,2447,238,2380,2.38244229080341,1.85908611544659,0.0972619534123416
"United States","Pennsylvania","PA",2021-05-23,2021-05-29,7,2021,"21",12801989,2521,158,2448,73,2363,1.23418321949816,0.570223892552946,0.0298202614379084
"United States","Pennsylvania","PA",2021-05-30,2021-06-05,7,2021,"22",12801989,2611,162,2435,176,2449,1.26542836429558,1.37478637108656,0.0722792607802876
"United States","Pennsylvania","PA",2021-06-06,2021-06-12,7,2021,"23",12801989,2402,125,2456,-54,2277,0.976410774919429,-0.421809454765193,-0.0219869706840391
"United States","Pennsylvania","PA",2021-06-13,2021-06-19,7,2021,"24",12801989,2424,86,2447,-23,2338,0.671770613144567,-0.179659582585175,-0.0093992644053944
"United States","Pennsylvania","PA",2021-06-20,2021-06-26,7,2021,"25",12801989,2181,83,2437,-256,2098,0.648336754546501,-1.99968926703499,-0.105047189167009
"United States","Rhode Island","RI",2019-12-29,2020-01-04,7,2020,"1",1059361,225,0,228,-3,225,0,-0.283189583154373,-0.0131578947368421
"United States","Rhode Island","RI",2020-01-05,2020-01-11,7,2020,"2",1059361,201,0,227,-26,201,0,-2.45430972067123,-0.114537444933921
"United States","Rhode Island","RI",2020-01-12,2020-01-18,7,2020,"3",1059361,204,0,229,-25,204,0,-2.35991319295311,-0.109170305676856
"United States","Rhode Island","RI",2020-01-19,2020-01-25,7,2020,"4",1059361,199,0,226,-27,199,0,-2.54870624838936,-0.119469026548673
"United States","Rhode Island","RI",2020-01-26,2020-02-01,7,2020,"5",1059361,220,0,230,-10,220,0,-0.943965277181244,-0.0434782608695652
"United States","Rhode Island","RI",2020-02-02,2020-02-08,7,2020,"6",1059361,244,0,232,12,244,0,1.13275833261749,0.0517241379310345
"United States","Rhode Island","RI",2020-02-09,2020-02-15,7,2020,"7",1059361,183,0,229,-46,183,0,-4.34224027503372,-0.200873362445415
"United States","Rhode Island","RI",2020-02-16,2020-02-22,7,2020,"8",1059361,206,0,228,-22,206,0,-2.07672360979874,-0.0964912280701754
"United States","Rhode Island","RI",2020-02-23,2020-02-29,7,2020,"9",1059361,235,0,221,14,235,0,1.32155138805374,0.0633484162895928
"United States","Rhode Island","RI",2020-03-01,2020-03-07,7,2020,"10",1059361,251,0,221,30,251,0,2.83189583154373,0.135746606334842
"United States","Rhode Island","RI",2020-03-08,2020-03-14,7,2020,"11",1059361,196,0,218,-22,196,0,-2.07672360979874,-0.100917431192661
"United States","Rhode Island","RI",2020-03-15,2020-03-21,7,2020,"12",1059361,220,0,217,3,220,0,0.283189583154373,0.0138248847926268
"United States","Rhode Island","RI",2020-03-22,2020-03-28,7,2020,"13",1059361,200,2,211,-11,198,0.188793055436249,-1.03836180489937,-0.0521327014218009
"United States","Rhode Island","RI",2020-03-29,2020-04-04,7,2020,"14",1059361,236,13,215,21,223,1.22715486033562,1.98232708208061,0.0976744186046512
"United States","Rhode Island","RI",2020-04-05,2020-04-11,7,2020,"15",1059361,246,41,221,25,205,3.8702576364431,2.35991319295311,0.113122171945701
"United States","Rhode Island","RI",2020-04-12,2020-04-18,7,2020,"16",1059361,273,81,222,51,192,7.64611874516808,4.81422291362435,0.22972972972973
"United States","Rhode Island","RI",2020-04-19,2020-04-25,7,2020,"17",1059361,297,78,217,80,219,7.3629291620137,7.55172221744995,0.368663594470046
"United States","Rhode Island","RI",2020-04-26,2020-05-02,7,2020,"18",1059361,332,81,219,113,251,7.64611874516808,10.6668076321481,0.515981735159817
"United States","Rhode Island","RI",2020-05-03,2020-05-09,7,2020,"19",1059361,381,122,219,162,259,11.5163763816112,15.2922374903362,0.73972602739726
"United States","Rhode Island","RI",2020-05-10,2020-05-16,7,2020,"20",1059361,303,71,216,87,232,6.70215346798683,8.21249791147682,0.402777777777778
"United States","Rhode Island","RI",2020-05-17,2020-05-23,7,2020,"21",1059361,279,108,205,74,171,10.1948249935574,6.98534305114121,0.360975609756098
"United States","Rhode Island","RI",2020-05-24,2020-05-30,7,2020,"22",1059361,254,121,201,53,133,11.4219798538931,5.00301596906059,0.263681592039801
"United States","Rhode Island","RI",2020-05-31,2020-06-06,7,2020,"23",1059361,241,54,195,46,187,5.09741249677872,4.34224027503372,0.235897435897436
"United States","Rhode Island","RI",2020-06-07,2020-06-13,7,2020,"24",1059361,209,61,195,14,148,5.75818819080559,1.32155138805374,0.0717948717948718
"United States","Rhode Island","RI",2020-06-14,2020-06-20,7,2020,"25",1059361,237,61,196,41,176,5.75818819080559,3.8702576364431,0.209183673469388
"United States","Rhode Island","RI",2020-06-21,2020-06-27,7,2020,"26",1059361,200,33,195,5,167,3.11508541469811,0.471982638590622,0.0256410256410255
"United States","Rhode Island","RI",2020-06-28,2020-07-04,7,2020,"27",1059361,177,33,193,-16,144,3.11508541469811,-1.51034444348999,-0.082901554404145
"United States","Rhode Island","RI",2020-07-05,2020-07-11,7,2020,"28",1059361,190,16,192,-2,174,1.51034444348999,-0.188793055436249,-0.0104166666666666
"United States","Rhode Island","RI",2020-07-12,2020-07-18,7,2020,"29",1059361,190,14,186,4,176,1.32155138805374,0.377586110872498,0.021505376344086
"United States","Rhode Island","RI",2020-07-19,2020-07-25,7,2020,"30",1059361,173,4,185,-12,169,0.377586110872498,-1.13275833261749,-0.0648648648648649
"United States","Rhode Island","RI",2020-07-26,2020-08-01,7,2020,"31",1059361,200,-5,186,14,205,-0.471982638590622,1.32155138805374,0.075268817204301
"United States","Rhode Island","RI",2020-08-02,2020-08-08,7,2020,"32",1059361,209,5,186,23,204,0.471982638590622,2.17112013751686,0.123655913978495
"United States","Rhode Island","RI",2020-08-09,2020-08-15,7,2020,"33",1059361,211,7,185,26,204,0.660775694026871,2.45430972067123,0.14054054054054
"United States","Rhode Island","RI",2020-08-16,2020-08-22,7,2020,"34",1059361,198,7,193,5,191,0.660775694026871,0.471982638590622,0.0259067357512954
"United States","Rhode Island","RI",2020-08-23,2020-08-29,7,2020,"35",1059361,187,12,193,-6,175,1.13275833261749,-0.566379166308747,-0.0310880829015544
"United States","Rhode Island","RI",2020-08-30,2020-09-05,7,2020,"36",1059361,207,11,192,15,196,1.03836180489937,1.41594791577187,0.078125
"United States","Rhode Island","RI",2020-09-06,2020-09-12,7,2020,"37",1059361,190,11,196,-6,179,1.03836180489937,-0.566379166308747,-0.0306122448979592
"United States","Rhode Island","RI",2020-09-13,2020-09-19,7,2020,"38",1059361,194,13,196,-2,181,1.22715486033562,-0.188793055436249,-0.0102040816326531
"United States","Rhode Island","RI",2020-09-20,2020-09-26,7,2020,"39",1059361,208,23,198,10,185,2.17112013751686,0.943965277181244,0.0505050505050506
"United States","Rhode Island","RI",2020-09-27,2020-10-03,7,2020,"40",1059361,218,14,196,22,204,1.32155138805374,2.07672360979874,0.112244897959184
"United States","Rhode Island","RI",2020-10-04,2020-10-10,7,2020,"41",1059361,214,12,199,15,202,1.13275833261749,1.41594791577187,0.0753768844221105
"United States","Rhode Island","RI",2020-10-11,2020-10-17,7,2020,"42",1059361,214,12,199,15,202,1.13275833261749,1.41594791577187,0.0753768844221105
"United States","Rhode Island","RI",2020-10-18,2020-10-24,7,2020,"43",1059361,196,23,199,-3,173,2.17112013751686,-0.283189583154373,-0.0150753768844221
"United States","Rhode Island","RI",2020-10-25,2020-10-31,7,2020,"44",1059361,204,27,202,2,177,2.54870624838936,0.188793055436249,0.00990099009900991
"United States","Rhode Island","RI",2020-11-01,2020-11-07,7,2020,"45",1059361,228,23,199,29,205,2.17112013751686,2.73749930382561,0.14572864321608
"United States","Rhode Island","RI",2020-11-08,2020-11-14,7,2020,"46",1059361,235,24,197,38,211,2.26551666523499,3.58706805328873,0.192893401015228
"United States","Rhode Island","RI",2020-11-15,2020-11-21,7,2020,"47",1059361,226,31,198,28,195,2.92629235926186,2.64310277610748,0.141414141414141
"United States","Rhode Island","RI",2020-11-22,2020-11-28,7,2020,"48",1059361,268,33,205,63,235,3.11508541469811,5.94698124624184,0.307317073170732
"United States","Rhode Island","RI",2020-11-29,2020-12-05,7,2020,"49",1059361,289,62,207,82,227,5.85258471852371,7.7405152728862,0.396135265700483
"United States","Rhode Island","RI",2020-12-06,2020-12-12,7,2020,"50",1059361,325,74,209,116,251,6.98534305114121,10.9499972153024,0.555023923444976
"United States","Rhode Island","RI",2020-12-13,2020-12-19,7,2020,"51",1059361,329,98,214,115,231,9.25085971637619,10.8556006875843,0.537383177570093
"United States","Rhode Island","RI",2020-12-20,2020-12-26,7,2020,"52",1059361,302,116,218,84,186,10.9499972153024,7.92930832832245,0.385321100917431
"United States","Rhode Island","RI",2020-12-27,2021-01-02,7,2020,"53",1059361,284,85,222,62,199,8.02370485604058,5.85258471852371,0.279279279279279
"United States","Rhode Island","RI",2021-01-03,2021-01-09,7,2021,"1",1059361,295,132,220,75,163,12.4603416587924,7.07973957885933,0.340909090909091
"United States","Rhode Island","RI",2021-01-10,2021-01-16,7,2021,"2",1059361,301,71,222,79,230,6.70215346798683,7.45732568973183,0.355855855855856
"United States","Rhode Island","RI",2021-01-17,2021-01-23,7,2021,"3",1059361,315,88,225,90,227,8.30689443919495,8.4956874946312,0.4
"United States","Rhode Island","RI",2021-01-24,2021-01-30,7,2021,"4",1059361,268,73,223,45,195,6.89094652342308,4.2478437473156,0.201793721973094
"United States","Rhode Island","RI",2021-01-31,2021-02-06,7,2021,"5",1059361,274,74,220,54,200,6.98534305114121,5.09741249677872,0.245454545454545
"United States","Rhode Island","RI",2021-02-07,2021-02-13,7,2021,"6",1059361,253,67,218,35,186,6.32456735711434,3.30387847013435,0.160550458715596
"United States","Rhode Island","RI",2021-02-14,2021-02-20,7,2021,"7",1059361,226,94,218,8,132,8.87327360550369,0.755172221744995,0.036697247706422
"United States","Rhode Island","RI",2021-02-21,2021-02-27,7,2021,"8",1059361,230,137,218,12,93,12.932324297383,1.13275833261749,0.0550458715596329
"United States","Rhode Island","RI",2021-02-28,2021-03-06,7,2021,"9",1059361,231,55,214,17,176,5.19180902449684,1.60474097120812,0.0794392523364487
"United States","Rhode Island","RI",2021-03-07,2021-03-13,7,2021,"10",1059361,244,33,213,31,211,3.11508541469811,2.92629235926186,0.145539906103286
"United States","Rhode Island","RI",2021-03-14,2021-03-20,7,2021,"11",1059361,213,26,213,0,187,2.45430972067123,0,0
"United States","Rhode Island","RI",2021-03-21,2021-03-27,7,2021,"12",1059361,212,32,213,-1,180,3.02068888697998,-0.0943965277181244,-0.00469483568075113
"United States","Rhode Island","RI",2021-03-28,2021-04-03,7,2021,"13",1059361,198,36,208,-10,162,3.39827499785248,-0.943965277181244,-0.0480769230769231
"United States","Rhode Island","RI",2021-04-04,2021-04-10,7,2021,"14",1059361,220,8,208,12,212,0.755172221744995,1.13275833261749,0.0576923076923077
"United States","Rhode Island","RI",2021-04-11,2021-04-17,7,2021,"15",1059361,193,9,213,-20,184,0.84956874946312,-1.88793055436249,-0.0938967136150235
"United States","Rhode Island","RI",2021-04-18,2021-04-24,7,2021,"16",1059361,200,13,218,-18,187,1.22715486033562,-1.69913749892624,-0.0825688073394495
"United States","Rhode Island","RI",2021-04-25,2021-05-01,7,2021,"17",1059361,211,11,215,-4,200,1.03836180489937,-0.377586110872498,-0.0186046511627908
"United States","Rhode Island","RI",2021-05-02,2021-05-08,7,2021,"18",1059361,215,19,215,0,196,1.79353402664436,0,0
"United States","Rhode Island","RI",2021-05-09,2021-05-15,7,2021,"19",1059361,244,10,213,31,234,0.943965277181244,2.92629235926186,0.145539906103286
"United States","Rhode Island","RI",2021-05-16,2021-05-22,7,2021,"20",1059361,191,4,205,-14,187,0.377586110872498,-1.32155138805374,-0.0682926829268292
"United States","Rhode Island","RI",2021-05-23,2021-05-29,7,2021,"21",1059361,187,4,199,-12,183,0.377586110872498,-1.13275833261749,-0.0603015075376885
"United States","Rhode Island","RI",2021-05-30,2021-06-05,7,2021,"22",1059361,186,9,200,-14,177,0.84956874946312,-1.32155138805374,-0.07
"United States","Rhode Island","RI",2021-06-06,2021-06-12,7,2021,"23",1059361,171,5,199,-28,166,0.471982638590622,-2.64310277610748,-0.14070351758794
"United States","South Carolina","SC",2019-12-29,2020-01-04,7,2020,"1",5148714,1085,0,1102,-17,1085,0,-0.330179536093867,-0.015426497277677
"United States","South Carolina","SC",2020-01-05,2020-01-11,7,2020,"2",5148714,1081,0,1102,-21,1081,0,-0.407868838704189,-0.0190562613430127
"United States","South Carolina","SC",2020-01-12,2020-01-18,7,2020,"3",5148714,1048,0,1117,-69,1048,0,-1.34014047002805,-0.0617726051924798
"United States","South Carolina","SC",2020-01-19,2020-01-25,7,2020,"4",5148714,1033,0,1117,-84,1033,0,-1.63147535481676,-0.0752014324082364
"United States","South Carolina","SC",2020-01-26,2020-02-01,7,2020,"5",5148714,1032,0,1111,-79,1032,0,-1.53436372655385,-0.0711071107110711
"United States","South Carolina","SC",2020-02-02,2020-02-08,7,2020,"6",5148714,1096,0,1082,14,1096,0,0.271912559136126,0.0129390018484288
"United States","South Carolina","SC",2020-02-09,2020-02-15,7,2020,"7",5148714,1003,0,1064,-61,1003,0,-1.18476186480741,-0.0573308270676691
"United States","South Carolina","SC",2020-02-16,2020-02-22,7,2020,"8",5148714,1035,0,1067,-32,1035,0,-0.621514420882574,-0.0299906279287723
"United States","South Carolina","SC",2020-02-23,2020-02-29,7,2020,"9",5148714,1044,0,1055,-11,1044,0,-0.213645582178385,-0.0104265402843602
"United States","South Carolina","SC",2020-03-01,2020-03-07,7,2020,"10",5148714,1133,0,1040,93,1133,0,1.80627628568998,0.0894230769230768
"United States","South Carolina","SC",2020-03-08,2020-03-14,7,2020,"11",5148714,1103,0,1037,66,1103,0,1.28187349307031,0.0636451301832208
"United States","South Carolina","SC",2020-03-15,2020-03-21,7,2020,"12",5148714,1067,3,1028,39,1064,0.0582669769577413,0.757470700450637,0.0379377431906616
"United States","South Carolina","SC",2020-03-22,2020-03-28,7,2020,"13",5148714,1039,12,1037,2,1027,0.233067907830965,0.0388446513051609,0.00192864030858253
"United States","South Carolina","SC",2020-03-29,2020-04-04,7,2020,"14",5148714,1048,25,1025,23,1023,0.485558141314511,0.44671349000935,0.0224390243902439
"United States","South Carolina","SC",2020-04-05,2020-04-11,7,2020,"15",5148714,1138,32,1016,122,1106,0.621514420882574,2.36952372961481,0.12007874015748
"United States","South Carolina","SC",2020-04-12,2020-04-18,7,2020,"16",5148714,1049,47,1002,47,1002,0.91284930567128,0.91284930567128,0.0469061876247505
"United States","South Carolina","SC",2020-04-19,2020-04-25,7,2020,"17",5148714,1023,47,979,44,976,0.91284930567128,0.854582328713539,0.0449438202247192
"United States","South Carolina","SC",2020-04-26,2020-05-02,7,2020,"18",5148714,1033,101,968,65,932,1.96165489091062,1.26245116741773,0.0671487603305785
"United States","South Carolina","SC",2020-05-03,2020-05-09,7,2020,"19",5148714,1060,62,959,101,998,1.20418419045999,1.96165489091062,0.105318039624609
"United States","South Carolina","SC",2020-05-10,2020-05-16,7,2020,"20",5148714,1110,51,956,154,1059,0.990538608281602,2.99103815049739,0.161087866108787
"United States","South Carolina","SC",2020-05-17,2020-05-23,7,2020,"21",5148714,1046,45,953,93,1001,0.874004654366119,1.80627628568998,0.0975865687303252
"United States","South Carolina","SC",2020-05-24,2020-05-30,7,2020,"22",5148714,1048,58,955,93,990,1.12649488784967,1.80627628568998,0.0973821989528796
"United States","South Carolina","SC",2020-05-31,2020-06-06,7,2020,"23",5148714,1037,62,957,80,975,1.20418419045999,1.55378605220643,0.083594566353187
"United States","South Carolina","SC",2020-06-07,2020-06-13,7,2020,"24",5148714,1079,53,953,126,1026,1.02938325958676,2.44721303222513,0.132214060860441
"United States","South Carolina","SC",2020-06-14,2020-06-20,7,2020,"25",5148714,1052,45,942,110,1007,0.874004654366119,2.13645582178385,0.116772823779193
"United States","South Carolina","SC",2020-06-21,2020-06-27,7,2020,"26",5148714,1099,64,949,150,1035,1.24302884176515,2.91334884788706,0.158061116965227
"United States","South Carolina","SC",2020-06-28,2020-07-04,7,2020,"27",5148714,1197,99,945,252,1098,1.92281023960546,4.89442606445027,0.266666666666667
"United States","South Carolina","SC",2020-07-05,2020-07-11,7,2020,"28",5148714,1218,134,942,276,1084,2.60259163744578,5.3605618801122,0.292993630573248
"United States","South Carolina","SC",2020-07-12,2020-07-18,7,2020,"29",5148714,1335,177,943,392,1158,3.43775164050674,7.61355165581153,0.415694591728526
"United States","South Carolina","SC",2020-07-19,2020-07-25,7,2020,"30",5148714,1352,295,946,406,1057,5.72958606751123,7.88546421494766,0.429175475687104
"United States","South Carolina","SC",2020-07-26,2020-08-01,7,2020,"31",5148714,1329,271,944,385,1058,5.2634502518493,7.47759537624347,0.407838983050848
"United States","South Carolina","SC",2020-08-02,2020-08-08,7,2020,"32",5148714,1368,233,935,433,1135,4.52540187705124,8.40986700756733,0.463101604278075
"United States","South Carolina","SC",2020-08-09,2020-08-15,7,2020,"33",5148714,1319,344,929,390,975,6.68128002448767,7.57470700450637,0.419806243272336
"United States","South Carolina","SC",2020-08-16,2020-08-22,7,2020,"34",5148714,1181,233,919,262,948,4.52540187705124,5.08864932097607,0.285092491838955
"United States","South Carolina","SC",2020-08-23,2020-08-29,7,2020,"35",5148714,1240,205,917,323,1035,3.98157675877899,6.27341118578348,0.352235550708833
"United States","South Carolina","SC",2020-08-30,2020-09-05,7,2020,"36",5148714,1243,179,923,320,1064,3.4765962918119,6.21514420882574,0.346695557963164
"United States","South Carolina","SC",2020-09-06,2020-09-12,7,2020,"37",5148714,1186,163,933,253,1023,3.16583908137061,4.91384839010285,0.271168274383708
"United States","South Carolina","SC",2020-09-13,2020-09-19,7,2020,"38",5148714,1142,148,941,201,994,2.8745041965819,3.90388745616867,0.213602550478215
"United States","South Carolina","SC",2020-09-20,2020-09-26,7,2020,"39",5148714,1152,135,946,206,1017,2.62201396309836,4.00099908443157,0.217758985200846
"United States","South Carolina","SC",2020-09-27,2020-10-03,7,2020,"40",5148714,1142,119,952,190,1023,2.31125675265707,3.69024187399028,0.199579831932773
"United States","South Carolina","SC",2020-10-04,2020-10-10,7,2020,"41",5148714,1133,109,944,189,1024,2.11703349613127,3.6708195483377,0.20021186440678
"United States","South Carolina","SC",2020-10-11,2020-10-17,7,2020,"42",5148714,1062,86,946,116,976,1.67032000612192,2.25298977569933,0.12262156448203
"United States","South Carolina","SC",2020-10-18,2020-10-24,7,2020,"43",5148714,1147,156,946,201,991,3.02988280180255,3.90388745616867,0.212473572938689
"United States","South Carolina","SC",2020-10-25,2020-10-31,7,2020,"44",5148714,1225,139,955,270,1086,2.69970326570868,5.24402792619672,0.282722513089005
"United States","South Carolina","SC",2020-11-01,2020-11-07,7,2020,"45",5148714,1185,83,961,224,1102,1.61205302916418,4.35060094617802,0.23309053069719
"United States","South Carolina","SC",2020-11-08,2020-11-14,7,2020,"46",5148714,1138,95,980,158,1043,1.84512093699514,3.06872745310771,0.161224489795918
"United States","South Carolina","SC",2020-11-15,2020-11-21,7,2020,"47",5148714,1192,90,986,206,1102,1.74800930873224,4.00099908443157,0.208924949290061
"United States","South Carolina","SC",2020-11-22,2020-11-28,7,2020,"48",5148714,1214,153,995,219,1061,2.97161582484481,4.25348931791511,0.220100502512563
"United States","South Carolina","SC",2020-11-29,2020-12-05,7,2020,"49",5148714,1287,164,1000,287,1123,3.18526140702319,5.57420746229058,0.287
"United States","South Carolina","SC",2020-12-06,2020-12-12,7,2020,"50",5148714,1281,168,1013,268,1113,3.26295070963351,5.20518327489156,0.264560710760118
"United States","South Carolina","SC",2020-12-13,2020-12-19,7,2020,"51",5148714,1367,210,1027,340,1157,4.07868838704189,6.60359072187735,0.331061343719572
"United States","South Carolina","SC",2020-12-20,2020-12-26,7,2020,"52",5148714,1420,229,1043,377,1191,4.44771257444092,7.32221677102282,0.361457334611697
"United States","South Carolina","SC",2020-12-27,2021-01-02,7,2020,"53",5148714,1511,260,1052,459,1251,5.04980466967091,8.91484747453442,0.436311787072243
"United States","South Carolina","SC",2021-01-03,2021-01-09,7,2021,"1",5148714,1587,374,1073,514,1213,7.26394979406508,9.98307538542634,0.479030754892824
"United States","South Carolina","SC",2021-01-10,2021-01-16,7,2021,"2",5148714,1641,350,1080,561,1291,6.79781397840315,10.8959246910976,0.519444444444444
"United States","South Carolina","SC",2021-01-17,2021-01-23,7,2021,"3",5148714,1698,371,1082,616,1327,7.20568281710734,11.9641526019895,0.569316081330869
"United States","South Carolina","SC",2021-01-24,2021-01-30,7,2021,"4",5148714,1580,535,1082,498,1045,10.3909442241305,9.67231817498505,0.460258780036969
"United States","South Carolina","SC",2021-01-31,2021-02-06,7,2021,"5",5148714,1505,597,1077,428,908,11.5951284145905,8.31275537930442,0.397400185701021
"United States","South Carolina","SC",2021-02-07,2021-02-13,7,2021,"6",5148714,1373,302,1038,335,1071,5.86554234707929,6.50647909361444,0.322736030828516
"United States","South Carolina","SC",2021-02-14,2021-02-20,7,2021,"7",5148714,1254,344,1028,226,910,6.68128002448767,4.38944559748318,0.219844357976654
"United States","South Carolina","SC",2021-02-21,2021-02-27,7,2021,"8",5148714,1241,241,1018,223,1000,4.68078048227188,4.33117862052544,0.219056974459725
"United States","South Carolina","SC",2021-02-28,2021-03-06,7,2021,"9",5148714,1198,221,1013,185,977,4.29233396922028,3.59313024572738,0.182625863770977
"United States","South Carolina","SC",2021-03-07,2021-03-13,7,2021,"10",5148714,1169,152,1000,169,1017,2.95219349919223,3.28237303528609,0.169
"United States","South Carolina","SC",2021-03-14,2021-03-20,7,2021,"11",5148714,1053,108,1008,45,945,2.09761117047869,0.874004654366119,0.0446428571428572
"United States","South Carolina","SC",2021-03-21,2021-03-27,7,2021,"12",5148714,1104,129,1004,100,975,2.50548000918288,1.94223256525804,0.0996015936254979
"United States","South Carolina","SC",2021-03-28,2021-04-03,7,2021,"13",5148714,996,92,991,5,904,1.7868539600374,0.0971116282629022,0.00504540867810288
"United States","South Carolina","SC",2021-04-04,2021-04-10,7,2021,"14",5148714,1129,73,975,154,1056,1.41782977263837,2.99103815049739,0.157948717948718
"United States","South Carolina","SC",2021-04-11,2021-04-17,7,2021,"15",5148714,1094,48,975,119,1046,0.932271631323861,2.31125675265707,0.122051282051282
"United States","South Carolina","SC",2021-04-18,2021-04-24,7,2021,"16",5148714,1061,93,960,101,968,1.80627628568998,1.96165489091062,0.105208333333333
"United States","South Carolina","SC",2021-04-25,2021-05-01,7,2021,"17",5148714,1147,92,958,189,1055,1.7868539600374,3.6708195483377,0.197286012526096
"United States","South Carolina","SC",2021-05-02,2021-05-08,7,2021,"18",5148714,1064,80,958,106,984,1.55378605220643,2.05876651917353,0.110647181628392
"United States","South Carolina","SC",2021-05-09,2021-05-15,7,2021,"19",5148714,1077,52,952,125,1025,1.00996093393418,2.42779070657255,0.131302521008403
"United States","South Carolina","SC",2021-05-16,2021-05-22,7,2021,"20",5148714,1009,36,948,61,973,0.699203723492896,1.18476186480741,0.0643459915611815
"United States","South Carolina","SC",2021-05-23,2021-05-29,7,2021,"21",5148714,1007,54,949,58,953,1.04880558523934,1.12649488784967,0.0611169652265542
"United States","South Carolina","SC",2021-05-30,2021-06-05,7,2021,"22",5148714,1012,24,941,71,988,0.46613581566193,1.37898512133321,0.0754516471838469
"United States","South Carolina","SC",2021-06-06,2021-06-12,7,2021,"23",5148714,1009,24,931,78,985,0.46613581566193,1.51494140090127,0.083780880773362
"United States","South Carolina","SC",2021-06-13,2021-06-19,7,2021,"24",5148714,1026,16,936,90,1010,0.310757210441287,1.74800930873224,0.0961538461538463
"United States","South Carolina","SC",2021-06-20,2021-06-26,7,2021,"25",5148714,892,27,929,-37,865,0.524402792619672,-0.718626049145476,-0.0398277717976319
"United States","South Dakota","SD",2019-12-29,2020-01-04,7,2020,"1",884659,170,0,166,4,170,0,0.452151620002736,0.0240963855421688
"United States","South Dakota","SD",2020-01-05,2020-01-11,7,2020,"2",884659,170,0,167,3,170,0,0.339113715002052,0.0179640718562875
"United States","South Dakota","SD",2020-01-12,2020-01-18,7,2020,"3",884659,168,0,169,-1,168,0,-0.113037905000684,-0.00591715976331364
"United States","South Dakota","SD",2020-01-19,2020-01-25,7,2020,"4",884659,151,0,170,-19,151,0,-2.14772019501299,-0.111764705882353
"United States","South Dakota","SD",2020-01-26,2020-02-01,7,2020,"5",884659,162,0,169,-7,162,0,-0.791265335004787,-0.0414201183431953
"United States","South Dakota","SD",2020-02-02,2020-02-08,7,2020,"6",884659,150,0,170,-20,150,0,-2.26075810001368,-0.117647058823529
"United States","South Dakota","SD",2020-02-09,2020-02-15,7,2020,"7",884659,178,0,168,10,178,0,1.13037905000684,0.0595238095238095
"United States","South Dakota","SD",2020-02-16,2020-02-22,7,2020,"8",884659,177,0,166,11,177,0,1.24341695500752,0.0662650602409638
"United States","South Dakota","SD",2020-02-23,2020-02-29,7,2020,"9",884659,163,0,164,-1,163,0,-0.113037905000684,-0.00609756097560976
"United States","South Dakota","SD",2020-03-01,2020-03-07,7,2020,"10",884659,194,0,162,32,194,0,3.61721296002188,0.197530864197531
"United States","South Dakota","SD",2020-03-08,2020-03-14,7,2020,"11",884659,166,1,162,4,165,0.113037905000684,0.452151620002736,0.0246913580246915
"United States","South Dakota","SD",2020-03-15,2020-03-21,7,2020,"12",884659,162,0,160,2,162,0,0.226075810001368,0.0125
"United States","South Dakota","SD",2020-03-22,2020-03-28,7,2020,"13",884659,149,0,160,-11,149,0,-1.24341695500752,-0.06875
"United States","South Dakota","SD",2020-03-29,2020-04-04,7,2020,"14",884659,170,1,160,10,169,0.113037905000684,1.13037905000684,0.0625
"United States","South Dakota","SD",2020-04-05,2020-04-11,7,2020,"15",884659,150,3,158,-8,147,0.339113715002052,-0.904303240005471,-0.0506329113924051
"United States","South Dakota","SD",2020-04-12,2020-04-18,7,2020,"16",884659,154,2,155,-1,152,0.226075810001368,-0.113037905000684,-0.00645161290322582
"United States","South Dakota","SD",2020-04-19,2020-04-25,7,2020,"17",884659,176,3,154,22,173,0.339113715002052,2.48683391001505,0.142857142857143
"United States","South Dakota","SD",2020-04-26,2020-05-02,7,2020,"18",884659,159,11,151,8,148,1.24341695500752,0.904303240005471,0.0529801324503312
"United States","South Dakota","SD",2020-05-03,2020-05-09,7,2020,"19",884659,181,13,149,32,168,1.46949276500889,3.61721296002188,0.214765100671141
"United States","South Dakota","SD",2020-05-10,2020-05-16,7,2020,"20",884659,147,10,146,1,137,1.13037905000684,0.113037905000684,0.00684931506849318
"United States","South Dakota","SD",2020-05-17,2020-05-23,7,2020,"21",884659,162,6,146,16,156,0.678227430004103,1.80860648001094,0.10958904109589
"United States","South Dakota","SD",2020-05-24,2020-05-30,7,2020,"22",884659,157,10,149,8,147,1.13037905000684,0.904303240005471,0.0536912751677852
"United States","South Dakota","SD",2020-05-31,2020-06-06,7,2020,"23",884659,147,5,146,1,142,0.565189525003419,0.113037905000684,0.00684931506849318
"United States","South Dakota","SD",2020-06-07,2020-06-13,7,2020,"24",884659,159,10,146,13,149,1.13037905000684,1.46949276500889,0.0890410958904109
"United States","South Dakota","SD",2020-06-14,2020-06-20,7,2020,"25",884659,176,6,148,28,170,0.678227430004103,3.16506134001915,0.189189189189189
"United States","South Dakota","SD",2020-06-21,2020-06-27,7,2020,"26",884659,163,10,143,20,153,1.13037905000684,2.26075810001368,0.13986013986014
"United States","South Dakota","SD",2020-06-28,2020-07-04,7,2020,"27",884659,160,6,143,17,154,0.678227430004103,1.92164438501163,0.118881118881119
"United States","South Dakota","SD",2020-07-05,2020-07-11,7,2020,"28",884659,172,12,145,27,160,1.35645486000821,3.05202343501846,0.186206896551724
"United States","South Dakota","SD",2020-07-12,2020-07-18,7,2020,"29",884659,158,7,146,12,151,0.791265335004787,1.35645486000821,0.0821917808219179
"United States","South Dakota","SD",2020-07-19,2020-07-25,7,2020,"30",884659,173,6,144,29,167,0.678227430004103,3.27809924501983,0.201388888888889
"United States","South Dakota","SD",2020-07-26,2020-08-01,7,2020,"31",884659,151,12,144,7,139,1.35645486000821,0.791265335004787,0.0486111111111112
"United States","South Dakota","SD",2020-08-02,2020-08-08,7,2020,"32",884659,187,12,138,49,175,1.35645486000821,5.53885734503351,0.355072463768116
"United States","South Dakota","SD",2020-08-09,2020-08-15,7,2020,"33",884659,162,6,141,21,156,0.678227430004103,2.37379600501436,0.148936170212766
"United States","South Dakota","SD",2020-08-16,2020-08-22,7,2020,"34",884659,169,7,140,29,162,0.791265335004787,3.27809924501983,0.207142857142857
"United States","South Dakota","SD",2020-08-23,2020-08-29,7,2020,"35",884659,189,8,139,50,181,0.904303240005471,5.65189525003419,0.359712230215827
"United States","South Dakota","SD",2020-08-30,2020-09-05,7,2020,"36",884659,209,6,137,72,203,0.678227430004103,8.13872916004924,0.525547445255474
"United States","South Dakota","SD",2020-09-06,2020-09-12,7,2020,"37",884659,182,10,139,43,172,1.13037905000684,4.86062991502941,0.309352517985612
"United States","South Dakota","SD",2020-09-13,2020-09-19,7,2020,"38",884659,181,17,139,42,164,1.92164438501163,4.74759201002872,0.302158273381295
"United States","South Dakota","SD",2020-09-20,2020-09-26,7,2020,"39",884659,191,18,144,47,173,2.03468229001231,5.31278153503214,0.326388888888889
"United States","South Dakota","SD",2020-09-27,2020-10-03,7,2020,"40",884659,206,30,152,54,176,3.39113715002052,6.10404687003693,0.355263157894737
"United States","South Dakota","SD",2020-10-04,2020-10-10,7,2020,"41",884659,215,38,152,63,177,4.29544039002599,7.12138801504308,0.414473684210526
"United States","South Dakota","SD",2020-10-11,2020-10-17,7,2020,"42",884659,201,29,157,44,172,3.27809924501983,4.97366782003009,0.280254777070064
"United States","South Dakota","SD",2020-10-18,2020-10-24,7,2020,"43",884659,243,51,159,84,192,5.76493315503488,9.49518402005745,0.528301886792453
"United States","South Dakota","SD",2020-10-25,2020-10-31,7,2020,"44",884659,243,59,158,85,184,6.66923639504035,9.60822192505813,0.537974683544304
"United States","South Dakota","SD",2020-11-01,2020-11-07,7,2020,"45",884659,356,98,153,203,258,11.077714690067,22.9466947151388,1.32679738562092
"United States","South Dakota","SD",2020-11-08,2020-11-14,7,2020,"46",884659,343,98,157,186,245,11.077714690067,21.0250503301272,1.18471337579618
"United States","South Dakota","SD",2020-11-15,2020-11-21,7,2020,"47",884659,335,120,155,180,215,13.5645486000821,20.3468229001231,1.16129032258065
"United States","South Dakota","SD",2020-11-22,2020-11-28,7,2020,"48",884659,335,201,154,181,134,22.7206189051375,20.4598608051238,1.17532467532468
"United States","South Dakota","SD",2020-11-29,2020-12-05,7,2020,"49",884659,305,148,159,146,157,16.7296099401012,16.5035341300998,0.918238993710692
"United States","South Dakota","SD",2020-12-06,2020-12-12,7,2020,"50",884659,283,153,161,122,130,17.2947994651046,13.7906244100834,0.75776397515528
"United States","South Dakota","SD",2020-12-13,2020-12-19,7,2020,"51",884659,236,107,158,78,129,12.0950558350732,8.81695659005334,0.493670886075949
"United States","South Dakota","SD",2020-12-20,2020-12-26,7,2020,"52",884659,206,31,160,46,175,3.5041750550212,5.19974363003146,0.2875
"United States","South Dakota","SD",2020-12-27,2021-01-02,7,2020,"53",884659,211,120,163,48,91,13.5645486000821,5.42581944003283,0.294478527607362
"United States","South Dakota","SD",2021-01-03,2021-01-09,7,2021,"1",884659,219,69,166,53,150,7.79961544504719,5.99100896503625,0.319277108433735
"United States","South Dakota","SD",2021-01-10,2021-01-16,7,2021,"2",884659,191,63,169,22,128,7.12138801504308,2.48683391001505,0.130177514792899
"United States","South Dakota","SD",2021-01-17,2021-01-23,7,2021,"3",884659,192,63,170,22,129,7.12138801504308,2.48683391001505,0.129411764705882
"United States","South Dakota","SD",2021-01-24,2021-01-30,7,2021,"4",884659,206,79,172,34,127,8.92999449505403,3.84328877002325,0.197674418604651
"United States","South Dakota","SD",2021-01-31,2021-02-06,7,2021,"5",884659,191,29,172,19,162,3.27809924501983,2.14772019501299,0.11046511627907
"United States","South Dakota","SD",2021-02-07,2021-02-13,7,2021,"6",884659,183,34,174,9,149,3.84328877002325,1.01734114500615,0.0517241379310345
"United States","South Dakota","SD",2021-02-14,2021-02-20,7,2021,"7",884659,170,21,173,-3,149,2.37379600501436,-0.339113715002052,-0.0173410404624278
"United States","South Dakota","SD",2021-02-21,2021-02-27,7,2021,"8",884659,182,29,177,5,153,3.27809924501983,0.565189525003419,0.0282485875706215
"United States","South Dakota","SD",2021-02-28,2021-03-06,7,2021,"9",884659,171,8,178,-7,163,0.904303240005471,-0.791265335004787,-0.0393258426966292
"United States","South Dakota","SD",2021-03-07,2021-03-13,7,2021,"10",884659,187,12,176,11,175,1.35645486000821,1.24341695500752,0.0625
"United States","South Dakota","SD",2021-03-14,2021-03-20,7,2021,"11",884659,158,11,178,-20,147,1.24341695500752,-2.26075810001368,-0.112359550561798
"United States","South Dakota","SD",2021-03-21,2021-03-27,7,2021,"12",884659,168,14,173,-5,154,1.58253067000957,-0.565189525003419,-0.0289017341040463
"United States","South Dakota","SD",2021-03-28,2021-04-03,7,2021,"13",884659,154,14,173,-19,140,1.58253067000957,-2.14772019501299,-0.109826589595376
"United States","South Dakota","SD",2021-04-04,2021-04-10,7,2021,"14",884659,144,-1,170,-26,145,-0.113037905000684,-2.93898553001778,-0.152941176470588
"United States","South Dakota","SD",2021-04-11,2021-04-17,7,2021,"15",884659,174,7,173,1,167,0.791265335004787,0.113037905000684,0.0057803468208093
"United States","South Dakota","SD",2021-04-18,2021-04-24,7,2021,"16",884659,170,0,172,-2,170,0,-0.226075810001368,-0.0116279069767442
"United States","South Dakota","SD",2021-04-25,2021-05-01,7,2021,"17",884659,156,14,169,-13,142,1.58253067000957,-1.46949276500889,-0.0769230769230769
"United States","South Dakota","SD",2021-05-02,2021-05-08,7,2021,"18",884659,172,12,166,6,160,1.35645486000821,0.678227430004103,0.036144578313253
"United States","South Dakota","SD",2021-05-09,2021-05-15,7,2021,"19",884659,163,12,166,-3,151,1.35645486000821,-0.339113715002052,-0.0180722891566265
"United States","South Dakota","SD",2021-05-16,2021-05-22,7,2021,"20",884659,150,10,162,-12,140,1.13037905000684,-1.35645486000821,-0.0740740740740741
"United States","South Dakota","SD",2021-05-23,2021-05-29,7,2021,"21",884659,135,9,165,-30,126,1.01734114500615,-3.39113715002052,-0.181818181818182
"United States","South Dakota","SD",2021-05-30,2021-06-05,7,2021,"22",884659,138,12,169,-31,126,1.35645486000821,-3.5041750550212,-0.183431952662722
"United States","South Dakota","SD",2021-06-06,2021-06-12,7,2021,"23",884659,142,4,165,-23,138,0.452151620002736,-2.59987181501573,-0.139393939393939
"United States","South Dakota","SD",2021-06-13,2021-06-19,7,2021,"24",884659,116,1,165,-49,115,0.113037905000684,-5.53885734503351,-0.296969696969697
"United States","South Dakota","SD",2021-06-20,2021-06-26,7,2021,"25",884659,133,3,168,-35,130,0.339113715002052,-3.95632667502394,-0.208333333333333
"United States","Tennessee","TN",2019-12-29,2020-01-04,7,2020,"1",6833174,1614,0,1643,-29,1614,0,-0.424400139671549,-0.0176506390748631
"United States","Tennessee","TN",2020-01-05,2020-01-11,7,2020,"2",6833174,1687,0,1633,54,1687,0,0.790262329043575,0.0330679730557257
"United States","Tennessee","TN",2020-01-12,2020-01-18,7,2020,"3",6833174,1597,0,1642,-45,1597,0,-0.658551940869646,-0.0274056029232643
"United States","Tennessee","TN",2020-01-19,2020-01-25,7,2020,"4",6833174,1532,0,1640,-108,1532,0,-1.58052465808715,-0.0658536585365853
"United States","Tennessee","TN",2020-01-26,2020-02-01,7,2020,"5",6833174,1591,0,1630,-39,1591,0,-0.57074501542036,-0.0239263803680981
"United States","Tennessee","TN",2020-02-02,2020-02-08,7,2020,"6",6833174,1612,0,1600,12,1612,0,0.175613850898572,0.00750000000000006
"United States","Tennessee","TN",2020-02-09,2020-02-15,7,2020,"7",6833174,1454,0,1584,-130,1454,0,-1.90248338473453,-0.0820707070707071
"United States","Tennessee","TN",2020-02-16,2020-02-22,7,2020,"8",6833174,1516,0,1565,-49,1516,0,-0.71708989116917,-0.0313099041533547
"United States","Tennessee","TN",2020-02-23,2020-02-29,7,2020,"9",6833174,1504,0,1556,-52,1504,0,-0.760993353893813,-0.0334190231362468
"United States","Tennessee","TN",2020-03-01,2020-03-07,7,2020,"10",6833174,1611,0,1540,71,1611,0,1.03904861781655,0.0461038961038962
"United States","Tennessee","TN",2020-03-08,2020-03-14,7,2020,"11",6833174,1601,0,1539,62,1601,0,0.907338229642623,0.0402858999350229
"United States","Tennessee","TN",2020-03-15,2020-03-21,7,2020,"12",6833174,1526,1,1538,-12,1525,0.014634487574881,-0.175613850898572,-0.00780234070221064
"United States","Tennessee","TN",2020-03-22,2020-03-28,7,2020,"13",6833174,1528,5,1528,0,1523,0.0731724378744051,0,0
"United States","Tennessee","TN",2020-03-29,2020-04-04,7,2020,"14",6833174,1593,37,1504,89,1556,0.541476040270597,1.30246939416441,0.0591755319148937
"United States","Tennessee","TN",2020-04-05,2020-04-11,7,2020,"15",6833174,1514,58,1501,13,1456,0.848800279343099,0.190248338473453,0.00866089273817461
"United States","Tennessee","TN",2020-04-12,2020-04-18,7,2020,"16",6833174,1541,44,1489,52,1497,0.643917453294765,0.760993353893813,0.0349227669576897
"United States","Tennessee","TN",2020-04-19,2020-04-25,7,2020,"17",6833174,1483,33,1466,17,1450,0.482938089971073,0.248786288772977,0.0115961800818554
"United States","Tennessee","TN",2020-04-26,2020-05-02,7,2020,"18",6833174,1495,31,1445,50,1464,0.453669114821311,0.731724378744051,0.0346020761245676
"United States","Tennessee","TN",2020-05-03,2020-05-09,7,2020,"19",6833174,1492,33,1436,56,1459,0.482938089971073,0.819531304193337,0.0389972144846797
"United States","Tennessee","TN",2020-05-10,2020-05-16,7,2020,"20",6833174,1544,53,1415,129,1491,0.775627841468694,1.88784889715965,0.0911660777385159
"United States","Tennessee","TN",2020-05-17,2020-05-23,7,2020,"21",6833174,1557,30,1415,142,1527,0.43903462724643,2.0780972356331,0.100353356890459
"United States","Tennessee","TN",2020-05-24,2020-05-30,7,2020,"22",6833174,1467,39,1419,48,1428,0.57074501542036,0.702455403594289,0.0338266384778012
"United States","Tennessee","TN",2020-05-31,2020-06-06,7,2020,"23",6833174,1485,49,1418,67,1436,0.71708989116917,0.980510667517028,0.0472496473906912
"United States","Tennessee","TN",2020-06-07,2020-06-13,7,2020,"24",6833174,1500,52,1413,87,1448,0.760993353893813,1.27320041901465,0.0615711252653928
"United States","Tennessee","TN",2020-06-14,2020-06-20,7,2020,"25",6833174,1570,51,1416,154,1519,0.746358866318932,2.25371108653168,0.108757062146893
"United States","Tennessee","TN",2020-06-21,2020-06-27,7,2020,"26",6833174,1562,61,1425,137,1501,0.892703742067742,2.0049247977587,0.096140350877193
"United States","Tennessee","TN",2020-06-28,2020-07-04,7,2020,"27",6833174,1533,52,1411,122,1481,0.760993353893813,1.78540748413548,0.0864635010630759
"United States","Tennessee","TN",2020-07-05,2020-07-11,7,2020,"28",6833174,1634,99,1407,227,1535,1.44881426991322,3.32202867949799,0.16133617626155
"United States","Tennessee","TN",2020-07-12,2020-07-18,7,2020,"29",6833174,1650,100,1423,227,1550,1.4634487574881,3.32202867949799,0.159522136331694
"United States","Tennessee","TN",2020-07-19,2020-07-25,7,2020,"30",6833174,1710,136,1410,300,1574,1.99029031018382,4.3903462724643,0.212765957446809
"United States","Tennessee","TN",2020-07-26,2020-08-01,7,2020,"31",6833174,1713,103,1390,323,1610,1.50735222021274,4.72693948668657,0.232374100719424
"United States","Tennessee","TN",2020-08-02,2020-08-08,7,2020,"32",6833174,1707,148,1379,328,1559,2.16590416108239,4.80011192456097,0.237853517041334
"United States","Tennessee","TN",2020-08-09,2020-08-15,7,2020,"33",6833174,1678,130,1370,308,1548,1.90248338473453,4.50742217306335,0.224817518248175
"United States","Tennessee","TN",2020-08-16,2020-08-22,7,2020,"34",6833174,1687,218,1359,328,1469,3.19031829132406,4.80011192456097,0.241353936718175
"United States","Tennessee","TN",2020-08-23,2020-08-29,7,2020,"35",6833174,1709,162,1363,346,1547,2.37078698713072,5.06353270090883,0.253851797505503
"United States","Tennessee","TN",2020-08-30,2020-09-05,7,2020,"36",6833174,1624,137,1377,247,1487,2.0049247977587,3.61471843099561,0.179375453885258
"United States","Tennessee","TN",2020-09-06,2020-09-12,7,2020,"37",6833174,1727,202,1375,352,1525,2.95616649012596,5.15133962635812,0.256
"United States","Tennessee","TN",2020-09-13,2020-09-19,7,2020,"38",6833174,1620,152,1377,243,1468,2.22444211138191,3.55618048069609,0.176470588235294
"United States","Tennessee","TN",2020-09-20,2020-09-26,7,2020,"39",6833174,1743,158,1389,354,1585,2.3122490368312,5.18060860150788,0.254859611231101
"United States","Tennessee","TN",2020-09-27,2020-10-03,7,2020,"40",6833174,1732,186,1381,351,1546,2.72201468892787,5.13670513878324,0.254163649529327
"United States","Tennessee","TN",2020-10-04,2020-10-10,7,2020,"41",6833174,1769,198,1390,379,1571,2.89762853982644,5.5464707908799,0.272661870503597
"United States","Tennessee","TN",2020-10-11,2020-10-17,7,2020,"42",6833174,1784,145,1404,380,1639,2.12200069835775,5.56110527845479,0.270655270655271
"United States","Tennessee","TN",2020-10-18,2020-10-24,7,2020,"43",6833174,1788,197,1412,376,1591,2.88299405225156,5.50256732815526,0.26628895184136
"United States","Tennessee","TN",2020-10-25,2020-10-31,7,2020,"44",6833174,1841,251,1411,430,1590,3.67325638129513,6.29282965719884,0.304748405386251
"United States","Tennessee","TN",2020-11-01,2020-11-07,7,2020,"45",6833174,1815,236,1440,375,1579,3.45373906767192,5.48793284058038,0.260416666666667
"United States","Tennessee","TN",2020-11-08,2020-11-14,7,2020,"46",6833174,1935,290,1447,488,1645,4.24400139671549,7.14162993654193,0.337249481686247
"United States","Tennessee","TN",2020-11-15,2020-11-21,7,2020,"47",6833174,2001,324,1463,538,1677,4.74157397426145,7.87335431528599,0.367737525632263
"United States","Tennessee","TN",2020-11-22,2020-11-28,7,2020,"48",6833174,1919,333,1496,423,1586,4.87328436243538,6.19038824417467,0.282754010695187
"United States","Tennessee","TN",2020-11-29,2020-12-05,7,2020,"49",6833174,2200,365,1525,675,1835,5.34158796483157,9.87827911304468,0.442622950819672
"United States","Tennessee","TN",2020-12-06,2020-12-12,7,2020,"50",6833174,2188,499,1535,653,1689,7.30260929986563,9.5563203863973,0.425407166123779
"United States","Tennessee","TN",2020-12-13,2020-12-19,7,2020,"51",6833174,2174,562,1560,614,1612,8.22458201708313,8.98557537097694,0.393589743589744
"United States","Tennessee","TN",2020-12-20,2020-12-26,7,2020,"52",6833174,2361,481,1579,782,1880,7.03918852351777,11.444169283557,0.495250158328056
"United States","Tennessee","TN",2020-12-27,2021-01-02,7,2020,"53",6833174,2365,529,1577,788,1836,7.74164392711206,11.5319762090062,0.499682942295498
"United States","Tennessee","TN",2021-01-03,2021-01-09,7,2021,"1",6833174,2425,734,1597,828,1691,10.7417138799627,12.1173557120015,0.518472135253601
"United States","Tennessee","TN",2021-01-10,2021-01-16,7,2021,"2",6833174,2315,651,1611,704,1664,9.52705141124754,10.3026792527162,0.43699565487275
"United States","Tennessee","TN",2021-01-17,2021-01-23,7,2021,"3",6833174,2293,463,1602,691,1830,6.77576774716991,10.1124309142428,0.431335830212235
"United States","Tennessee","TN",2021-01-24,2021-01-30,7,2021,"4",6833174,2088,756,1605,483,1332,11.06367260661,7.06845749866753,0.300934579439252
"United States","Tennessee","TN",2021-01-31,2021-02-06,7,2021,"5",6833174,1952,889,1607,345,1063,13.0100594540692,5.04889821333395,0.214685749844431
"United States","Tennessee","TN",2021-02-07,2021-02-13,7,2021,"6",6833174,1776,468,1583,193,1308,6.84894018504431,2.82445610195204,0.121920404295641
"United States","Tennessee","TN",2021-02-14,2021-02-20,7,2021,"7",6833174,1797,199,1558,239,1598,2.91226302740132,3.49764253039656,0.153401797175867
"United States","Tennessee","TN",2021-02-21,2021-02-27,7,2021,"8",6833174,1755,274,1536,219,1481,4.0098495955174,3.20495277889894,0.142578125
"United States","Tennessee","TN",2021-02-28,2021-03-06,7,2021,"9",6833174,1666,146,1535,131,1520,2.13663518593263,1.91711787230941,0.085342019543974
"United States","Tennessee","TN",2021-03-07,2021-03-13,7,2021,"10",6833174,1603,96,1517,86,1507,1.40491080718858,1.25856593143977,0.0566908371786421
"United States","Tennessee","TN",2021-03-14,2021-03-20,7,2021,"11",6833174,1577,73,1516,61,1504,1.06831759296631,0.892703742067742,0.0402374670184698
"United States","Tennessee","TN",2021-03-21,2021-03-27,7,2021,"12",6833174,1655,102,1516,139,1553,1.49271773263786,2.03419377290846,0.091688654353562
"United States","Tennessee","TN",2021-03-28,2021-04-03,7,2021,"13",6833174,1568,94,1524,44,1474,1.37564183203882,0.643917453294765,0.0288713910761156
"United States","Tennessee","TN",2021-04-04,2021-04-10,7,2021,"14",6833174,1691,86,1511,180,1605,1.25856593143977,2.63420776347858,0.119126406353408
"United States","Tennessee","TN",2021-04-11,2021-04-17,7,2021,"15",6833174,1618,65,1510,108,1553,0.951241692367266,1.58052465808715,0.0715231788079471
"United States","Tennessee","TN",2021-04-18,2021-04-24,7,2021,"16",6833174,1677,80,1484,193,1597,1.17075900599048,2.82445610195204,0.130053908355795
"United States","Tennessee","TN",2021-04-25,2021-05-01,7,2021,"17",6833174,1641,58,1480,161,1583,0.848800279343099,2.35615249955584,0.108783783783784
"United States","Tennessee","TN",2021-05-02,2021-05-08,7,2021,"18",6833174,1645,53,1478,167,1592,0.775627841468694,2.44395942500513,0.112990527740189
"United States","Tennessee","TN",2021-05-09,2021-05-15,7,2021,"19",6833174,1637,55,1466,171,1582,0.804896816618456,2.50249737530465,0.116643929058663
"United States","Tennessee","TN",2021-05-16,2021-05-22,7,2021,"20",6833174,1556,68,1461,95,1488,0.995145155091909,1.3902763196137,0.0650239561943875
"United States","Tennessee","TN",2021-05-23,2021-05-29,7,2021,"21",6833174,1535,61,1461,74,1474,0.892703742067742,1.08295208054119,0.0506502395619439
"United States","Tennessee","TN",2021-05-30,2021-06-05,7,2021,"22",6833174,1530,35,1442,88,1495,0.512207065120835,1.28783490658953,0.0610263522884882
"United States","Tennessee","TN",2021-06-06,2021-06-12,7,2021,"23",6833174,1623,22,1441,182,1601,0.321958726647382,2.66347673862834,0.126301179736294
"United States","Tennessee","TN",2021-06-13,2021-06-19,7,2021,"24",6833174,1439,18,1434,5,1421,0.263420776347858,0.0731724378744051,0.00348675034867507
"United States","Tennessee","TN",2021-06-20,2021-06-26,7,2021,"25",6833174,1183,34,1425,-242,1149,0.497572577545954,-3.5415459931212,-0.169824561403509
"United States","Texas","TX",2019-12-29,2020-01-04,7,2020,"1",28995881,4325,0,4478,-153,4325,0,-0.527661152975486,-0.0341670388566324
"United States","Texas","TX",2020-01-05,2020-01-11,7,2020,"2",28995881,4564,0,4471,93,4564,0,0.320735210632158,0.0208007157235517
"United States","Texas","TX",2020-01-12,2020-01-18,7,2020,"3",28995881,4250,0,4462,-212,4250,0,-0.731138329613092,-0.0475123263110713
"United States","Texas","TX",2020-01-19,2020-01-25,7,2020,"4",28995881,4128,0,4499,-371,4128,0,-1.27949207682291,-0.0824627695043343
"United States","Texas","TX",2020-01-26,2020-02-01,7,2020,"5",28995881,4174,0,4484,-310,4174,0,-1.06911736877386,-0.0691347011596789
"United States","Texas","TX",2020-02-02,2020-02-08,7,2020,"6",28995881,4322,0,4426,-104,4322,0,-0.358671633395102,-0.0234975146859466
"United States","Texas","TX",2020-02-09,2020-02-15,7,2020,"7",28995881,4343,0,4404,-61,4343,0,-0.21037470804905,-0.0138510445049954
"United States","Texas","TX",2020-02-16,2020-02-22,7,2020,"8",28995881,4221,0,4368,-147,4221,0,-0.506968558741154,-0.0336538461538461
"United States","Texas","TX",2020-02-23,2020-02-29,7,2020,"9",28995881,4146,0,4305,-159,4146,0,-0.548353747209819,-0.0369337979094077
"United States","Texas","TX",2020-03-01,2020-03-07,7,2020,"10",28995881,4172,0,4262,-90,4172,0,-0.310388913514992,-0.0211168465509151
"United States","Texas","TX",2020-03-08,2020-03-14,7,2020,"11",28995881,4169,0,4209,-40,4169,0,-0.137950628228885,-0.00950344499881206
"United States","Texas","TX",2020-03-15,2020-03-21,7,2020,"12",28995881,4256,5,4139,117,4251,0.0172438285286107,0.40350558756949,0.0282676975114762
"United States","Texas","TX",2020-03-22,2020-03-28,7,2020,"13",28995881,4259,25,4087,172,4234,0.0862191426430533,0.593187701384207,0.0420846586738439
"United States","Texas","TX",2020-03-29,2020-04-04,7,2020,"14",28995881,4186,77,4040,146,4109,0.265554959340604,0.503519793035431,0.0361386138613862
"United States","Texas","TX",2020-04-05,2020-04-11,7,2020,"15",28995881,4266,147,3998,268,4119,0.506968558741154,0.924269209133532,0.0670335167583791
"United States","Texas","TX",2020-04-12,2020-04-18,7,2020,"16",28995881,4294,199,3984,310,4095,0.686304375438704,1.06911736877386,0.0778112449799198
"United States","Texas","TX",2020-04-19,2020-04-25,7,2020,"17",28995881,4464,169,3948,516,4295,0.582841404267041,1.77956310415262,0.130699088145897
"United States","Texas","TX",2020-04-26,2020-05-02,7,2020,"18",28995881,4263,224,3931,332,4039,0.772523518081758,1.14499021429975,0.0844568812007123
"United States","Texas","TX",2020-05-03,2020-05-09,7,2020,"19",28995881,4278,202,3917,361,4076,0.696650672555871,1.24500441976569,0.0921623691600715
"United States","Texas","TX",2020-05-10,2020-05-16,7,2020,"20",28995881,4280,256,3903,377,4024,0.882884020664866,1.30018467105724,0.0965923648475531
"United States","Texas","TX",2020-05-17,2020-05-23,7,2020,"21",28995881,4255,199,3865,390,4056,0.686304375438704,1.34501862523163,0.100905562742561
"United States","Texas","TX",2020-05-24,2020-05-30,7,2020,"22",28995881,4156,142,3858,298,4014,0.489724730212543,1.0277321803052,0.0772420943494039
"United States","Texas","TX",2020-05-31,2020-06-06,7,2020,"23",28995881,4229,169,3864,365,4060,0.582841404267041,1.25879948258858,0.0944616977225672
"United States","Texas","TX",2020-06-07,2020-06-13,7,2020,"24",28995881,4396,141,3879,517,4255,0.486275964506821,1.78301186985834,0.133281773653003
"United States","Texas","TX",2020-06-14,2020-06-20,7,2020,"25",28995881,4509,207,3850,659,4302,0.713894501084482,2.27273660007089,0.171168831168831
"United States","Texas","TX",2020-06-21,2020-06-27,7,2020,"26",28995881,4566,204,3850,716,4362,0.703548203967315,2.46931624529705,0.185974025974026
"United States","Texas","TX",2020-06-28,2020-07-04,7,2020,"27",28995881,5036,242,3836,1200,4794,0.834601300784756,4.13851884686656,0.312825860271116
"United States","Texas","TX",2020-07-05,2020-07-11,7,2020,"28",28995881,5772,504,3815,1957,5268,1.73817791568396,6.74923448609821,0.512975098296199
"United States","Texas","TX",2020-07-12,2020-07-18,7,2020,"29",28995881,6264,753,3816,2448,5511,2.59692057640877,8.44257844760778,0.641509433962264
"United States","Texas","TX",2020-07-19,2020-07-25,7,2020,"30",28995881,6308,1020,3832,2476,5288,3.51774101983658,8.539143887368,0.646137787056367
"United States","Texas","TX",2020-07-26,2020-08-01,7,2020,"31",28995881,5953,1950,3813,2140,4003,6.72509312615816,7.38035861024536,0.561237870443221
"United States","Texas","TX",2020-08-02,2020-08-08,7,2020,"32",28995881,5712,1506,3819,1893,4206,5.19384115281753,6.528513480932,0.495679497250589
"United States","Texas","TX",2020-08-09,2020-08-15,7,2020,"33",28995881,5782,1498,3819,1963,4284,5.16625102717176,6.76992708033255,0.51400890285415
"United States","Texas","TX",2020-08-16,2020-08-22,7,2020,"34",28995881,5033,1423,3797,1236,3610,4.9075935992426,4.26267441227256,0.325520147484856
"United States","Texas","TX",2020-08-23,2020-08-29,7,2020,"35",28995881,5137,1154,3792,1345,3983,3.97987562440334,4.63858987419627,0.354694092827004
"United States","Texas","TX",2020-08-30,2020-09-05,7,2020,"36",28995881,4942,987,3794,1148,3955,3.40393175154775,3.95918303016901,0.302583025830258
"United States","Texas","TX",2020-09-06,2020-09-12,7,2020,"37",28995881,4654,735,3773,881,3919,2.53484279370577,3.0383625867412,0.233501192684866
"United States","Texas","TX",2020-09-13,2020-09-19,7,2020,"38",28995881,4601,705,3777,824,3896,2.4313798225341,2.84178294151504,0.218162562880593
"United States","Texas","TX",2020-09-20,2020-09-26,7,2020,"39",28995881,4543,634,3805,738,3909,2.18651745742783,2.54518909082293,0.193955321944809
"United States","Texas","TX",2020-09-27,2020-10-03,7,2020,"40",28995881,4589,507,3831,758,4082,1.74852421280112,2.61416440493738,0.19785956669277
"United States","Texas","TX",2020-10-04,2020-10-10,7,2020,"41",28995881,4719,534,3845,874,4185,1.84164088685562,3.01422122680114,0.227308192457737
"United States","Texas","TX",2020-10-11,2020-10-17,7,2020,"42",28995881,4535,457,3882,653,4078,1.57608592751501,2.25204400583655,0.168212261720762
"United States","Texas","TX",2020-10-18,2020-10-24,7,2020,"43",28995881,4813,472,3932,881,4341,1.62781741310085,3.0383625867412,0.224059003051882
"United States","Texas","TX",2020-10-25,2020-10-31,7,2020,"44",28995881,5163,566,3969,1194,4597,1.95200138943873,4.11782625263223,0.300831443688587
"United States","Texas","TX",2020-11-01,2020-11-07,7,2020,"45",28995881,5400,674,3995,1405,4726,2.32446808565672,4.8455158165396,0.351689612015019
"United States","Texas","TX",2020-11-08,2020-11-14,7,2020,"46",28995881,5442,767,4019,1423,4675,2.64520329628888,4.9075935992426,0.354068176163225
"United States","Texas","TX",2020-11-15,2020-11-21,7,2020,"47",28995881,5431,827,4043,1388,4604,2.8521292386322,4.78688679954232,0.343309423695276
"United States","Texas","TX",2020-11-22,2020-11-28,7,2020,"48",28995881,5595,1013,4048,1547,4582,3.49359965989652,5.33524054675214,0.382164031620553
"United States","Texas","TX",2020-11-29,2020-12-05,7,2020,"49",28995881,5636,1194,4091,1545,4442,4.11782625263223,5.3283430153407,0.377658274260572
"United States","Texas","TX",2020-12-06,2020-12-12,7,2020,"50",28995881,6056,1297,4138,1918,4759,4.47304912032161,6.61473262357505,0.463508941517641
"United States","Texas","TX",2020-12-13,2020-12-19,7,2020,"51",28995881,6184,861,4220,1964,5323,2.96938727262676,6.77337584603827,0.465402843601896
"United States","Texas","TX",2020-12-20,2020-12-26,7,2020,"52",28995881,6132,1775,4294,1838,4357,6.12155912765679,6.33883136711728,0.428039124359572
"United States","Texas","TX",2020-12-27,2021-01-02,7,2020,"53",28995881,6542,1431,4352,2190,5111,4.93518372488837,7.55279689553147,0.503216911764706
"United States","Texas","TX",2021-01-03,2021-01-09,7,2021,"1",28995881,6965,1825,4359,2606,5140,6.29399741294289,8.98748342911188,0.597843542096811
"United States","Texas","TX",2021-01-10,2021-01-16,7,2021,"2",28995881,7234,2140,4385,2849,5094,7.38035861024536,9.82553349560236,0.649714937286203
"United States","Texas","TX",2021-01-17,2021-01-23,7,2021,"3",28995881,7024,2282,4381,2643,4742,7.87008334045791,9.1150877602236,0.603286920794339
"United States","Texas","TX",2021-01-24,2021-01-30,7,2021,"4",28995881,6675,2204,4381,2294,4471,7.60107961541158,7.91146852892657,0.523624743209313
"United States","Texas","TX",2021-01-31,2021-02-06,7,2021,"5",28995881,6266,2156,4344,1922,4110,7.43553886153692,6.62852768639794,0.442449355432781
"United States","Texas","TX",2021-02-07,2021-02-13,7,2021,"6",28995881,5916,1902,4330,1586,4014,6.5595523722835,5.4697424092753,0.366281755196305
"United States","Texas","TX",2021-02-14,2021-02-20,7,2021,"7",28995881,6431,834,4329,2102,5597,2.87627059857226,7.24930551342792,0.485562485562486
"United States","Texas","TX",2021-02-21,2021-02-27,7,2021,"8",28995881,5673,1526,4303,1370,4147,5.26281646693198,4.72480901683932,0.31838252382059
"United States","Texas","TX",2021-02-28,2021-03-06,7,2021,"9",28995881,5204,1627,4239,965,3577,5.61114180320991,3.32805890602186,0.227648030195801
"United States","Texas","TX",2021-03-07,2021-03-13,7,2021,"10",28995881,4936,1104,4177,759,3832,3.80743733911724,2.6176131706431,0.181709360785253
"United States","Texas","TX",2021-03-14,2021-03-20,7,2021,"11",28995881,4616,881,4153,463,3735,3.0383625867412,1.59677852174935,0.111485673007464
"United States","Texas","TX",2021-03-21,2021-03-27,7,2021,"12",28995881,4564,740,4086,478,3824,2.55208662223438,1.64851000733518,0.116984826235928
"United States","Texas","TX",2021-03-28,2021-04-03,7,2021,"13",28995881,4427,629,4015,412,3798,2.16927362889922,1.42089147075752,0.102615193026152
"United States","Texas","TX",2021-04-04,2021-04-10,7,2021,"14",28995881,4574,460,3960,614,4114,1.58643222463218,2.11754214331339,0.155050505050505
"United States","Texas","TX",2021-04-11,2021-04-17,7,2021,"15",28995881,4293,388,3942,351,3905,1.33812109382019,1.21051676270847,0.0890410958904109
"United States","Texas","TX",2021-04-18,2021-04-24,7,2021,"16",28995881,4544,372,3939,605,4172,1.28294084252863,2.08650325196189,0.153592282305154
"United States","Texas","TX",2021-04-25,2021-05-01,7,2021,"17",28995881,4418,341,3925,493,4077,1.17602910565125,1.70024149292101,0.125605095541401
"United States","Texas","TX",2021-05-02,2021-05-08,7,2021,"18",28995881,4359,293,3909,450,4066,1.01048835177659,1.55194456757496,0.115118956254797
"United States","Texas","TX",2021-05-09,2021-05-15,7,2021,"19",28995881,4374,305,3884,490,4069,1.05187354024525,1.68989519580385,0.12615859938208
"United States","Texas","TX",2021-05-16,2021-05-22,7,2021,"20",28995881,4259,261,3883,376,3998,0.900127849193477,1.29673590535152,0.0968323461241307
"United States","Texas","TX",2021-05-23,2021-05-29,7,2021,"21",28995881,4278,263,3873,405,4015,0.907025380604921,1.39675011081746,0.104570100697134
"United States","Texas","TX",2021-05-30,2021-06-05,7,2021,"22",28995881,4247,218,3884,363,4029,0.751830923847425,1.25190195117713,0.09346035015448
"United States","Texas","TX",2021-06-06,2021-06-12,7,2021,"23",28995881,4400,223,3876,524,4177,0.769074752376036,1.8071532297984,0.135190918472652
"United States","Texas","TX",2021-06-13,2021-06-19,7,2021,"24",28995881,3916,173,3875,41,3743,0.596636467089929,0.141399393934607,0.0105806451612904
"United States","Texas","TX",2021-06-20,2021-06-26,7,2021,"25",28995881,3693,171,3850,-157,3522,0.589738935678485,-0.541456215798375,-0.0407792207792208
"United States","Utah","UT",2019-12-29,2020-01-04,7,2020,"1",3205958,392,0,387,5,392,0,0.155959622677527,0.0129198966408268
"United States","Utah","UT",2020-01-05,2020-01-11,7,2020,"2",3205958,438,0,394,44,438,0,1.37244467956224,0.111675126903553
"United States","Utah","UT",2020-01-12,2020-01-18,7,2020,"3",3205958,409,0,394,15,409,0,0.467878868032582,0.0380710659898478
"United States","Utah","UT",2020-01-19,2020-01-25,7,2020,"4",3205958,390,0,392,-2,390,0,-0.0623838490710109,-0.00510204081632648
"United States","Utah","UT",2020-01-26,2020-02-01,7,2020,"5",3205958,364,0,388,-24,364,0,-0.748606188852131,-0.0618556701030928
"United States","Utah","UT",2020-02-02,2020-02-08,7,2020,"6",3205958,395,0,391,4,395,0,0.124767698142022,0.0102301790281329
"United States","Utah","UT",2020-02-09,2020-02-15,7,2020,"7",3205958,414,0,391,23,414,0,0.717414264316625,0.0588235294117647
"United States","Utah","UT",2020-02-16,2020-02-22,7,2020,"8",3205958,368,0,394,-26,368,0,-0.810990037923142,-0.065989847715736
"United States","Utah","UT",2020-02-23,2020-02-29,7,2020,"9",3205958,417,0,393,24,417,0,0.748606188852131,0.0610687022900764
"United States","Utah","UT",2020-03-01,2020-03-07,7,2020,"10",3205958,427,0,389,38,427,0,1.18529313234921,0.0976863753213368
"United States","Utah","UT",2020-03-08,2020-03-14,7,2020,"11",3205958,406,0,389,17,406,0,0.530262717103593,0.0437017994858613
"United States","Utah","UT",2020-03-15,2020-03-21,7,2020,"12",3205958,412,0,381,31,412,0,0.966949660600669,0.0813648293963254
"United States","Utah","UT",2020-03-22,2020-03-28,7,2020,"13",3205958,395,3,379,16,392,0.0935757736065164,0.499070792568087,0.0422163588390501
"United States","Utah","UT",2020-03-29,2020-04-04,7,2020,"14",3205958,408,5,378,30,403,0.155959622677527,0.935757736065164,0.0793650793650793
"United States","Utah","UT",2020-04-05,2020-04-11,7,2020,"15",3205958,382,10,385,-3,372,0.311919245355055,-0.0935757736065164,-0.00779220779220779
"United States","Utah","UT",2020-04-12,2020-04-18,7,2020,"16",3205958,388,7,378,10,381,0.218343471748538,0.311919245355055,0.0264550264550265
"United States","Utah","UT",2020-04-19,2020-04-25,7,2020,"17",3205958,410,16,377,33,394,0.499070792568087,1.02933350967168,0.0875331564986737
"United States","Utah","UT",2020-04-26,2020-05-02,7,2020,"18",3205958,381,8,376,5,373,0.249535396284044,0.155959622677527,0.0132978723404256
"United States","Utah","UT",2020-05-03,2020-05-09,7,2020,"19",3205958,372,19,376,-4,353,0.592646566174604,-0.124767698142022,-0.0106382978723404
"United States","Utah","UT",2020-05-10,2020-05-16,7,2020,"20",3205958,403,10,372,31,393,0.311919245355055,0.966949660600669,0.0833333333333333
"United States","Utah","UT",2020-05-17,2020-05-23,7,2020,"21",3205958,374,19,377,-3,355,0.592646566174604,-0.0935757736065164,-0.00795755968169765
"United States","Utah","UT",2020-05-24,2020-05-30,7,2020,"22",3205958,390,11,378,12,379,0.34311116989056,0.374303094426065,0.0317460317460319
"United States","Utah","UT",2020-05-31,2020-06-06,7,2020,"23",3205958,410,13,382,28,397,0.405495018961571,0.873373886994153,0.0732984293193717
"United States","Utah","UT",2020-06-07,2020-06-13,7,2020,"24",3205958,388,18,381,7,370,0.561454641639098,0.218343471748538,0.0183727034120735
"United States","Utah","UT",2020-06-14,2020-06-20,7,2020,"25",3205958,402,16,382,20,386,0.499070792568087,0.623838490710109,0.0523560209424083
"United States","Utah","UT",2020-06-21,2020-06-27,7,2020,"26",3205958,388,12,372,16,376,0.374303094426065,0.499070792568087,0.043010752688172
"United States","Utah","UT",2020-06-28,2020-07-04,7,2020,"27",3205958,438,14,373,65,424,0.436686943497076,2.02747509480785,0.17426273458445
"United States","Utah","UT",2020-07-05,2020-07-11,7,2020,"28",3205958,407,31,370,37,376,0.966949660600669,1.1541012078137,0.1
"United States","Utah","UT",2020-07-12,2020-07-18,7,2020,"29",3205958,435,31,372,63,404,0.966949660600669,1.96509124573684,0.169354838709677
"United States","Utah","UT",2020-07-19,2020-07-25,7,2020,"30",3205958,437,31,371,66,406,0.966949660600669,2.05866701934336,0.177897574123989
"United States","Utah","UT",2020-07-26,2020-08-01,7,2020,"31",3205958,435,36,374,61,399,1.1229092832782,1.90270739666583,0.163101604278075
"United States","Utah","UT",2020-08-02,2020-08-08,7,2020,"32",3205958,449,25,368,81,424,0.779798113387636,2.52654588737594,0.220108695652174
"United States","Utah","UT",2020-08-09,2020-08-15,7,2020,"33",3205958,450,28,368,82,422,0.873373886994153,2.55773781191145,0.222826086956522
"United States","Utah","UT",2020-08-16,2020-08-22,7,2020,"34",3205958,422,23,367,55,399,0.717414264316625,1.7155558494528,0.149863760217984
"United States","Utah","UT",2020-08-23,2020-08-29,7,2020,"35",3205958,377,21,364,13,356,0.655030415245615,0.405495018961571,0.0357142857142858
"United States","Utah","UT",2020-08-30,2020-09-05,7,2020,"36",3205958,367,13,364,3,354,0.405495018961571,0.0935757736065164,0.00824175824175821
"United States","Utah","UT",2020-09-06,2020-09-12,7,2020,"37",3205958,382,13,368,14,369,0.405495018961571,0.436686943497076,0.0380434782608696
"United States","Utah","UT",2020-09-13,2020-09-19,7,2020,"38",3205958,400,7,367,33,393,0.218343471748538,1.02933350967168,0.0899182561307903
"United States","Utah","UT",2020-09-20,2020-09-26,7,2020,"39",3205958,440,8,375,65,432,0.249535396284044,2.02747509480785,0.173333333333333
"United States","Utah","UT",2020-09-27,2020-10-03,7,2020,"40",3205958,393,28,380,13,365,0.873373886994153,0.405495018961571,0.0342105263157895
"United States","Utah","UT",2020-10-04,2020-10-10,7,2020,"41",3205958,443,37,381,62,406,1.1541012078137,1.93389932120134,0.162729658792651
"United States","Utah","UT",2020-10-11,2020-10-17,7,2020,"42",3205958,424,28,380,44,396,0.873373886994153,1.37244467956224,0.11578947368421
"United States","Utah","UT",2020-10-18,2020-10-24,7,2020,"43",3205958,442,27,378,64,415,0.842181962458647,1.99628317027235,0.169312169312169
"United States","Utah","UT",2020-10-25,2020-10-31,7,2020,"44",3205958,460,36,375,85,424,1.1229092832782,2.65131358551796,0.226666666666667
"United States","Utah","UT",2020-11-01,2020-11-07,7,2020,"45",3205958,453,54,372,81,399,1.68436392491729,2.52654588737594,0.217741935483871
"United States","Utah","UT",2020-11-08,2020-11-14,7,2020,"46",3205958,482,53,375,107,429,1.65317200038179,3.33753592529908,0.285333333333333
"United States","Utah","UT",2020-11-15,2020-11-21,7,2020,"47",3205958,544,64,380,164,480,1.99628317027235,5.11547562382289,0.431578947368421
"United States","Utah","UT",2020-11-22,2020-11-28,7,2020,"48",3205958,487,88,381,106,399,2.74488935912448,3.30634400076358,0.278215223097113
"United States","Utah","UT",2020-11-29,2020-12-05,7,2020,"49",3205958,538,76,387,151,462,2.37058626469841,4.70998060486132,0.390180878552972
"United States","Utah","UT",2020-12-06,2020-12-12,7,2020,"50",3205958,552,101,385,167,451,3.15038437808605,5.20905139742941,0.433766233766234
"United States","Utah","UT",2020-12-13,2020-12-19,7,2020,"51",3205958,545,109,390,155,436,3.39991977437009,4.83474830300335,0.397435897435897
"United States","Utah","UT",2020-12-20,2020-12-26,7,2020,"52",3205958,502,7,399,103,495,0.218343471748538,3.21276822715706,0.258145363408521
"United States","Utah","UT",2020-12-27,2021-01-02,7,2020,"53",3205958,486,140,409,77,346,4.36686943497076,2.40177818923392,0.188264058679707
"United States","Utah","UT",2021-01-03,2021-01-09,7,2021,"1",3205958,533,97,413,120,436,3.02561667994403,3.74303094426065,0.290556900726392
"United States","Utah","UT",2021-01-10,2021-01-16,7,2021,"2",3205958,488,94,418,70,394,2.93204090633751,2.18343471748538,0.167464114832536
"United States","Utah","UT",2021-01-17,2021-01-23,7,2021,"3",3205958,500,97,413,87,403,3.02561667994403,2.71369743458897,0.210653753026634
"United States","Utah","UT",2021-01-24,2021-01-30,7,2021,"4",3205958,506,81,408,98,425,2.52654588737594,3.05680860447954,0.240196078431373
"United States","Utah","UT",2021-01-31,2021-02-06,7,2021,"5",3205958,470,71,404,66,399,2.21462664202089,2.05866701934336,0.163366336633663
"United States","Utah","UT",2021-02-07,2021-02-13,7,2021,"6",3205958,454,57,404,50,397,1.77793969852381,1.55959622677527,0.123762376237624
"United States","Utah","UT",2021-02-14,2021-02-20,7,2021,"7",3205958,432,50,405,27,382,1.55959622677527,0.842181962458647,0.0666666666666667
"United States","Utah","UT",2021-02-21,2021-02-27,7,2021,"8",3205958,382,65,408,-26,317,2.02747509480785,-0.810990037923142,-0.0637254901960784
"United States","Utah","UT",2021-02-28,2021-03-06,7,2021,"9",3205958,418,62,406,12,356,1.93389932120134,0.374303094426065,0.0295566502463054
"United States","Utah","UT",2021-03-07,2021-03-13,7,2021,"10",3205958,414,49,406,8,365,1.52840430223977,0.249535396284044,0.0197044334975369
"United States","Utah","UT",2021-03-14,2021-03-20,7,2021,"11",3205958,398,41,399,-1,357,1.27886890595572,-0.0311919245355055,-0.00250626566416046
"United States","Utah","UT",2021-03-21,2021-03-27,7,2021,"12",3205958,394,60,389,5,334,1.87151547213033,0.155959622677527,0.012853470437018
"United States","Utah","UT",2021-03-28,2021-04-03,7,2021,"13",3205958,406,15,385,21,391,0.467878868032582,0.655030415245615,0.0545454545454545
"United States","Utah","UT",2021-04-04,2021-04-10,7,2021,"14",3205958,382,27,382,0,355,0.842181962458647,0,0
"United States","Utah","UT",2021-04-11,2021-04-17,7,2021,"15",3205958,373,4,382,-9,369,0.124767698142022,-0.280727320819549,-0.0235602094240838
"United States","Utah","UT",2021-04-18,2021-04-24,7,2021,"16",3205958,395,14,384,11,381,0.436686943497076,0.34311116989056,0.0286458333333333
"United States","Utah","UT",2021-04-25,2021-05-01,7,2021,"17",3205958,431,23,382,49,408,0.717414264316625,1.52840430223977,0.128272251308901
"United States","Utah","UT",2021-05-02,2021-05-08,7,2021,"18",3205958,389,20,378,11,369,0.623838490710109,0.34311116989056,0.0291005291005291
"United States","Utah","UT",2021-05-09,2021-05-15,7,2021,"19",3205958,386,35,380,6,351,1.09171735874269,0.187151547213033,0.0157894736842106
"United States","Utah","UT",2021-05-16,2021-05-22,7,2021,"20",3205958,411,32,374,37,379,0.998141585136175,1.1541012078137,0.0989304812834224
"United States","Utah","UT",2021-05-23,2021-05-29,7,2021,"21",3205958,440,11,374,66,429,0.34311116989056,2.05866701934336,0.176470588235294
"United States","Utah","UT",2021-05-30,2021-06-05,7,2021,"22",3205958,395,10,376,19,385,0.311919245355055,0.592646566174604,0.050531914893617
"United States","Utah","UT",2021-06-06,2021-06-12,7,2021,"23",3205958,393,8,373,20,385,0.249535396284044,0.623838490710109,0.0536193029490617
"United States","Utah","UT",2021-06-13,2021-06-19,7,2021,"24",3205958,411,7,369,42,404,0.218343471748538,1.31006083049123,0.113821138211382
"United States","Utah","UT",2021-06-20,2021-06-26,7,2021,"25",3205958,389,25,370,19,364,0.779798113387636,0.592646566174604,0.0513513513513513
"United States","Vermont","VT",2019-12-29,2020-01-04,7,2020,"1",623989,109,0,120,-11,109,0,-1.76285158872993,-0.0916666666666667
"United States","Vermont","VT",2020-01-05,2020-01-11,7,2020,"2",623989,111,0,127,-16,111,0,-2.56414776542535,-0.125984251968504
"United States","Vermont","VT",2020-01-12,2020-01-18,7,2020,"3",623989,125,0,118,7,125,0,1.12181464737359,0.0593220338983051
"United States","Vermont","VT",2020-01-19,2020-01-25,7,2020,"4",623989,128,0,119,9,128,0,1.44233311805176,0.0756302521008403
"United States","Vermont","VT",2020-01-26,2020-02-01,7,2020,"5",623989,96,0,119,-23,96,0,-3.68596241279894,-0.19327731092437
"United States","Vermont","VT",2020-02-02,2020-02-08,7,2020,"6",623989,112,0,119,-7,112,0,-1.12181464737359,-0.0588235294117647
"United States","Vermont","VT",2020-02-09,2020-02-15,7,2020,"7",623989,135,0,114,21,135,0,3.36544394212077,0.184210526315789
"United States","Vermont","VT",2020-02-16,2020-02-22,7,2020,"8",623989,116,0,114,2,116,0,0.320518470678169,0.0175438596491229
"United States","Vermont","VT",2020-02-23,2020-02-29,7,2020,"9",623989,137,0,112,25,137,0,4.00648088347711,0.223214285714286
"United States","Vermont","VT",2020-03-01,2020-03-07,7,2020,"10",623989,115,0,117,-2,115,0,-0.320518470678169,-0.0170940170940171
"United States","Vermont","VT",2020-03-08,2020-03-14,7,2020,"11",623989,140,0,116,24,140,0,3.84622164813803,0.206896551724138
"United States","Vermont","VT",2020-03-15,2020-03-21,7,2020,"12",623989,157,2,116,41,155,0.320518470678169,6.57062864890246,0.353448275862069
"United States","Vermont","VT",2020-03-22,2020-03-28,7,2020,"13",623989,128,10,117,11,118,1.60259235339085,1.76285158872993,0.0940170940170941
"United States","Vermont","VT",2020-03-29,2020-04-04,7,2020,"14",623989,130,4,116,14,126,0.641036941356338,2.24362929474718,0.120689655172414
"United States","Vermont","VT",2020-04-05,2020-04-11,7,2020,"15",623989,109,8,113,-4,101,1.28207388271268,-0.641036941356338,-0.0353982300884956
"United States","Vermont","VT",2020-04-12,2020-04-18,7,2020,"16",623989,147,12,113,34,135,1.92311082406901,5.44881400152887,0.300884955752212
"United States","Vermont","VT",2020-04-19,2020-04-25,7,2020,"17",623989,138,9,110,28,129,1.44233311805176,4.48725858949437,0.254545454545455
"United States","Vermont","VT",2020-04-26,2020-05-02,7,2020,"18",623989,109,5,109,0,104,0.801296176695423,0,0
"United States","Vermont","VT",2020-05-03,2020-05-09,7,2020,"19",623989,124,3,106,18,121,0.480777706017254,2.88466623610352,0.169811320754717
"United States","Vermont","VT",2020-05-10,2020-05-16,7,2020,"20",623989,103,0,106,-3,103,0,-0.480777706017254,-0.0283018867924528
"United States","Vermont","VT",2020-05-17,2020-05-23,7,2020,"21",623989,103,1,103,0,102,0.160259235339084,0,0
"United States","Vermont","VT",2020-05-24,2020-05-30,7,2020,"22",623989,143,1,108,35,142,0.160259235339084,5.60907323686796,0.324074074074074
"United States","Vermont","VT",2020-05-31,2020-06-06,7,2020,"23",623989,116,0,109,7,116,0,1.12181464737359,0.0642201834862386
"United States","Vermont","VT",2020-06-07,2020-06-13,7,2020,"24",623989,115,0,107,8,115,0,1.28207388271268,0.0747663551401869
"United States","Vermont","VT",2020-06-14,2020-06-20,7,2020,"25",623989,102,1,103,-1,101,0.160259235339084,-0.160259235339084,-0.00970873786407767
"United States","Vermont","VT",2020-06-21,2020-06-27,7,2020,"26",623989,124,0,107,17,124,0,2.72440700076444,0.158878504672897
"United States","Vermont","VT",2020-06-28,2020-07-04,7,2020,"27",623989,91,0,105,-14,91,0,-2.24362929474718,-0.133333333333333
"United States","Vermont","VT",2020-07-05,2020-07-11,7,2020,"28",623989,112,0,103,9,112,0,1.44233311805176,0.087378640776699
"United States","Vermont","VT",2020-07-12,2020-07-18,7,2020,"29",623989,104,0,102,2,104,0,0.320518470678169,0.0196078431372548
"United States","Vermont","VT",2020-07-19,2020-07-25,7,2020,"30",623989,115,0,103,12,115,0,1.92311082406901,0.116504854368932
"United States","Vermont","VT",2020-07-26,2020-08-01,7,2020,"31",623989,120,1,100,20,119,0.160259235339084,3.20518470678169,0.2
"United States","Vermont","VT",2020-08-02,2020-08-08,7,2020,"32",623989,102,1,100,2,101,0.160259235339084,0.320518470678169,0.02
"United States","Vermont","VT",2020-08-09,2020-08-15,7,2020,"33",623989,104,0,101,3,104,0,0.480777706017254,0.0297029702970297
"United States","Vermont","VT",2020-08-16,2020-08-22,7,2020,"34",623989,138,0,101,37,138,0,5.92959170754613,0.366336633663366
"United States","Vermont","VT",2020-08-23,2020-08-29,7,2020,"35",623989,121,0,101,20,121,0,3.20518470678169,0.198019801980198
"United States","Vermont","VT",2020-08-30,2020-09-05,7,2020,"36",623989,124,0,100,24,124,0,3.84622164813803,0.24
"United States","Vermont","VT",2020-09-06,2020-09-12,7,2020,"37",623989,126,0,101,25,126,0,4.00648088347711,0.247524752475248
"United States","Vermont","VT",2020-09-13,2020-09-19,7,2020,"38",623989,113,0,101,12,113,0,1.92311082406901,0.118811881188119
"United States","Vermont","VT",2020-09-20,2020-09-26,7,2020,"39",623989,120,0,101,19,120,0,3.04492547144261,0.188118811881188
"United States","Vermont","VT",2020-09-27,2020-10-03,7,2020,"40",623989,106,0,103,3,106,0,0.480777706017254,0.029126213592233
"United States","Vermont","VT",2020-10-04,2020-10-10,7,2020,"41",623989,118,0,106,12,118,0,1.92311082406901,0.113207547169811
"United States","Vermont","VT",2020-10-11,2020-10-17,7,2020,"42",623989,120,0,108,12,120,0,1.92311082406901,0.111111111111111
"United States","Vermont","VT",2020-10-18,2020-10-24,7,2020,"43",623989,122,0,110,12,122,0,1.92311082406901,0.109090909090909
"United States","Vermont","VT",2020-10-25,2020-10-31,7,2020,"44",623989,137,0,111,26,137,0,4.1667401188162,0.234234234234234
"United States","Vermont","VT",2020-11-01,2020-11-07,7,2020,"45",623989,112,1,112,0,111,0.160259235339084,0,0
"United States","Vermont","VT",2020-11-08,2020-11-14,7,2020,"46",623989,144,0,110,34,144,0,5.44881400152887,0.309090909090909
"United States","Vermont","VT",2020-11-15,2020-11-21,7,2020,"47",623989,128,3,108,20,125,0.480777706017254,3.20518470678169,0.185185185185185
"United States","Vermont","VT",2020-11-22,2020-11-28,7,2020,"48",623989,123,5,105,18,118,0.801296176695423,2.88466623610352,0.171428571428571
"United States","Vermont","VT",2020-11-29,2020-12-05,7,2020,"49",623989,146,12,106,40,134,1.92311082406901,6.41036941356338,0.377358490566038
"United States","Vermont","VT",2020-12-06,2020-12-12,7,2020,"50",623989,113,16,109,4,97,2.56414776542535,0.641036941356338,0.036697247706422
"United States","Vermont","VT",2020-12-13,2020-12-19,7,2020,"51",623989,124,13,115,9,111,2.0833700594081,1.44233311805176,0.0782608695652174
"United States","Vermont","VT",2020-12-20,2020-12-26,7,2020,"52",623989,150,13,117,33,137,2.0833700594081,5.28855476618979,0.282051282051282
"United States","Vermont","VT",2020-12-27,2021-01-02,7,2020,"53",623989,138,18,123,15,120,2.88466623610352,2.40388853008627,0.121951219512195
"United States","Vermont","VT",2021-01-03,2021-01-09,7,2021,"1",623989,108,17,123,-15,91,2.72440700076444,-2.40388853008627,-0.121951219512195
"United States","Vermont","VT",2021-01-10,2021-01-16,7,2021,"2",623989,152,7,127,25,145,1.12181464737359,4.00648088347711,0.196850393700787
"United States","Vermont","VT",2021-01-17,2021-01-23,7,2021,"3",623989,126,7,123,3,119,1.12181464737359,0.480777706017254,0.024390243902439
"United States","Vermont","VT",2021-01-24,2021-01-30,7,2021,"4",623989,116,3,123,-7,113,0.480777706017254,-1.12181464737359,-0.056910569105691
"United States","Vermont","VT",2021-01-31,2021-02-06,7,2021,"5",623989,153,9,120,33,144,1.44233311805176,5.28855476618979,0.275
"United States","Vermont","VT",2021-02-07,2021-02-13,7,2021,"6",623989,127,7,120,7,120,1.12181464737359,1.12181464737359,0.0583333333333333
"United States","Vermont","VT",2021-02-14,2021-02-20,7,2021,"7",623989,156,7,115,41,149,1.12181464737359,6.57062864890246,0.356521739130435
"United States","Vermont","VT",2021-02-21,2021-02-27,7,2021,"8",623989,158,9,121,37,149,1.44233311805176,5.92959170754613,0.305785123966942
"United States","Vermont","VT",2021-02-28,2021-03-06,7,2021,"9",623989,110,3,115,-5,107,0.480777706017254,-0.801296176695423,-0.0434782608695652
"United States","Vermont","VT",2021-03-07,2021-03-13,7,2021,"10",623989,152,6,120,32,146,0.961555412034507,5.1282955308507,0.266666666666667
"United States","Vermont","VT",2021-03-14,2021-03-20,7,2021,"11",623989,106,5,118,-12,101,0.801296176695423,-1.92311082406901,-0.101694915254237
"United States","Vermont","VT",2021-03-21,2021-03-27,7,2021,"12",623989,101,5,115,-14,96,0.801296176695423,-2.24362929474718,-0.121739130434783
"United States","Vermont","VT",2021-03-28,2021-04-03,7,2021,"13",623989,128,5,114,14,123,0.801296176695423,2.24362929474718,0.12280701754386
"United States","Vermont","VT",2021-04-04,2021-04-10,7,2021,"14",623989,130,2,122,8,128,0.320518470678169,1.28207388271268,0.0655737704918034
"United States","Vermont","VT",2021-04-11,2021-04-17,7,2021,"15",623989,112,11,114,-2,101,1.76285158872993,-0.320518470678169,-0.0175438596491229
"United States","Vermont","VT",2021-04-18,2021-04-24,7,2021,"16",623989,141,2,113,28,139,0.320518470678169,4.48725858949437,0.247787610619469
"United States","Vermont","VT",2021-04-25,2021-05-01,7,2021,"17",623989,139,3,112,27,136,0.480777706017254,4.32699935415528,0.241071428571429
"United States","Vermont","VT",2021-05-02,2021-05-08,7,2021,"18",623989,118,2,104,14,116,0.320518470678169,2.24362929474718,0.134615384615385
"United States","Vermont","VT",2021-05-09,2021-05-15,7,2021,"19",623989,146,3,103,43,143,0.480777706017254,6.89114711958063,0.41747572815534
"United States","Vermont","VT",2021-05-16,2021-05-22,7,2021,"20",623989,111,3,101,10,108,0.480777706017254,1.60259235339085,0.0990099009900991
"United States","Vermont","VT",2021-05-23,2021-05-29,7,2021,"21",623989,100,0,101,-1,100,0,-0.160259235339084,-0.00990099009900991
"United States","Vermont","VT",2021-05-30,2021-06-05,7,2021,"22",623989,87,1,107,-20,86,0.160259235339084,-3.20518470678169,-0.186915887850467
"United States","Vermont","VT",2021-06-06,2021-06-12,7,2021,"23",623989,97,0,108,-11,97,0,-1.76285158872993,-0.101851851851852
"United States","Vermont","VT",2021-06-13,2021-06-19,7,2021,"24",623989,130,0,107,23,130,0,3.68596241279894,0.214953271028037
"United States","Vermont","VT",2021-06-20,2021-06-26,7,2021,"25",623989,116,0,108,8,116,0,1.28207388271268,0.0740740740740742
"United States","Virginia","VA",2019-12-29,2020-01-04,7,2020,"1",8535519,1438,0,1490,-52,1438,0,-0.609218959034594,-0.0348993288590604
"United States","Virginia","VA",2020-01-05,2020-01-11,7,2020,"2",8535519,1562,0,1496,66,1562,0,0.773239448005446,0.0441176470588236
"United States","Virginia","VA",2020-01-12,2020-01-18,7,2020,"3",8535519,1466,0,1488,-22,1466,0,-0.257746482668482,-0.0147849462365591
"United States","Virginia","VA",2020-01-19,2020-01-25,7,2020,"4",8535519,1459,0,1492,-33,1459,0,-0.386619724002723,-0.0221179624664879
"United States","Virginia","VA",2020-01-26,2020-02-01,7,2020,"5",8535519,1479,0,1472,7,1479,0,0.0820102444854261,0.00475543478260865
"United States","Virginia","VA",2020-02-02,2020-02-08,7,2020,"6",8535519,1524,0,1460,64,1524,0,0.749807949581039,0.0438356164383562
"United States","Virginia","VA",2020-02-09,2020-02-15,7,2020,"7",8535519,1377,0,1457,-80,1377,0,-0.937259936976299,-0.0549073438572409
"United States","Virginia","VA",2020-02-16,2020-02-22,7,2020,"8",8535519,1444,0,1449,-5,1444,0,-0.0585787460610187,-0.0034506556245687
"United States","Virginia","VA",2020-02-23,2020-02-29,7,2020,"9",8535519,1388,0,1426,-38,1388,0,-0.445198470063742,-0.0266479663394109
"United States","Virginia","VA",2020-03-01,2020-03-07,7,2020,"10",8535519,1480,0,1426,54,1480,0,0.632650457459002,0.0378681626928472
"United States","Virginia","VA",2020-03-08,2020-03-14,7,2020,"11",8535519,1435,1,1417,18,1434,0.0117157492122037,0.210883485819667,0.0127028934368383
"United States","Virginia","VA",2020-03-15,2020-03-21,7,2020,"12",8535519,1455,1,1404,51,1454,0.0117157492122037,0.59750320982239,0.0363247863247864
"United States","Virginia","VA",2020-03-22,2020-03-28,7,2020,"13",8535519,1517,15,1390,127,1502,0.175736238183056,1.48790014994987,0.0913669064748202
"United States","Virginia","VA",2020-03-29,2020-04-04,7,2020,"14",8535519,1467,32,1378,89,1435,0.374903974790519,1.04270167988613,0.0645863570391871
"United States","Virginia","VA",2020-04-05,2020-04-11,7,2020,"15",8535519,1619,80,1361,258,1539,0.937259936976299,3.02266329674856,0.1895664952241
"United States","Virginia","VA",2020-04-12,2020-04-18,7,2020,"16",8535519,1602,128,1344,258,1474,1.49961589916208,3.02266329674856,0.191964285714286
"United States","Virginia","VA",2020-04-19,2020-04-25,7,2020,"17",8535519,1633,179,1339,294,1454,2.09711910898447,3.4444302683879,0.219566840926064
"United States","Virginia","VA",2020-04-26,2020-05-02,7,2020,"18",8535519,1669,181,1327,342,1488,2.12055060740888,4.00678623057368,0.257724189902035
"United States","Virginia","VA",2020-05-03,2020-05-09,7,2020,"19",8535519,1593,211,1310,283,1382,2.47202308377499,3.31555702705366,0.216030534351145
"United States","Virginia","VA",2020-05-10,2020-05-16,7,2020,"20",8535519,1565,174,1297,268,1391,2.03854036292345,3.1398207888706,0.206630686198921
"United States","Virginia","VA",2020-05-17,2020-05-23,7,2020,"21",8535519,1464,156,1300,164,1308,1.82765687710378,1.92138287080141,0.126153846153846
"United States","Virginia","VA",2020-05-24,2020-05-30,7,2020,"22",8535519,1443,206,1297,146,1237,2.41344433771397,1.71049938498174,0.112567463377024
"United States","Virginia","VA",2020-05-31,2020-06-06,7,2020,"23",8535519,1410,89,1290,120,1321,1.04270167988613,1.40588990546445,0.0930232558139534
"United States","Virginia","VA",2020-06-07,2020-06-13,7,2020,"24",8535519,1422,83,1284,138,1339,0.97240718461291,1.61677339128412,0.107476635514019
"United States","Virginia","VA",2020-06-14,2020-06-20,7,2020,"25",8535519,1292,68,1275,17,1224,0.796670946429854,0.199167736607463,0.0133333333333334
"United States","Virginia","VA",2020-06-21,2020-06-27,7,2020,"26",8535519,1456,120,1275,181,1336,1.40588990546445,2.12055060740888,0.141960784313725
"United States","Virginia","VA",2020-06-28,2020-07-04,7,2020,"27",8535519,1394,124,1276,118,1270,1.45275290231326,1.38245840704004,0.0924764890282133
"United States","Virginia","VA",2020-07-05,2020-07-11,7,2020,"28",8535519,1488,118,1267,221,1370,1.38245840704004,2.58918057589702,0.174427782162589
"United States","Virginia","VA",2020-07-12,2020-07-18,7,2020,"29",8535519,1390,61,1259,131,1329,0.714660701944428,1.53476314679869,0.104050833995234
"United States","Virginia","VA",2020-07-19,2020-07-25,7,2020,"30",8535519,1463,48,1258,205,1415,0.562355962185779,2.40172858850177,0.162957074721781
"United States","Virginia","VA",2020-07-26,2020-08-01,7,2020,"31",8535519,1455,140,1255,200,1315,1.64020488970852,2.34314984244075,0.159362549800797
"United States","Virginia","VA",2020-08-02,2020-08-08,7,2020,"32",8535519,1513,107,1246,267,1406,1.2535851657058,3.1281050396584,0.214285714285714
"United States","Virginia","VA",2020-08-09,2020-08-15,7,2020,"33",8535519,1457,59,1246,211,1398,0.69122920352002,2.47202308377499,0.169341894060995
"United States","Virginia","VA",2020-08-16,2020-08-22,7,2020,"34",8535519,1454,62,1252,202,1392,0.726376451156632,2.36658134086515,0.161341853035144
"United States","Virginia","VA",2020-08-23,2020-08-29,7,2020,"35",8535519,1458,125,1242,216,1333,1.46446865152547,2.53060182983601,0.173913043478261
"United States","Virginia","VA",2020-08-30,2020-09-05,7,2020,"36",8535519,1486,109,1243,243,1377,1.27701666413021,2.84692705856551,0.19549477071601
"United States","Virginia","VA",2020-09-06,2020-09-12,7,2020,"37",8535519,1469,45,1256,213,1424,0.527208714549168,2.49545458219939,0.169585987261146
"United States","Virginia","VA",2020-09-13,2020-09-19,7,2020,"38",8535519,1459,268,1264,195,1191,3.1398207888706,2.28457109637973,0.154272151898734
"United States","Virginia","VA",2020-09-20,2020-09-26,7,2020,"39",8535519,1484,154,1267,217,1330,1.80422537867937,2.54231757904821,0.171270718232044
"United States","Virginia","VA",2020-09-27,2020-10-03,7,2020,"40",8535519,1516,126,1289,227,1390,1.47618440073767,2.65947507117025,0.17610550814585
"United States","Virginia","VA",2020-10-04,2020-10-10,7,2020,"41",8535519,1478,84,1301,177,1394,0.984122933825114,2.07368761056006,0.136049192928517
"United States","Virginia","VA",2020-10-11,2020-10-17,7,2020,"42",8535519,1448,68,1315,133,1380,0.796670946429854,1.5581946452231,0.101140684410646
"United States","Virginia","VA",2020-10-18,2020-10-24,7,2020,"43",8535519,1496,156,1318,178,1340,1.82765687710378,2.08540335977226,0.1350531107739
"United States","Virginia","VA",2020-10-25,2020-10-31,7,2020,"44",8535519,1546,60,1330,216,1486,0.702944952732224,2.53060182983601,0.162406015037594
"United States","Virginia","VA",2020-11-01,2020-11-07,7,2020,"45",8535519,1652,59,1331,321,1593,0.69122920352002,3.7607554971174,0.241172051089406
"United States","Virginia","VA",2020-11-08,2020-11-14,7,2020,"46",8535519,1513,90,1335,178,1423,1.05441742909834,2.08540335977226,0.133333333333333
"United States","Virginia","VA",2020-11-15,2020-11-21,7,2020,"47",8535519,1614,120,1344,270,1494,1.40588990546445,3.16325228729501,0.200892857142857
"United States","Virginia","VA",2020-11-22,2020-11-28,7,2020,"48",8535519,1595,144,1362,233,1451,1.68706788655734,2.72976956644347,0.171071953010279
"United States","Virginia","VA",2020-11-29,2020-12-05,7,2020,"49",8535519,1629,143,1375,254,1486,1.67535213734513,2.97580029989975,0.184727272727273
"United States","Virginia","VA",2020-12-06,2020-12-12,7,2020,"50",8535519,1795,215,1392,403,1580,2.5188860806238,4.7214469325181,0.289511494252874
"United States","Virginia","VA",2020-12-13,2020-12-19,7,2020,"51",8535519,1868,233,1404,464,1635,2.72976956644347,5.43610763446253,0.330484330484331
"United States","Virginia","VA",2020-12-20,2020-12-26,7,2020,"52",8535519,1901,193,1417,484,1708,2.26113959795532,5.67042261870661,0.341566690190543
"United States","Virginia","VA",2020-12-27,2021-01-02,7,2020,"53",8535519,2016,280,1425,591,1736,3.28040977941705,6.92400778441241,0.414736842105263
"United States","Virginia","VA",2021-01-03,2021-01-09,7,2021,"1",8535519,2015,266,1440,575,1749,3.11638929044619,6.73655579701715,0.399305555555556
"United States","Virginia","VA",2021-01-10,2021-01-16,7,2021,"2",8535519,2070,323,1457,613,1747,3.78418699554181,7.18175426708089,0.420727522306108
"United States","Virginia","VA",2021-01-17,2021-01-23,7,2021,"3",8535519,2130,371,1474,656,1759,4.34654295772758,7.68553148320565,0.445047489823609
"United States","Virginia","VA",2021-01-24,2021-01-30,7,2021,"4",8535519,1963,374,1486,477,1589,4.3816902053642,5.58841237422118,0.320995962314939
"United States","Virginia","VA",2021-01-31,2021-02-06,7,2021,"5",8535519,2008,325,1483,525,1683,3.80761849396621,6.15076833640696,0.354012137559002
"United States","Virginia","VA",2021-02-07,2021-02-13,7,2021,"6",8535519,1805,228,1483,322,1577,2.67119082038245,3.7724712463296,0.217127444369521
"United States","Virginia","VA",2021-02-14,2021-02-20,7,2021,"7",8535519,1743,209,1472,271,1534,2.44859158535058,3.17496803650721,0.184103260869565
"United States","Virginia","VA",2021-02-21,2021-02-27,7,2021,"8",8535519,1714,1173,1459,255,541,13.742573825915,2.98751604911195,0.174777244688143
"United States","Virginia","VA",2021-02-28,2021-03-06,7,2021,"9",8535519,1594,1140,1448,146,454,13.3559541019123,1.71049938498174,0.100828729281768
"United States","Virginia","VA",2021-03-07,2021-03-13,7,2021,"10",8535519,1552,477,1451,101,1075,5.58841237422118,1.18329067043258,0.0696071674707099
"United States","Virginia","VA",2021-03-14,2021-03-20,7,2021,"11",8535519,1528,209,1439,89,1319,2.44859158535058,1.04270167988613,0.0618485059068798
"United States","Virginia","VA",2021-03-21,2021-03-27,7,2021,"12",8535519,1534,62,1429,105,1472,0.726376451156632,1.23015366728139,0.0734779566130161
"United States","Virginia","VA",2021-03-28,2021-04-03,7,2021,"13",8535519,1368,15,1427,-59,1353,0.175736238183056,-0.69122920352002,-0.0413454800280308
"United States","Virginia","VA",2021-04-04,2021-04-10,7,2021,"14",8535519,1576,171,1414,162,1405,2.00339311528684,1.897951372377,0.114568599717115
"United States","Virginia","VA",2021-04-11,2021-04-17,7,2021,"15",8535519,1436,106,1402,34,1330,1.2418694164936,0.398335473214927,0.0242510699001426
"United States","Virginia","VA",2021-04-18,2021-04-24,7,2021,"16",8535519,1498,111,1382,116,1387,1.30044816255461,1.35902690861563,0.0839363241678726
"United States","Virginia","VA",2021-04-25,2021-05-01,7,2021,"17",8535519,1504,102,1361,143,1402,1.19500641964478,1.67535213734513,0.105069801616458
"United States","Virginia","VA",2021-05-02,2021-05-08,7,2021,"18",8535519,1499,108,1337,162,1391,1.265300914918,1.897951372377,0.121166791323859
"United States","Virginia","VA",2021-05-09,2021-05-15,7,2021,"19",8535519,1492,123,1334,158,1369,1.44103715310106,1.85108837552819,0.118440779610195
"United States","Virginia","VA",2021-05-16,2021-05-22,7,2021,"20",8535519,1427,89,1331,96,1338,1.04270167988613,1.12471192437156,0.0721262208865514
"United States","Virginia","VA",2021-05-23,2021-05-29,7,2021,"21",8535519,1453,63,1325,128,1390,0.738092200368835,1.49961589916208,0.0966037735849057
"United States","Virginia","VA",2021-05-30,2021-06-05,7,2021,"22",8535519,1449,69,1330,119,1380,0.808386695642058,1.39417415625224,0.0894736842105264
"United States","Virginia","VA",2021-06-06,2021-06-12,7,2021,"23",8535519,1403,64,1326,77,1339,0.749807949581039,0.902112689339687,0.0580693815987934
"United States","Virginia","VA",2021-06-13,2021-06-19,7,2021,"24",8535519,1301,50,1320,-19,1251,0.585787460610187,-0.222599235031871,-0.0143939393939394
"United States","Virginia","VA",2021-06-20,2021-06-26,7,2021,"25",8535519,1003,49,1321,-318,954,0.574071711397983,-3.72560824948079,-0.240726722180167
"United States","Washington","WA",2019-12-29,2020-01-04,7,2020,"1",7614893,1183,0,1279,-96,1183,0,-1.26068744498445,-0.075058639562158
"United States","Washington","WA",2020-01-05,2020-01-11,7,2020,"2",7614893,1246,0,1297,-51,1246,0,-0.669740205147991,-0.0393215111796453
"United States","Washington","WA",2020-01-12,2020-01-18,7,2020,"3",7614893,1221,0,1295,-74,1221,0,-0.97177990550885,-0.0571428571428572
"United States","Washington","WA",2020-01-19,2020-01-25,7,2020,"4",7614893,1192,0,1283,-91,1192,0,-1.19502664055818,-0.0709275136399065
"United States","Washington","WA",2020-01-26,2020-02-01,7,2020,"5",7614893,1200,0,1246,-46,1200,0,-0.604079400721717,-0.0369181380417335
"United States","Washington","WA",2020-02-02,2020-02-08,7,2020,"6",7614893,1180,0,1233,-53,1180,0,-0.6960045269185,-0.0429845904298459
"United States","Washington","WA",2020-02-09,2020-02-15,7,2020,"7",7614893,1179,0,1222,-43,1179,0,-0.564682918065953,-0.0351882160392799
"United States","Washington","WA",2020-02-16,2020-02-22,7,2020,"8",7614893,1115,0,1207,-92,1115,0,-1.20815880144343,-0.076222038111019
"United States","Washington","WA",2020-02-23,2020-02-29,7,2020,"9",7614893,1135,1,1203,-68,1134,0.0131321608852547,-0.892986940197321,-0.056525353283458
"United States","Washington","WA",2020-03-01,2020-03-07,7,2020,"10",7614893,1208,15,1208,0,1193,0.196982413278821,0,0
"United States","Washington","WA",2020-03-08,2020-03-14,7,2020,"11",7614893,1165,24,1197,-32,1141,0.315171861246113,-0.420229148328151,-0.0267335004177109
"United States","Washington","WA",2020-03-15,2020-03-21,7,2020,"12",7614893,1224,53,1184,40,1171,0.6960045269185,0.525286435410189,0.0337837837837838
"United States","Washington","WA",2020-03-22,2020-03-28,7,2020,"13",7614893,1294,91,1173,121,1203,1.19502664055818,1.58899146711582,0.103154305200341
"United States","Washington","WA",2020-03-29,2020-04-04,7,2020,"14",7614893,1305,126,1156,149,1179,1.6546522715421,1.95669197190295,0.128892733564014
"United States","Washington","WA",2020-04-05,2020-04-11,7,2020,"15",7614893,1304,181,1139,165,1123,2.3769211202311,2.16680654606703,0.14486391571554
"United States","Washington","WA",2020-04-12,2020-04-18,7,2020,"16",7614893,1251,133,1119,132,1118,1.74657739773888,1.73344523685362,0.117962466487936
"United States","Washington","WA",2020-04-19,2020-04-25,7,2020,"17",7614893,1231,114,1114,117,1117,1.49706634091904,1.5364628235748,0.105026929982047
"United States","Washington","WA",2020-04-26,2020-05-02,7,2020,"18",7614893,1157,91,1096,61,1066,1.19502664055818,0.801061814000538,0.0556569343065694
"United States","Washington","WA",2020-05-03,2020-05-09,7,2020,"19",7614893,1211,91,1090,121,1120,1.19502664055818,1.58899146711582,0.111009174311927
"United States","Washington","WA",2020-05-10,2020-05-16,7,2020,"20",7614893,1138,79,1088,50,1059,1.03744070993512,0.656608044262736,0.0459558823529411
"United States","Washington","WA",2020-05-17,2020-05-23,7,2020,"21",7614893,1114,51,1096,18,1063,0.669740205147991,0.236378895934585,0.0164233576642336
"United States","Washington","WA",2020-05-24,2020-05-30,7,2020,"22",7614893,1058,68,1088,-30,990,0.892986940197321,-0.393964826557642,-0.0275735294117647
"United States","Washington","WA",2020-05-31,2020-06-06,7,2020,"23",7614893,1054,35,1076,-22,1019,0.459625630983915,-0.288907539475604,-0.0204460966542751
"United States","Washington","WA",2020-06-07,2020-06-13,7,2020,"24",7614893,1101,59,1069,32,1042,0.774797492230029,0.420229148328151,0.0299345182413471
"United States","Washington","WA",2020-06-14,2020-06-20,7,2020,"25",7614893,1133,51,1087,46,1082,0.669740205147991,0.604079400721717,0.0423183072677094
"United States","Washington","WA",2020-06-21,2020-06-27,7,2020,"26",7614893,1084,47,1084,0,1037,0.617211561606972,0,0
"United States","Washington","WA",2020-06-28,2020-07-04,7,2020,"27",7614893,1126,44,1074,52,1082,0.577815078951208,0.682872366033246,0.048417132216015
"United States","Washington","WA",2020-07-05,2020-07-11,7,2020,"28",7614893,1162,70,1064,98,1092,0.919251261967831,1.28695176675496,0.0921052631578947
"United States","Washington","WA",2020-07-12,2020-07-18,7,2020,"29",7614893,1180,20,1070,110,1160,0.262643217705094,1.44453769737802,0.102803738317757
"United States","Washington","WA",2020-07-19,2020-07-25,7,2020,"30",7614893,1180,50,1062,118,1130,0.656608044262736,1.54959498446006,0.111111111111111
"United States","Washington","WA",2020-07-26,2020-08-01,7,2020,"31",7614893,1229,98,1045,184,1131,1.28695176675496,2.41631760288687,0.176076555023923
"United States","Washington","WA",2020-08-02,2020-08-08,7,2020,"32",7614893,1234,80,1039,195,1154,1.05057287082038,2.56077137262467,0.187680461982676
"United States","Washington","WA",2020-08-09,2020-08-15,7,2020,"33",7614893,1174,94,1032,142,1080,1.23442312321394,1.86476684570617,0.137596899224806
"United States","Washington","WA",2020-08-16,2020-08-22,7,2020,"34",7614893,1199,91,1037,162,1108,1.19502664055818,2.12741006341127,0.156219864995178
"United States","Washington","WA",2020-08-23,2020-08-29,7,2020,"35",7614893,1118,48,1039,79,1070,0.630343722492227,1.03744070993512,0.0760346487006738
"United States","Washington","WA",2020-08-30,2020-09-05,7,2020,"36",7614893,1240,48,1036,204,1192,0.630343722492227,2.67896082059196,0.196911196911197
"United States","Washington","WA",2020-09-06,2020-09-12,7,2020,"37",7614893,1146,38,1041,105,1108,0.499022113639679,1.37887689295175,0.100864553314121
"United States","Washington","WA",2020-09-13,2020-09-19,7,2020,"38",7614893,1178,45,1039,139,1133,0.590947239836463,1.82537036305041,0.133782483156882
"United States","Washington","WA",2020-09-20,2020-09-26,7,2020,"39",7614893,1168,62,1045,123,1106,0.814193974885793,1.61525578888633,0.117703349282297
"United States","Washington","WA",2020-09-27,2020-10-03,7,2020,"40",7614893,1143,45,1072,71,1098,0.590947239836463,0.932383422853086,0.0662313432835822
"United States","Washington","WA",2020-10-04,2020-10-10,7,2020,"41",7614893,1162,47,1077,85,1115,0.617211561606972,1.11623367524665,0.0789229340761375
"United States","Washington","WA",2020-10-11,2020-10-17,7,2020,"42",7614893,1149,49,1098,51,1100,0.643475883377482,0.669740205147991,0.0464480874316939
"United States","Washington","WA",2020-10-18,2020-10-24,7,2020,"43",7614893,1195,47,1092,103,1148,0.617211561606972,1.35261257118124,0.0943223443223444
"United States","Washington","WA",2020-10-25,2020-10-31,7,2020,"44",7614893,1194,79,1091,103,1115,1.03744070993512,1.35261257118124,0.0944087992667277
"United States","Washington","WA",2020-11-01,2020-11-07,7,2020,"45",7614893,1274,72,1093,181,1202,0.94551558373834,2.3769211202311,0.165599268069533
"United States","Washington","WA",2020-11-08,2020-11-14,7,2020,"46",7614893,1313,77,1110,203,1236,1.01117638816461,2.66582865970671,0.182882882882883
"United States","Washington","WA",2020-11-15,2020-11-21,7,2020,"47",7614893,1325,100,1107,218,1225,1.31321608852547,2.86281107298553,0.196928635953026
"United States","Washington","WA",2020-11-22,2020-11-28,7,2020,"48",7614893,1246,81,1123,123,1165,1.06370503170563,1.61525578888633,0.109528049866429
"United States","Washington","WA",2020-11-29,2020-12-05,7,2020,"49",7614893,1354,137,1124,230,1217,1.7991060412799,3.02039700360859,0.204626334519573
"United States","Washington","WA",2020-12-06,2020-12-12,7,2020,"50",7614893,1412,47,1140,272,1365,0.617211561606972,3.57194776078929,0.23859649122807
"United States","Washington","WA",2020-12-13,2020-12-19,7,2020,"51",7614893,1381,225,1168,213,1156,2.95473619918231,2.79715026855926,0.18236301369863
"United States","Washington","WA",2020-12-20,2020-12-26,7,2020,"52",7614893,1392,27,1203,189,1365,0.354568343901878,2.48197840731314,0.1571072319202
"United States","Washington","WA",2020-12-27,2021-01-02,7,2020,"53",7614893,1348,56,1236,112,1292,0.735401009574265,1.47080201914853,0.0906148867313916
"United States","Washington","WA",2021-01-03,2021-01-09,7,2021,"1",7614893,1426,447,1258,168,979,5.87007591570886,2.20620302872279,0.133545310015898
"United States","Washington","WA",2021-01-10,2021-01-16,7,2021,"2",7614893,1404,209,1268,136,1195,2.74462162501824,1.78597388039464,0.107255520504732
"United States","Washington","WA",2021-01-17,2021-01-23,7,2021,"3",7614893,1319,269,1263,56,1050,3.53255127813352,0.735401009574265,0.0443388756927949
"United States","Washington","WA",2021-01-24,2021-01-30,7,2021,"4",7614893,1341,173,1262,79,1168,2.27186383314907,1.03744070993512,0.0625990491283677
"United States","Washington","WA",2021-01-31,2021-02-06,7,2021,"5",7614893,1355,164,1254,101,1191,2.15367438518177,1.32634824941073,0.0805422647527911
"United States","Washington","WA",2021-02-07,2021-02-13,7,2021,"6",7614893,1247,226,1252,-5,1021,2.96786836006757,-0.0656608044262736,-0.0039936102236422
"United States","Washington","WA",2021-02-14,2021-02-20,7,2021,"7",7614893,1264,148,1257,7,1116,1.9435598110177,0.0919251261967831,0.00556881463802705
"United States","Washington","WA",2021-02-21,2021-02-27,7,2021,"8",7614893,1241,134,1256,-15,1107,1.75970955862413,-0.196982413278821,-0.0119426751592356
"United States","Washington","WA",2021-02-28,2021-03-06,7,2021,"9",7614893,1250,89,1250,0,1161,1.16876231878767,0,0
"United States","Washington","WA",2021-03-07,2021-03-13,7,2021,"10",7614893,1200,85,1241,-41,1115,1.11623367524665,-0.538418596295444,-0.0330378726833199
"United States","Washington","WA",2021-03-14,2021-03-20,7,2021,"11",7614893,1171,47,1239,-68,1124,0.617211561606972,-0.892986940197321,-0.0548829701372074
"United States","Washington","WA",2021-03-21,2021-03-27,7,2021,"12",7614893,1220,43,1222,-2,1177,0.564682918065953,-0.0262643217705094,-0.00163666121112926
"United States","Washington","WA",2021-03-28,2021-04-03,7,2021,"13",7614893,1186,58,1214,-28,1128,0.761665331344774,-0.367700504787132,-0.0230642504118617
"United States","Washington","WA",2021-04-04,2021-04-10,7,2021,"14",7614893,1219,43,1184,35,1176,0.564682918065953,0.459625630983915,0.0295608108108107
"United States","Washington","WA",2021-04-11,2021-04-17,7,2021,"15",7614893,1201,58,1165,36,1143,0.761665331344774,0.47275779186917,0.0309012875536481
"United States","Washington","WA",2021-04-18,2021-04-24,7,2021,"16",7614893,1218,54,1159,59,1164,0.709136687803755,0.774797492230029,0.0509059534081104
"United States","Washington","WA",2021-04-25,2021-05-01,7,2021,"17",7614893,1232,65,1140,92,1167,0.853590457541557,1.20815880144343,0.0807017543859649
"United States","Washington","WA",2021-05-02,2021-05-08,7,2021,"18",7614893,1214,65,1135,79,1149,0.853590457541557,1.03744070993512,0.0696035242290749
"United States","Washington","WA",2021-05-09,2021-05-15,7,2021,"19",7614893,1195,58,1128,67,1137,0.761665331344774,0.879854779312066,0.0593971631205674
"United States","Washington","WA",2021-05-16,2021-05-22,7,2021,"20",7614893,1161,80,1126,35,1081,1.05057287082038,0.459625630983915,0.0310834813499112
"United States","Washington","WA",2021-05-23,2021-05-29,7,2021,"21",7614893,1199,63,1119,80,1136,0.827326135771048,1.05057287082038,0.0714924039320821
"United States","Washington","WA",2021-05-30,2021-06-05,7,2021,"22",7614893,1203,71,1097,106,1132,0.932383422853086,1.392009053837,0.0966271649954422
"United States","Washington","WA",2021-06-06,2021-06-12,7,2021,"23",7614893,913,-21,1092,-179,934,-0.275775378590349,-2.3506567984606,-0.163919413919414
"United States","Washington","WA",2021-06-20,2021-06-26,7,2021,"25",7614893,916,82,1109,-193,834,1.07683719259089,-2.53450705085416,-0.174030658250676
"United States","West Virginia","WV",2019-12-29,2020-01-04,7,2020,"1",1792147,474,0,511,-37,474,0,-2.06456278419125,-0.0724070450097848
"United States","West Virginia","WV",2020-01-05,2020-01-11,7,2020,"2",1792147,494,0,515,-21,494,0,-1.17177887751395,-0.0407766990291262
"United States","West Virginia","WV",2020-01-12,2020-01-18,7,2020,"3",1792147,520,0,514,6,520,0,0.334793965003987,0.0116731517509727
"United States","West Virginia","WV",2020-01-19,2020-01-25,7,2020,"4",1792147,442,0,500,-58,442,0,-3.23634166170521,-0.116
"United States","West Virginia","WV",2020-01-26,2020-02-01,7,2020,"5",1792147,482,0,487,-5,482,0,-0.278994970836656,-0.0102669404517454
"United States","West Virginia","WV",2020-02-02,2020-02-08,7,2020,"6",1792147,482,0,484,-2,482,0,-0.111597988334662,-0.00413223140495866
"United States","West Virginia","WV",2020-02-09,2020-02-15,7,2020,"7",1792147,478,0,479,-1,478,0,-0.0557989941673311,-0.0020876826722338
"United States","West Virginia","WV",2020-02-16,2020-02-22,7,2020,"8",1792147,467,0,473,-6,467,0,-0.334793965003987,-0.0126849894291755
"United States","West Virginia","WV",2020-02-23,2020-02-29,7,2020,"9",1792147,460,0,468,-8,460,0,-0.446391953338649,-0.0170940170940171
"United States","West Virginia","WV",2020-03-01,2020-03-07,7,2020,"10",1792147,483,0,466,17,483,0,0.948582900844629,0.0364806866952789
"United States","West Virginia","WV",2020-03-08,2020-03-14,7,2020,"11",1792147,475,0,470,5,475,0,0.278994970836656,0.0106382978723405
"United States","West Virginia","WV",2020-03-15,2020-03-21,7,2020,"12",1792147,470,0,472,-2,470,0,-0.111597988334662,-0.00423728813559321
"United States","West Virginia","WV",2020-03-22,2020-03-28,7,2020,"13",1792147,491,0,475,16,491,0,0.892783906677298,0.0336842105263158
"United States","West Virginia","WV",2020-03-29,2020-04-04,7,2020,"14",1792147,467,2,477,-10,465,0.111597988334662,-0.557989941673311,-0.0209643605870021
"United States","West Virginia","WV",2020-04-05,2020-04-11,7,2020,"15",1792147,523,4,465,58,519,0.223195976669325,3.23634166170521,0.124731182795699
"United States","West Virginia","WV",2020-04-12,2020-04-18,7,2020,"16",1792147,419,12,461,-42,407,0.669587930007974,-2.34355775502791,-0.0911062906724512
"United States","West Virginia","WV",2020-04-19,2020-04-25,7,2020,"17",1792147,460,15,448,12,445,0.836984912509967,0.669587930007974,0.0267857142857142
"United States","West Virginia","WV",2020-04-26,2020-05-02,7,2020,"18",1792147,482,16,439,43,466,0.892783906677298,2.39935674919524,0.0979498861047836
"United States","West Virginia","WV",2020-05-03,2020-05-09,7,2020,"19",1792147,449,3,425,24,446,0.167396982501993,1.33917586001595,0.0564705882352941
"United States","West Virginia","WV",2020-05-10,2020-05-16,7,2020,"20",1792147,477,12,424,53,465,0.669587930007974,2.95734669086855,0.125
"United States","West Virginia","WV",2020-05-17,2020-05-23,7,2020,"21",1792147,440,7,424,16,433,0.390592959171318,0.892783906677298,0.0377358490566038
"United States","West Virginia","WV",2020-05-24,2020-05-30,7,2020,"22",1792147,412,2,423,-11,410,0.111597988334662,-0.613788935840643,-0.0260047281323877
"United States","West Virginia","WV",2020-05-31,2020-06-06,7,2020,"23",1792147,409,11,419,-10,398,0.613788935840643,-0.557989941673311,-0.0238663484486874
"United States","West Virginia","WV",2020-06-07,2020-06-13,7,2020,"24",1792147,458,4,421,37,454,0.223195976669325,2.06456278419125,0.0878859857482186
"United States","West Virginia","WV",2020-06-14,2020-06-20,7,2020,"25",1792147,419,0,419,0,419,0,0,0
"United States","West Virginia","WV",2020-06-21,2020-06-27,7,2020,"26",1792147,464,5,421,43,459,0.278994970836656,2.39935674919524,0.102137767220903
"United States","West Virginia","WV",2020-06-28,2020-07-04,7,2020,"27",1792147,425,1,416,9,424,0.0557989941673311,0.50219094750598,0.0216346153846154
"United States","West Virginia","WV",2020-07-05,2020-07-11,7,2020,"28",1792147,436,2,415,21,434,0.111597988334662,1.17177887751395,0.0506024096385542
"United States","West Virginia","WV",2020-07-12,2020-07-18,7,2020,"29",1792147,426,4,411,15,422,0.223195976669325,0.836984912509967,0.0364963503649636
"United States","West Virginia","WV",2020-07-19,2020-07-25,7,2020,"30",1792147,501,3,402,99,498,0.167396982501993,5.52410042256578,0.246268656716418
"United States","West Virginia","WV",2020-07-26,2020-08-01,7,2020,"31",1792147,474,13,395,79,461,0.725386924175305,4.40812053921916,0.2
"United States","West Virginia","WV",2020-08-02,2020-08-08,7,2020,"32",1792147,494,15,397,97,479,0.836984912509967,5.41250243423112,0.244332493702771
"United States","West Virginia","WV",2020-08-09,2020-08-15,7,2020,"33",1792147,462,29,399,63,433,1.6181708308526,3.51533663254186,0.157894736842105
"United States","West Virginia","WV",2020-08-16,2020-08-22,7,2020,"34",1792147,497,16,403,94,481,0.892783906677298,5.24510545172913,0.233250620347395
"United States","West Virginia","WV",2020-08-23,2020-08-29,7,2020,"35",1792147,442,36,411,31,406,2.00876379002392,1.72976881918727,0.0754257907542579
"United States","West Virginia","WV",2020-08-30,2020-09-05,7,2020,"36",1792147,460,31,416,44,429,1.72976881918727,2.45515574336257,0.105769230769231
"United States","West Virginia","WV",2020-09-06,2020-09-12,7,2020,"37",1792147,468,22,418,50,446,1.22757787168129,2.78994970836656,0.119617224880383
"United States","West Virginia","WV",2020-09-13,2020-09-19,7,2020,"38",1792147,484,43,417,67,441,2.39935674919524,3.73853260921119,0.160671462829736
"United States","West Virginia","WV",2020-09-20,2020-09-26,7,2020,"39",1792147,495,24,421,74,471,1.33917586001595,4.1291255683825,0.175771971496437
"United States","West Virginia","WV",2020-09-27,2020-10-03,7,2020,"40",1792147,424,25,424,0,399,1.39497485418328,0,0
"United States","West Virginia","WV",2020-10-04,2020-10-10,7,2020,"41",1792147,500,24,429,71,476,1.33917586001595,3.96172858588051,0.165501165501166
"United States","West Virginia","WV",2020-10-11,2020-10-17,7,2020,"42",1792147,455,18,437,18,437,1.00438189501196,1.00438189501196,0.0411899313501145
"United States","West Virginia","WV",2020-10-18,2020-10-24,7,2020,"43",1792147,471,23,441,30,448,1.28337686584862,1.67396982501993,0.0680272108843538
"United States","West Virginia","WV",2020-10-25,2020-10-31,7,2020,"44",1792147,485,31,442,43,454,1.72976881918727,2.39935674919524,0.0972850678733033
"United States","West Virginia","WV",2020-11-01,2020-11-07,7,2020,"45",1792147,531,48,442,89,483,2.67835172003189,4.96611048089247,0.201357466063348
"United States","West Virginia","WV",2020-11-08,2020-11-14,7,2020,"46",1792147,554,72,443,111,482,4.01752758004784,6.19368835257376,0.250564334085779
"United States","West Virginia","WV",2020-11-15,2020-11-21,7,2020,"47",1792147,524,65,443,81,459,3.62693462087652,4.51971852755382,0.182844243792325
"United States","West Virginia","WV",2020-11-22,2020-11-28,7,2020,"48",1792147,570,80,447,123,490,4.46391953338649,6.86327628258173,0.275167785234899
"United States","West Virginia","WV",2020-11-29,2020-12-05,7,2020,"49",1792147,637,111,454,183,526,6.19368835257376,10.2112159326216,0.403083700440529
"United States","West Virginia","WV",2020-12-06,2020-12-12,7,2020,"50",1792147,647,137,459,188,510,7.64446220092437,10.4902109034583,0.40958605664488
"United States","West Virginia","WV",2020-12-13,2020-12-19,7,2020,"51",1792147,695,156,467,228,539,8.70464309010366,12.7221706701515,0.488222698072805
"United States","West Virginia","WV",2020-12-20,2020-12-26,7,2020,"52",1792147,669,6,475,194,663,0.334793965003987,10.8250048684622,0.408421052631579
"United States","West Virginia","WV",2020-12-27,2021-01-02,7,2020,"53",1792147,729,245,484,245,484,13.6707535709961,13.6707535709961,0.506198347107438
"United States","West Virginia","WV",2021-01-03,2021-01-09,7,2021,"1",1792147,719,197,494,225,522,10.9924018509642,12.5547736876495,0.455465587044534
"United States","West Virginia","WV",2021-01-10,2021-01-16,7,2021,"2",1792147,678,191,493,185,487,10.6576078859602,10.3228139209563,0.37525354969574
"United States","West Virginia","WV",2021-01-17,2021-01-23,7,2021,"3",1792147,607,111,489,118,496,6.19368835257376,6.58428131174507,0.241308793456033
"United States","West Virginia","WV",2021-01-24,2021-01-30,7,2021,"4",1792147,621,143,489,132,478,7.97925616592835,7.36546723008771,0.269938650306748
"United States","West Virginia","WV",2021-01-31,2021-02-06,7,2021,"5",1792147,585,104,480,105,481,5.80309539340244,5.85889438756977,0.21875
"United States","West Virginia","WV",2021-02-07,2021-02-13,7,2021,"6",1792147,573,80,475,98,493,4.46391953338649,5.46830142839845,0.206315789473684
"United States","West Virginia","WV",2021-02-14,2021-02-20,7,2021,"7",1792147,509,17,468,41,492,0.948582900844629,2.28775876086058,0.0876068376068375
"United States","West Virginia","WV",2021-02-21,2021-02-27,7,2021,"8",1792147,487,75,469,18,412,4.18492456254984,1.00438189501196,0.0383795309168444
"United States","West Virginia","WV",2021-02-28,2021-03-06,7,2021,"9",1792147,501,27,465,36,474,1.50657284251794,2.00876379002392,0.0774193548387097
"United States","West Virginia","WV",2021-03-07,2021-03-13,7,2021,"10",1792147,484,212,475,9,272,11.8293867634742,0.50219094750598,0.0189473684210526
"United States","West Virginia","WV",2021-03-14,2021-03-20,7,2021,"11",1792147,501,75,474,27,426,4.18492456254984,1.50657284251794,0.0569620253164558
"United States","West Virginia","WV",2021-03-21,2021-03-27,7,2021,"12",1792147,508,34,477,31,474,1.89716580168926,1.72976881918727,0.0649895178197064
"United States","West Virginia","WV",2021-03-28,2021-04-03,7,2021,"13",1792147,469,59,478,-9,410,3.29214065587254,-0.50219094750598,-0.0188284518828452
"United States","West Virginia","WV",2021-04-04,2021-04-10,7,2021,"14",1792147,479,39,475,4,440,2.17616077252591,0.223195976669325,0.00842105263157888
"United States","West Virginia","WV",2021-04-11,2021-04-17,7,2021,"15",1792147,495,43,464,31,452,2.39935674919524,1.72976881918727,0.0668103448275863
"United States","West Virginia","WV",2021-04-18,2021-04-24,7,2021,"16",1792147,448,37,458,-10,411,2.06456278419125,-0.557989941673311,-0.0218340611353712
"United States","West Virginia","WV",2021-04-25,2021-05-01,7,2021,"17",1792147,500,-138,450,50,638,-7.7002611950917,2.78994970836656,0.111111111111111
"United States","West Virginia","WV",2021-05-02,2021-05-08,7,2021,"18",1792147,454,47,442,12,407,2.62255272586456,0.669587930007974,0.0271493212669682
"United States","West Virginia","WV",2021-05-09,2021-05-15,7,2021,"19",1792147,438,31,440,-2,407,1.72976881918727,-0.111597988334662,-0.00454545454545452
"United States","West Virginia","WV",2021-05-16,2021-05-22,7,2021,"20",1792147,392,15,438,-46,377,0.836984912509967,-2.56675373169723,-0.105022831050228
"United States","West Virginia","WV",2021-05-23,2021-05-29,7,2021,"21",1792147,256,20,431,-175,236,1.11597988334662,-9.76482397928295,-0.406032482598608
"United States","Wisconsin","WI",2019-12-29,2020-01-04,7,2020,"1",5822434,1118,0,1155,-37,1118,0,-0.635473068479608,-0.0320346320346321
"United States","Wisconsin","WI",2020-01-05,2020-01-11,7,2020,"2",5822434,1060,0,1168,-108,1060,0,-1.85489436204859,-0.0924657534246576
"United States","Wisconsin","WI",2020-01-12,2020-01-18,7,2020,"3",5822434,1133,0,1174,-41,1133,0,-0.704172859666593,-0.034923339011925
"United States","Wisconsin","WI",2020-01-19,2020-01-25,7,2020,"4",5822434,1086,0,1171,-85,1086,0,-1.45987056272342,-0.0725875320239112
"United States","Wisconsin","WI",2020-01-26,2020-02-01,7,2020,"5",5822434,1176,0,1158,18,1176,0,0.309149060341431,0.0155440414507773
"United States","Wisconsin","WI",2020-02-02,2020-02-08,7,2020,"6",5822434,1056,0,1152,-96,1056,0,-1.64879498848763,-0.0833333333333334
"United States","Wisconsin","WI",2020-02-09,2020-02-15,7,2020,"7",5822434,1125,0,1135,-10,1125,0,-0.171749477967462,-0.00881057268722463
"United States","Wisconsin","WI",2020-02-16,2020-02-22,7,2020,"8",5822434,1162,0,1130,32,1162,0,0.549598329495878,0.0283185840707965
"United States","Wisconsin","WI",2020-02-23,2020-02-29,7,2020,"9",5822434,1136,0,1104,32,1136,0,0.549598329495878,0.0289855072463767
"United States","Wisconsin","WI",2020-03-01,2020-03-07,7,2020,"10",5822434,1116,0,1105,11,1116,0,0.188924425764208,0.00995475113122168
"United States","Wisconsin","WI",2020-03-08,2020-03-14,7,2020,"11",5822434,1105,0,1113,-8,1105,0,-0.137399582373969,-0.00718778077268645
"United States","Wisconsin","WI",2020-03-15,2020-03-21,7,2020,"12",5822434,1115,4,1109,6,1111,0.0686997911869847,0.103049686780477,0.00541027953110906
"United States","Wisconsin","WI",2020-03-22,2020-03-28,7,2020,"13",5822434,1146,9,1115,31,1137,0.154574530170716,0.532423381699131,0.0278026905829596
"United States","Wisconsin","WI",2020-03-29,2020-04-04,7,2020,"14",5822434,1221,43,1112,109,1178,0.738522755260085,1.87206930984533,0.0980215827338129
"United States","Wisconsin","WI",2020-04-05,2020-04-11,7,2020,"15",5822434,1171,81,1097,74,1090,1.39117077153644,1.27094613695922,0.0674567000911577
"United States","Wisconsin","WI",2020-04-12,2020-04-18,7,2020,"16",5822434,1152,74,1088,64,1078,1.27094613695922,1.09919665899176,0.0588235294117647
"United States","Wisconsin","WI",2020-04-19,2020-04-25,7,2020,"17",5822434,1026,55,1084,-58,971,0.944622128821039,-0.996146972211278,-0.0535055350553506
"United States","Wisconsin","WI",2020-04-26,2020-05-02,7,2020,"18",5822434,1162,68,1069,93,1094,1.16789645017874,1.59727014509739,0.0869971936389149
"United States","Wisconsin","WI",2020-05-03,2020-05-09,7,2020,"19",5822434,1080,64,1051,29,1016,1.09919665899176,0.498073486105639,0.0275927687916271
"United States","Wisconsin","WI",2020-05-10,2020-05-16,7,2020,"20",5822434,1022,54,1044,-22,968,0.927447181024293,-0.377848851528416,-0.0210727969348659
"United States","Wisconsin","WI",2020-05-17,2020-05-23,7,2020,"21",5822434,1078,55,1031,47,1023,0.944622128821039,0.80722254644707,0.0455868089233753
"United States","Wisconsin","WI",2020-05-24,2020-05-30,7,2020,"22",5822434,1139,81,1015,124,1058,1.39117077153644,2.12969352679653,0.122167487684729
"United States","Wisconsin","WI",2020-05-31,2020-06-06,7,2020,"23",5822434,1043,57,1005,38,986,0.978972024414532,0.652648016276354,0.0378109452736319
"United States","Wisconsin","WI",2020-06-07,2020-06-13,7,2020,"24",5822434,1026,46,998,28,980,0.790047598650324,0.480898538308893,0.0280561122244489
"United States","Wisconsin","WI",2020-06-14,2020-06-20,7,2020,"25",5822434,1085,52,1002,83,1033,0.893097285430801,1.42552066712993,0.0828343313373254
"United States","Wisconsin","WI",2020-06-21,2020-06-27,7,2020,"26",5822434,1034,34,1010,24,1000,0.58394822508937,0.412198747121908,0.0237623762376238
"United States","Wisconsin","WI",2020-06-28,2020-07-04,7,2020,"27",5822434,1066,19,1011,55,1047,0.326324008138177,0.944622128821039,0.0544015825914936
"United States","Wisconsin","WI",2020-07-05,2020-07-11,7,2020,"28",5822434,1049,25,1002,47,1024,0.429373694918654,0.80722254644707,0.0469061876247505
"United States","Wisconsin","WI",2020-07-12,2020-07-18,7,2020,"29",5822434,1039,22,998,41,1017,0.377848851528416,0.704172859666593,0.0410821643286574
"United States","Wisconsin","WI",2020-07-19,2020-07-25,7,2020,"30",5822434,1101,48,986,115,1053,0.824397494243816,1.97511899662581,0.116632860040568
"United States","Wisconsin","WI",2020-07-26,2020-08-01,7,2020,"31",5822434,1057,56,977,80,1001,0.961797076617786,1.37399582373969,0.0818833162743091
"United States","Wisconsin","WI",2020-08-02,2020-08-08,7,2020,"32",5822434,1099,49,980,119,1050,0.841572442040562,2.04381878781279,0.121428571428571
"United States","Wisconsin","WI",2020-08-09,2020-08-15,7,2020,"33",5822434,1126,42,983,143,1084,0.721347807463339,2.4560175349347,0.145473041709054
"United States","Wisconsin","WI",2020-08-16,2020-08-22,7,2020,"34",5822434,1061,43,974,87,1018,0.738522755260085,1.49422045831692,0.0893223819301847
"United States","Wisconsin","WI",2020-08-23,2020-08-29,7,2020,"35",5822434,1082,38,979,103,1044,0.652648016276354,1.76901962306486,0.105209397344229
"United States","Wisconsin","WI",2020-08-30,2020-09-05,7,2020,"36",5822434,1039,49,986,53,990,0.841572442040562,0.910272233227547,0.0537525354969575
"United States","Wisconsin","WI",2020-09-06,2020-09-12,7,2020,"37",5822434,1066,41,986,80,1025,0.704172859666593,1.37399582373969,0.0811359026369169
"United States","Wisconsin","WI",2020-09-13,2020-09-19,7,2020,"38",5822434,1140,32,988,152,1108,0.549598329495878,2.61059206510542,0.153846153846154
"United States","Wisconsin","WI",2020-09-20,2020-09-26,7,2020,"39",5822434,1102,40,1004,98,1062,0.686997911869847,1.68314488408112,0.097609561752988
"United States","Wisconsin","WI",2020-09-27,2020-10-03,7,2020,"40",5822434,1157,91,1011,146,1066,1.5629202495039,2.50754237832494,0.144411473788328
"United States","Wisconsin","WI",2020-10-04,2020-10-10,7,2020,"41",5822434,1163,86,1016,147,1077,1.47704551052017,2.52471732612169,0.144685039370079
"United States","Wisconsin","WI",2020-10-11,2020-10-17,7,2020,"42",5822434,1244,116,1020,224,1128,1.99229394442256,3.84718830647114,0.219607843137255
"United States","Wisconsin","WI",2020-10-18,2020-10-24,7,2020,"43",5822434,1387,196,1023,364,1191,3.36628976816225,6.25168099801561,0.355816226783969
"United States","Wisconsin","WI",2020-10-25,2020-10-31,7,2020,"44",5822434,1454,259,1034,420,1195,4.44831147935726,7.21347807463339,0.406189555125725
"United States","Wisconsin","WI",2020-11-01,2020-11-07,7,2020,"45",5822434,1601,272,1041,560,1329,4.67158580071496,9.61797076617786,0.537944284341979
"United States","Wisconsin","WI",2020-11-08,2020-11-14,7,2020,"46",5822434,1716,323,1039,677,1393,5.54750813834901,11.6274396583972,0.651588065447546
"United States","Wisconsin","WI",2020-11-15,2020-11-21,7,2020,"47",5822434,1657,327,1029,628,1330,5.616207929536,10.7858672163566,0.610301263362488
"United States","Wisconsin","WI",2020-11-22,2020-11-28,7,2020,"48",5822434,1636,333,1040,596,1303,5.71925761631648,10.2362688868607,0.573076923076923
"United States","Wisconsin","WI",2020-11-29,2020-12-05,7,2020,"49",5822434,1652,415,1044,608,1237,7.12760333564966,10.4423682604217,0.582375478927203
"United States","Wisconsin","WI",2020-12-06,2020-12-12,7,2020,"50",5822434,1569,340,1047,522,1229,5.8394822508937,8.9653227499015,0.498567335243553
"United States","Wisconsin","WI",2020-12-13,2020-12-19,7,2020,"51",5822434,1500,360,1065,435,1140,6.18298120682862,7.47110229158459,0.408450704225352
"United States","Wisconsin","WI",2020-12-20,2020-12-26,7,2020,"52",5822434,1404,283,1082,322,1121,4.86051022647917,5.53033319055227,0.297597042513863
"United States","Wisconsin","WI",2020-12-27,2021-01-02,7,2020,"53",5822434,1403,187,1096,307,1216,3.21171523799153,5.27270897360108,0.280109489051095
"United States","Wisconsin","WI",2021-01-03,2021-01-09,7,2021,"1",5822434,1378,286,1108,270,1092,4.91203506986941,4.63723590512147,0.243682310469314
"United States","Wisconsin","WI",2021-01-10,2021-01-16,7,2021,"2",5822434,1264,294,1133,131,970,5.04943465224337,2.24991816137375,0.115622241835834
"United States","Wisconsin","WI",2021-01-17,2021-01-23,7,2021,"3",5822434,1283,235,1127,156,1048,4.03611273223535,2.6792918562924,0.138420585625554
"United States","Wisconsin","WI",2021-01-24,2021-01-30,7,2021,"4",5822434,1197,208,1132,65,989,3.5723891417232,1.1163716067885,0.0574204946996466
"United States","Wisconsin","WI",2021-01-31,2021-02-06,7,2021,"5",5822434,1163,162,1124,39,1001,2.78234154307288,0.669822964073101,0.0346975088967971
"United States","Wisconsin","WI",2021-02-07,2021-02-13,7,2021,"6",5822434,1151,110,1110,41,1041,1.88924425764208,0.704172859666593,0.036936936936937
"United States","Wisconsin","WI",2021-02-14,2021-02-20,7,2021,"7",5822434,1132,121,1092,40,1011,2.07816868340629,0.686997911869847,0.0366300366300367
"United States","Wisconsin","WI",2021-02-21,2021-02-27,7,2021,"8",5822434,1111,130,1090,21,981,2.232743213577,0.36067390373167,0.0192660550458716
"United States","Wisconsin","WI",2021-02-28,2021-03-06,7,2021,"9",5822434,1081,71,1077,4,1010,1.21942129356898,0.0686997911869847,0.00371402042711244
"United States","Wisconsin","WI",2021-03-07,2021-03-13,7,2021,"10",5822434,1060,65,1081,-21,995,1.1163716067885,-0.36067390373167,-0.0194264569842738
"United States","Wisconsin","WI",2021-03-14,2021-03-20,7,2021,"11",5822434,1000,55,1089,-89,945,0.944622128821039,-1.52857035391041,-0.0817263544536272
"United States","Wisconsin","WI",2021-03-21,2021-03-27,7,2021,"12",5822434,1031,29,1083,-52,1002,0.498073486105639,-0.893097285430801,-0.0480147737765466
"United States","Wisconsin","WI",2021-03-28,2021-04-03,7,2021,"13",5822434,984,5,1074,-90,979,0.0858747389837309,-1.54574530170716,-0.0837988826815642
"United States","Wisconsin","WI",2021-04-04,2021-04-10,7,2021,"14",5822434,1065,36,1073,-8,1029,0.618298120682862,-0.137399582373969,-0.00745573159366264
"United States","Wisconsin","WI",2021-04-11,2021-04-17,7,2021,"15",5822434,991,35,1061,-70,956,0.601123172886116,-1.20224634577223,-0.0659754948162111
"United States","Wisconsin","WI",2021-04-18,2021-04-24,7,2021,"16",5822434,1077,46,1055,22,1031,0.790047598650324,0.377848851528416,0.0208530805687204
"United States","Wisconsin","WI",2021-04-25,2021-05-01,7,2021,"17",5822434,1026,84,1055,-29,942,1.44269561492668,-0.498073486105639,-0.0274881516587677
"United States","Wisconsin","WI",2021-05-02,2021-05-08,7,2021,"18",5822434,1025,63,1050,-25,962,1.08202171119501,-0.429373694918654,-0.0238095238095238
"United States","Wisconsin","WI",2021-05-09,2021-05-15,7,2021,"19",5822434,1004,54,1043,-39,950,0.927447181024293,-0.669822964073101,-0.037392138063279
"United States","Wisconsin","WI",2021-05-16,2021-05-22,7,2021,"20",5822434,1028,31,1037,-9,997,0.532423381699131,-0.154574530170716,-0.00867888138862105
"United States","Wisconsin","WI",2021-05-23,2021-05-29,7,2021,"21",5822434,1016,64,1013,3,952,1.09919665899176,0.0515248433902385,0.00296150049358346
"United States","Wisconsin","WI",2021-05-30,2021-06-05,7,2021,"22",5822434,1048,97,999,49,951,1.66596993628438,0.841572442040562,0.0490490490490489
"United States","Wisconsin","WI",2021-06-06,2021-06-12,7,2021,"23",5822434,1041,56,990,51,985,0.961797076617786,0.875922337634055,0.0515151515151515
"United States","Wisconsin","WI",2021-06-13,2021-06-19,7,2021,"24",5822434,995,29,997,-2,966,0.498073486105639,-0.0343498955934923,-0.00200601805416245
"United States","Wisconsin","WI",2021-06-20,2021-06-26,7,2021,"25",5822434,768,45,1004,-236,723,0.772872650853578,-4.0532876800321,-0.235059760956175
"United States","Wyoming","WY",2019-12-29,2020-01-04,7,2020,"1",578759,144,0,91,53,144,0,9.15752498017309,0.582417582417582
"United States","Wyoming","WY",2020-01-05,2020-01-11,7,2020,"2",578759,81,0,92,-11,81,0,-1.9006183921114,-0.119565217391304
"United States","Wyoming","WY",2020-01-12,2020-01-18,7,2020,"3",578759,103,0,93,10,103,0,1.72783490191945,0.10752688172043
"United States","Wyoming","WY",2020-01-19,2020-01-25,7,2020,"4",578759,96,0,94,2,96,0,0.34556698038389,0.0212765957446808
"United States","Wyoming","WY",2020-01-26,2020-02-01,7,2020,"5",578759,94,0,96,-2,94,0,-0.34556698038389,-0.0208333333333334
"United States","Wyoming","WY",2020-02-02,2020-02-08,7,2020,"6",578759,97,0,95,2,97,0,0.34556698038389,0.0210526315789474
"United States","Wyoming","WY",2020-02-09,2020-02-15,7,2020,"7",578759,75,0,96,-21,75,0,-3.62845329403085,-0.21875
"United States","Wyoming","WY",2020-02-16,2020-02-22,7,2020,"8",578759,101,0,95,6,101,0,1.03670094115167,0.0631578947368421
"United States","Wyoming","WY",2020-02-23,2020-02-29,7,2020,"9",578759,100,0,94,6,100,0,1.03670094115167,0.0638297872340425
"United States","Wyoming","WY",2020-03-01,2020-03-07,7,2020,"10",578759,80,0,94,-14,80,0,-2.41896886268723,-0.148936170212766
"United States","Wyoming","WY",2020-03-08,2020-03-14,7,2020,"11",578759,85,0,94,-9,85,0,-1.55505141172751,-0.0957446808510638
"United States","Wyoming","WY",2020-03-15,2020-03-21,7,2020,"12",578759,117,0,96,21,117,0,3.62845329403085,0.21875
"United States","Wyoming","WY",2020-03-22,2020-03-28,7,2020,"13",578759,88,0,93,-5,88,0,-0.863917450959726,-0.053763440860215
"United States","Wyoming","WY",2020-03-29,2020-04-04,7,2020,"14",578759,123,0,95,28,123,0,4.83793772537446,0.294736842105263
"United States","Wyoming","WY",2020-04-05,2020-04-11,7,2020,"15",578759,102,0,93,9,102,0,1.55505141172751,0.096774193548387
"United States","Wyoming","WY",2020-04-12,2020-04-18,7,2020,"16",578759,89,2,89,0,87,0.34556698038389,0,0
"United States","Wyoming","WY",2020-04-19,2020-04-25,7,2020,"17",578759,98,5,88,10,93,0.863917450959726,1.72783490191945,0.113636363636364
"United States","Wyoming","WY",2020-04-26,2020-05-02,7,2020,"18",578759,68,0,90,-22,68,0,-3.80123678422279,-0.244444444444444
"United States","Wyoming","WY",2020-05-03,2020-05-09,7,2020,"19",578759,83,0,91,-8,83,0,-1.38226792153556,-0.0879120879120879
"United States","Wyoming","WY",2020-05-10,2020-05-16,7,2020,"20",578759,101,0,91,10,101,0,1.72783490191945,0.10989010989011
"United States","Wyoming","WY",2020-05-17,2020-05-23,7,2020,"21",578759,96,5,92,4,91,0.863917450959726,0.691133960767781,0.0434782608695652
"United States","Wyoming","WY",2020-05-24,2020-05-30,7,2020,"22",578759,84,3,91,-7,81,0.518350470575835,-1.20948443134362,-0.0769230769230769
"United States","Wyoming","WY",2020-05-31,2020-06-06,7,2020,"23",578759,105,2,92,13,103,0.34556698038389,2.24618537249529,0.141304347826087
"United States","Wyoming","WY",2020-06-07,2020-06-13,7,2020,"24",578759,96,1,91,5,95,0.172783490191945,0.863917450959726,0.054945054945055
"United States","Wyoming","WY",2020-06-14,2020-06-20,7,2020,"25",578759,93,2,92,1,91,0.34556698038389,0.172783490191945,0.0108695652173914
"United States","Wyoming","WY",2020-06-21,2020-06-27,7,2020,"26",578759,89,0,94,-5,89,0,-0.863917450959726,-0.0531914893617021
"United States","Wyoming","WY",2020-06-28,2020-07-04,7,2020,"27",578759,102,0,96,6,102,0,1.03670094115167,0.0625
"United States","Wyoming","WY",2020-07-05,2020-07-11,7,2020,"28",578759,104,1,96,8,103,0.172783490191945,1.38226792153556,0.0833333333333333
"United States","Wyoming","WY",2020-07-12,2020-07-18,7,2020,"29",578759,101,3,96,5,98,0.518350470575835,0.863917450959726,0.0520833333333333
"United States","Wyoming","WY",2020-07-19,2020-07-25,7,2020,"30",578759,95,1,98,-3,94,0.172783490191945,-0.518350470575835,-0.0306122448979592
"United States","Wyoming","WY",2020-07-26,2020-08-01,7,2020,"31",578759,90,0,97,-7,90,0,-1.20948443134362,-0.0721649484536082
"United States","Wyoming","WY",2020-08-02,2020-08-08,7,2020,"32",578759,106,2,98,8,104,0.34556698038389,1.38226792153556,0.0816326530612246
"United States","Wyoming","WY",2020-08-09,2020-08-15,7,2020,"33",578759,113,1,96,17,112,0.172783490191945,2.93731933326307,0.177083333333333
"United States","Wyoming","WY",2020-08-16,2020-08-22,7,2020,"34",578759,100,9,98,2,91,1.55505141172751,0.34556698038389,0.0204081632653061
"United States","Wyoming","WY",2020-08-23,2020-08-29,7,2020,"35",578759,89,0,98,-9,89,0,-1.55505141172751,-0.0918367346938775
"United States","Wyoming","WY",2020-08-30,2020-09-05,7,2020,"36",578759,107,5,95,12,102,0.863917450959726,2.07340188230334,0.126315789473684
"United States","Wyoming","WY",2020-09-06,2020-09-12,7,2020,"37",578759,121,0,94,27,121,0,4.66515423518252,0.287234042553191
"United States","Wyoming","WY",2020-09-13,2020-09-19,7,2020,"38",578759,94,7,93,1,87,1.20948443134362,0.172783490191945,0.010752688172043
"United States","Wyoming","WY",2020-09-20,2020-09-26,7,2020,"39",578759,112,1,92,20,111,0.172783490191945,3.4556698038389,0.217391304347826
"United States","Wyoming","WY",2020-09-27,2020-10-03,7,2020,"40",578759,119,3,94,25,116,0.518350470575835,4.31958725479863,0.265957446808511
"United States","Wyoming","WY",2020-10-04,2020-10-10,7,2020,"41",578759,102,0,95,7,102,0,1.20948443134362,0.0736842105263158
"United States","Wyoming","WY",2020-10-11,2020-10-17,7,2020,"42",578759,107,4,95,12,103,0.691133960767781,2.07340188230334,0.126315789473684
"United States","Wyoming","WY",2020-10-18,2020-10-24,7,2020,"43",578759,131,11,96,35,120,1.9006183921114,6.04742215671808,0.364583333333333
"United States","Wyoming","WY",2020-10-25,2020-10-31,7,2020,"44",578759,114,19,96,18,95,3.28288631364696,3.11010282345501,0.1875
"United States","Wyoming","WY",2020-11-01,2020-11-07,7,2020,"45",578759,136,17,95,41,119,2.93731933326307,7.08412309786975,0.431578947368421
"United States","Wyoming","WY",2020-11-08,2020-11-14,7,2020,"46",578759,132,19,98,34,113,3.28288631364696,5.87463866652614,0.346938775510204
"United States","Wyoming","WY",2020-11-15,2020-11-21,7,2020,"47",578759,135,41,100,35,94,7.08412309786975,6.04742215671808,0.35
"United States","Wyoming","WY",2020-11-22,2020-11-28,7,2020,"48",578759,138,51,100,38,87,8.8119579997892,6.56577262729392,0.38
"United States","Wyoming","WY",2020-11-29,2020-12-05,7,2020,"49",578759,123,42,104,19,81,7.2569065880617,3.28288631364696,0.182692307692308
"United States","Wyoming","WY",2020-12-06,2020-12-12,7,2020,"50",578759,143,64,103,40,79,11.0581433722845,6.91133960767781,0.388349514563107
"United States","Wyoming","WY",2020-12-13,2020-12-19,7,2020,"51",578759,165,30,102,63,135,5.18350470575835,10.8853598820925,0.617647058823529
"United States","Wyoming","WY",2020-12-20,2020-12-26,7,2020,"52",578759,130,0,103,27,130,0,4.66515423518252,0.262135922330097
"United States","Wyoming","WY",2020-12-27,2021-01-02,7,2020,"53",578759,129,87,103,26,42,15.0321636466992,4.49237074499058,0.25242718446602
"United States","Wyoming","WY",2021-01-03,2021-01-09,7,2021,"1",578759,127,51,102,25,76,8.8119579997892,4.31958725479863,0.245098039215686
"United States","Wyoming","WY",2021-01-10,2021-01-16,7,2021,"2",578759,112,33,102,10,79,5.70185517633419,1.72783490191945,0.0980392156862746
"United States","Wyoming","WY",2021-01-17,2021-01-23,7,2021,"3",578759,113,49,103,10,64,8.46639101940531,1.72783490191945,0.0970873786407767
"United States","Wyoming","WY",2021-01-24,2021-01-30,7,2021,"4",578759,121,25,100,21,96,4.31958725479863,3.62845329403085,0.21
"United States","Wyoming","WY",2021-01-31,2021-02-06,7,2021,"5",578759,114,28,102,12,86,4.83793772537446,2.07340188230334,0.117647058823529
"United States","Wyoming","WY",2021-02-07,2021-02-13,7,2021,"6",578759,104,23,99,5,81,3.97402027441474,0.863917450959726,0.0505050505050506
"United States","Wyoming","WY",2021-02-14,2021-02-20,7,2021,"7",578759,112,15,102,10,97,2.59175235287918,1.72783490191945,0.0980392156862746
"United States","Wyoming","WY",2021-02-21,2021-02-27,7,2021,"8",578759,104,9,101,3,95,1.55505141172751,0.518350470575835,0.0297029702970297
"United States","Wyoming","WY",2021-02-28,2021-03-06,7,2021,"9",578759,88,13,100,-12,75,2.24618537249529,-2.07340188230334,-0.12
"United States","Wyoming","WY",2021-03-07,2021-03-13,7,2021,"10",578759,106,9,101,5,97,1.55505141172751,0.863917450959726,0.0495049504950495
"United States","Wyoming","WY",2021-03-14,2021-03-20,7,2021,"11",578759,86,1,101,-15,85,0.172783490191945,-2.59175235287918,-0.148514851485149
"United States","Wyoming","WY",2021-03-21,2021-03-27,7,2021,"12",578759,111,2,99,12,109,0.34556698038389,2.07340188230334,0.121212121212121
"United States","Wyoming","WY",2021-03-28,2021-04-03,7,2021,"13",578759,88,4,95,-7,84,0.691133960767781,-1.20948443134362,-0.0736842105263158
"United States","Wyoming","WY",2021-04-04,2021-04-10,7,2021,"14",578759,93,1,96,-3,92,0.172783490191945,-0.518350470575835,-0.03125
"United States","Wyoming","WY",2021-04-11,2021-04-17,7,2021,"15",578759,78,2,93,-15,76,0.34556698038389,-2.59175235287918,-0.161290322580645
"United States","Wyoming","WY",2021-04-18,2021-04-24,7,2021,"16",578759,99,2,95,4,97,0.34556698038389,0.691133960767781,0.0421052631578946
"United States","Wyoming","WY",2021-04-25,2021-05-01,7,2021,"17",578759,90,2,96,-6,88,0.34556698038389,-1.03670094115167,-0.0625
"United States","Wyoming","WY",2021-05-02,2021-05-08,7,2021,"18",578759,92,3,98,-6,89,0.518350470575835,-1.03670094115167,-0.0612244897959183
"United States","Wyoming","WY",2021-05-09,2021-05-15,7,2021,"19",578759,92,2,99,-7,90,0.34556698038389,-1.20948443134362,-0.0707070707070707
"United States","Wyoming","WY",2021-05-16,2021-05-22,7,2021,"20",578759,97,1,98,-1,96,0.172783490191945,-0.172783490191945,-0.0102040816326531
"United States","Wyoming","WY",2021-05-23,2021-05-29,7,2021,"21",578759,99,6,93,6,93,1.03670094115167,1.03670094115167,0.064516129032258
"United States","Wyoming","WY",2021-05-30,2021-06-05,7,2021,"22",578759,107,1,92,15,106,0.172783490191945,2.59175235287918,0.16304347826087
"United States","Wyoming","WY",2021-06-06,2021-06-12,7,2021,"23",578759,106,5,91,15,101,0.863917450959726,2.59175235287918,0.164835164835165
"United States","Wyoming","WY",2021-06-13,2021-06-19,7,2021,"24",578759,87,9,90,-3,78,1.55505141172751,-0.518350470575835,-0.0333333333333333
"United States","Wyoming","WY",2021-06-20,2021-06-26,7,2021,"25",578759,62,6,92,-30,56,1.03670094115167,-5.18350470575835,-0.326086956521739
"United States","United States","USA",2019-12-29,2020-01-04,7,2020,"1",328300544,60193,0,62719,-2526,60193,0,-0.769416940107172,-0.0402748768315822
"United States","United States","USA",2020-01-05,2020-01-11,7,2020,"2",328300544,60742,0,63069,-2327,60742,0,-0.70880174965534,-0.0368960979244954
"United States","United States","USA",2020-01-12,2020-01-18,7,2020,"3",328300544,59363,0,63076,-3713,59363,0,-1.1309758901892,-0.0588654955926184
"United States","United States","USA",2020-01-19,2020-01-25,7,2020,"4",328300544,59171,0,62592,-3421,59171,0,-1.04203299766692,-0.0546555470347648
"United States","United States","USA",2020-01-26,2020-02-01,7,2020,"5",328300544,58836,0,61971,-3135,58836,0,-0.954917698826597,-0.0505881783414823
"United States","United States","USA",2020-02-02,2020-02-08,7,2020,"6",328300544,59482,1,61332,-1850,59481,0.00030459894699413,-0.56350805193914,-0.0301636992108524
"United States","United States","USA",2020-02-09,2020-02-15,7,2020,"7",328300544,58823,0,60698,-1875,58823,0,-0.571123025613994,-0.0308906389007875
"United States","United States","USA",2020-02-16,2020-02-22,7,2020,"8",328300544,58921,1,60204,-1283,58920,0.00030459894699413,-0.390800448993469,-0.0213108763537306
"United States","United States","USA",2020-02-23,2020-02-29,7,2020,"9",328300544,59334,1,59508,-174,59333,0.00030459894699413,-0.0530002167769786,-0.00292397660818711
"United States","United States","USA",2020-03-01,2020-03-07,7,2020,"10",328300544,59695,19,59298,397,59676,0.00578737999288847,0.12092578195667,0.00669499814496266
"United States","United States","USA",2020-03-08,2020-03-14,7,2020,"11",328300544,58672,39,58913,-241,58633,0.0118793589327711,-0.0734083462255853,-0.00409077792677337
"United States","United States","USA",2020-03-15,2020-03-21,7,2020,"12",328300544,59242,284,58451,791,58958,0.0865061009463329,0.240937767072357,0.0135327026056014
"United States","United States","USA",2020-03-22,2020-03-28,7,2020,"13",328300544,63048,1988,57996,5052,61060,0.60554270662433,1.53883388021434,0.0871094558245396
"United States","United States","USA",2020-03-29,2020-04-04,7,2020,"14",328300544,72296,7056,57397,14899,65240,2.14925016999058,4.53821971126554,0.259578026726136
"United States","United States","USA",2020-04-05,2020-04-11,7,2020,"15",328300544,79094,13519,56847,22247,65575,4.11787316441364,6.77641277377841,0.391348707935335
"United States","United States","USA",2020-04-12,2020-04-18,7,2020,"16",328300544,76828,14155,56340,20488,62673,4.31159809470191,6.24062322601573,0.36364927227547
"United States","United States","USA",2020-04-19,2020-04-25,7,2020,"17",328300544,73930,15605,55667,18263,58325,4.7532665678434,5.56289056895379,0.328075879785151
"United States","United States","USA",2020-04-26,2020-05-02,7,2020,"18",328300544,69303,12860,54874,14429,56443,3.91714245834451,4.3950582061783,0.262947844152057
"United States","United States","USA",2020-05-03,2020-05-09,7,2020,"19",328300544,66826,12666,54262,12564,54160,3.85805026262765,3.82698117003425,0.231543253105304
"United States","United States","USA",2020-05-10,2020-05-16,7,2020,"20",328300544,64480,9576,53811,10669,54904,2.91683951641579,3.24976616548037,0.198268012116482
"United States","United States","USA",2020-05-17,2020-05-23,7,2020,"21",328300544,61629,8548,53457,8172,53081,2.60371179890582,2.48918259483603,0.152870531455188
"United States","United States","USA",2020-05-24,2020-05-30,7,2020,"22",328300544,59692,6656,53252,6440,53036,2.02741059119293,1.9616172186422,0.120934424998122
"United States","United States","USA",2020-05-31,2020-06-06,7,2020,"23",328300544,58907,6391,53143,5764,52516,1.94669187023948,1.75570833047416,0.108462074026683
"United States","United States","USA",2020-06-07,2020-06-13,7,2020,"24",328300544,58046,5207,52914,5132,52839,1.58604671699843,1.56320179597387,0.0969875647276712
"United States","United States","USA",2020-06-14,2020-06-20,7,2020,"25",328300544,58010,4306,52952,5058,53704,1.31160306575672,1.54066147389631,0.0955204713702977
"United States","United States","USA",2020-06-21,2020-06-27,7,2020,"26",328300544,58510,5858,52848,5662,52652,1.78434063149161,1.72463923788076,0.107137450802301
"United States","United States","USA",2020-06-28,2020-07-04,7,2020,"27",328300544,59824,4079,52581,7243,55745,1.24245910478906,2.20621017307848,0.137749377151443
"United States","United States","USA",2020-07-05,2020-07-11,7,2020,"28",328300544,61944,4858,52248,9696,57086,1.47974168449748,2.95339139005508,0.185576481396417
"United States","United States","USA",2020-07-12,2020-07-18,7,2020,"29",328300544,63193,5326,51946,11247,57867,1.62229399169074,3.42582435684298,0.21651330227544
"United States","United States","USA",2020-07-19,2020-07-25,7,2020,"30",328300544,64248,6221,51695,12553,58027,1.89491004925048,3.82363058161731,0.242828126511268
"United States","United States","USA",2020-07-26,2020-08-01,7,2020,"31",328300544,64249,8026,51368,12881,56223,2.44471114857489,3.92353903623139,0.250759227534652
"United States","United States","USA",2020-08-02,2020-08-08,7,2020,"32",328300544,63719,7128,51184,12535,56591,2.17118129417416,3.81814780057142,0.244900750234448
"United States","United States","USA",2020-08-09,2020-08-15,7,2020,"33",328300544,63642,7482,51062,12580,56160,2.27900932141008,3.83185475318615,0.246367161489953
"United States","United States","USA",2020-08-16,2020-08-22,7,2020,"34",328300544,62582,6875,51075,11507,55707,2.09411776058464,3.50502008306145,0.225296133137543
"United States","United States","USA",2020-08-23,2020-08-29,7,2020,"35",328300544,61125,6690,51088,10037,54435,2.03776695539073,3.05725963098008,0.196464923269652
"United States","United States","USA",2020-08-30,2020-09-05,7,2020,"36",328300544,60257,5713,51296,8961,54544,1.74017378417746,2.7295111640144,0.174691983780412
"United States","United States","USA",2020-09-06,2020-09-12,7,2020,"37",328300544,59678,5018,51383,8295,54660,1.52847751601654,2.52664826531631,0.161434715762022
"United States","United States","USA",2020-09-13,2020-09-19,7,2020,"38",328300544,59738,5484,51632,8106,54254,1.67042062531581,2.46907906433442,0.156995661605206
"United States","United States","USA",2020-09-20,2020-09-26,7,2020,"39",328300544,60611,5119,51953,8658,55492,1.55924200966295,2.63721768307518,0.166650626527823
"United States","United States","USA",2020-09-27,2020-10-03,7,2020,"40",328300544,59799,4872,52279,7520,54927,1.4840060697554,2.29058408139586,0.143843608332217
"United States","United States","USA",2020-10-04,2020-10-10,7,2020,"41",328300544,61776,4860,52528,9248,56916,1.48035088239147,2.81693106180171,0.17605848309473
"United States","United States","USA",2020-10-11,2020-10-17,7,2020,"42",328300544,60663,4696,52933,7730,55967,1.43039665508443,2.35454986026462,0.146033665199403
"United States","United States","USA",2020-10-18,2020-10-24,7,2020,"43",328300544,62191,5390,53188,9003,56801,1.64178832429836,2.74230431978815,0.169267503948259
"United States","United States","USA",2020-10-25,2020-10-31,7,2020,"44",328300544,63444,5607,53498,9946,57837,1.70788629579609,3.02954112680362,0.185913492093162
"United States","United States","USA",2020-11-01,2020-11-07,7,2020,"45",328300544,67584,6501,53876,13708,61083,1.98019775440884,4.17544236539553,0.254436112554755
"United States","United States","USA",2020-11-08,2020-11-14,7,2020,"46",328300544,68842,7640,54187,14655,61202,2.32713595503515,4.46389756819897,0.27045232251278
"United States","United States","USA",2020-11-15,2020-11-21,7,2020,"47",328300544,71691,9373,54677,17014,62318,2.85500593017598,5.18244648415813,0.311172888051649
"United States","United States","USA",2020-11-22,2020-11-28,7,2020,"48",328300544,73300,10520,55201,18099,62780,3.20438092237825,5.51293634164676,0.327874495027264
"United States","United States","USA",2020-11-29,2020-12-05,7,2020,"49",328300544,77445,14514,55833,21612,62931,4.4209491166728,6.58299244243713,0.387082907957659
"United States","United States","USA",2020-12-06,2020-12-12,7,2020,"50",328300544,82000,16360,56509,25491,65640,4.98323877282396,7.76453175782737,0.451096285547435
"United States","United States","USA",2020-12-13,2020-12-19,7,2020,"51",328300544,82927,17350,57403,25524,65577,5.28479173034815,7.77458352307817,0.444645750222114
"United States","United States","USA",2020-12-20,2020-12-26,7,2020,"52",328300544,84364,13916,58299,26065,70448,4.23879894637031,7.93937155340199,0.447091716839054
"United States","United States","USA",2020-12-27,2021-01-02,7,2020,"53",328300544,86975,19700,59274,27701,67275,6.00059925578436,8.43769543068439,0.467338124641495
"United States","United States","USA",2021-01-03,2021-01-09,7,2021,"1",328300544,86870,21036,60087,26783,65834,6.40754344896852,8.15807359734378,0.445737014662073
"United States","United States","USA",2021-01-10,2021-01-16,7,2021,"2",328300544,87637,23481,60599,27038,64156,7.15228787436916,8.23574632882728,0.446178979851153
"United States","United States","USA",2021-01-17,2021-01-23,7,2021,"3",328300544,83848,21264,60722,23126,62584,6.47699200888318,7.04415524818625,0.380850433121439
"United States","United States","USA",2021-01-24,2021-01-30,7,2021,"4",328300544,79358,21666,60592,18766,57692,6.59944078557482,5.71610383929184,0.309710852917877
"United States","United States","USA",2021-01-31,2021-02-06,7,2021,"5",317812460,74151,21658,58199,15952,52493,6.81471078887215,5.01931233281414,0.274094056598911
"United States","United States","USA",2021-02-07,2021-02-13,7,2021,"6",317812460,69260,21040,57746,11514,48220,6.62025648711193,3.62289131143568,0.199390433969452
"United States","United States","USA",2021-02-14,2021-02-20,7,2021,"7",317812460,67344,12850,57272,10072,54494,4.04326501232834,3.16916460732849,0.175862550635564
"United States","United States","USA",2021-02-21,2021-02-27,7,2021,"8",317812460,64759,14094,56991,7768,50665,4.43469082363857,2.44420876387288,0.136302223158042
"United States","United States","USA",2021-02-28,2021-03-06,7,2021,"9",317812460,61807,11906,56621,5186,49901,3.74623449313472,1.63177994972255,0.0915914589993112
"United States","United States","USA",2021-03-07,2021-03-13,7,2021,"10",317812460,60027,9271,56271,3756,50756,2.91712917737712,1.18182905730002,0.0667484139254679
"United States","United States","USA",2021-03-14,2021-03-20,7,2021,"11",317812460,58579,7022,55852,2727,51557,2.20947913747623,0.85805320534003,0.0488254673064528
"United States","United States","USA",2021-03-21,2021-03-27,7,2021,"12",317812460,59043,6938,55403,3640,52105,2.18304845568358,1.14532954434826,0.0657004133350179
"United States","United States","USA",2021-03-28,2021-04-03,7,2021,"13",317812460,56972,9573,54955,2017,47399,3.01215377144118,0.634651013997374,0.036702756801019
"United States","United States","USA",2021-04-04,2021-04-10,7,2021,"14",317812460,59072,6723,54431,4641,52349,2.11539849633334,1.46029516904403,0.0852639121089085
"United States","United States","USA",2021-04-11,2021-04-17,7,2021,"15",317812460,57349,5026,53963,3386,52323,1.58143579392702,1.06540819702286,0.0627466968107777
"United States","United States","USA",2021-04-18,2021-04-24,7,2021,"16",317812460,58449,4670,53468,4981,53779,1.46942004728197,1.56727650010953,0.0931585247250692
"United States","United States","USA",2021-04-25,2021-05-01,7,2021,"17",317812460,57890,4644,52993,4897,53246,1.4612391219652,1.54084581831688,0.0924084313022475
"United States","United States","USA",2021-05-02,2021-05-08,7,2021,"18",317080915,56927,4438,52468,4459,52489,1.3996427378797,1.40626565304317,0.0849851337958374
"United States","United States","USA",2021-05-09,2021-05-15,7,2021,"19",317080915,56402,4064,52101,4301,52338,1.28169177258745,1.35643610086088,0.0825511986334235
"United States","United States","USA",2021-05-16,2021-05-22,7,2021,"20",317080915,56522,3919,51823,4699,52603,1.23596212026826,1.48195611205424,0.0906740250467939
"United States","United States","USA",2021-05-23,2021-05-29,7,2021,"21",317080915,54776,4107,51555,3221,50669,1.29525297982693,1.01582903531107,0.06247696634662
"United States","United States","USA",2021-05-30,2021-06-05,7,2021,"22",315288768,54007,2862,50912,3095,51145,0.907739282358451,0.981639789971839,0.0607911690760528
"United States","United States","USA",2021-06-06,2021-06-12,7,2021,"23",310749717,52125,2599,50130,1995,49526,0.836364398040626,0.641995757634109,0.0397965290245361
"United States","United States","USA",2021-06-13,2021-06-19,7,2021,"24",303049227,49118,2119,49010,108,46999,0.699226333944749,0.0356377744530594,0.0022036319118548
"United States","United States","USA",2021-06-20,2021-06-26,7,2021,"25",308729712,42653,2093,49802,-7149,40560,0.677939284314818,-2.31561774656791,-0.143548451869403
